--------------------------------------------------------------------------------------------------------------------------------------------------------------------------------------------------------
--------------------------------------------------------------------------------------------------------------------------------------------------------------------------------------------------------
--------------------------------------------------------------------------------------------------------------------------------------------------------------------------------------------------------
--------------------------------------------------------------------------------------------------------------------------------------------------------------------------------------------------------
--------------------------------------------------------------------------------------------------------------------------------------------------------------------------------------------------------
--------------------------------------------------------------------------------------------------------------------------------------------------------------------------------------------------------
--------------------------------------------------------------------------------------------------------------------------------------------------------------------------------------------------------
--------------------------Tt----------------------------------------------------------------------------------------------------------------------------------------------------------------------------
--------------------------tt----------------------------------------------------------------------------------------------------------------------------------------------------------------------------
--------------------------tt----------------------------------------------------------------------------------------------------------------------------------------------------------------------------
--------------------------tt----------------------------------------------G------------------------------------------------K-----------------------------------------Tt-----------------------------G---
----------------------%%%%%%%%%%%-------------------------------------22C2S------------------------------------------------%%%%%%-F------------------G---------------tt--------------------------%%%%---
----------------------|||||||||||------------------K-K----------------G---------------------%%%%%%%%%%---------------------||||||-%---------------CS2SS---------K----tt--------------------------||||---
----------------------|||||||||||----------------%%%%%------%%%%------%%%%%%----------------||||||||||---------------------||||||-|------%%%%----------------%%K%%%%%%%%%%%%----------US2C2S-----F|||---
----------------------|||||||||||----------------|||||------||||------||||||----------------||||||||||----%%%------%%%-----||||||-|------||||----------%%%%%%%%%||||||||||||--------------------- |||---
XXXXXXXXXXXXXXXXXXXXXXXXXXXXXXXXXXXXXXXXXXXXXXXXX|||||------||||XXXXXX||||||XXXXXXXXXXXXXXXX||||||||||XXXX|||------|||XXXXXXXXXXXXXXXXXXXXXXXXXXXXXXXXX|||||||||X|||||||||||XXXXXXXXXXXXXXXXXXXXXXXXXXXX