---------------- -------------- ------------------------------------------------------ -----------------------------------------------------------------------------------------------------------------
---------------------------------------------------------------------------------------------------------------- ---------------------------------------------------------------------------------------
------------------------- --------------------------------------------------- ----------- --------------------------------------------------------------------------------------------------------------
---------------------------------- ---------------------------------------------------------------------------------------------------------------------------------------------------------------------
-------------------------------------------------------------------------------------------------------- ------------------- -------- ----------------------- ----------- ------------------------------
---- ---------------------- ------------------------------------------------------------------------------------------------- -------------------------------------------------------- -----------------
------------------------------------------------------------------------------------------------------------ ---------------------------------------------- --------------------------------------------
------------------------------------------------- ------------------------------------------------ -------------------------------------------------- -------- -----------------------------------------
-------------------------- -----------------------------------------------------------------------------------------------------------------------------------------------------------------------------
----------------------- --g-----------------------------------------------------------------------------------------------------------------------------------------------------------------------------
---------------------------------------------------- CC2------------------gr------k------------------------------------------------------%%%%%%%  %%%%   %%% %%%--------- ------------------------------
--------------------- -----------------------------gkgggggg--------------------- % % %------------------------- ------------%   %      %%|||||||||||||||||||||||---  % %%%% -rr--k----------------------
--------------------------------- ---------------r------------------------------||      ---- --%%%%%% ----------------------||||||||||||||||||||||||||||||||||||---|||||||||-------- -------------------
------------ -----------------%%%%%-  %% %%%% %%%%--------- %%%% %% %%%% -----%%%%%% %%%%------|||||||-------------- -------||||||||||||||||||||||||||||||||||||---|||||||||%%%%%%%% %------------------
------%%% %-------------------|||||-||||||||||||||---------||||||||||||||-----|||||||||||- ----|||||||---------------- -----||||||||||||||||||||||||||||||||||||---|||||||||||||||||||------------------
 XXXXX||||| XXX X X X XXX---XXX X XX||||||||||||||XXXXXX X ||| ||||||||||-----|||||||||||----XXXXXXX  XXXX-----XX XXX X XXXX||||||||||||||||| ||||||||||||||||||---|||||||||||||||||||---XXXXX XXX X FXX