--------------------------------------------------------------------------------------------------------------------------------------------------------------------------------------------------------
--------------------------------------------------------------------------------------------------------------------------------------------------------------------------------------------------------
--------------------------------------------------------------------------------------------------------------------------------------------------------------------------------------------------------
--------------------------------------------------------------------------------------------------------------------------------------------------------------------------------------------------------
--------------------------------------------------------------------------------------------------------------------------------------------------------------------------------------------------------
--------------------------------------------------------------------------------------------------------------------------------------------------------------------------------------------------------
--------------------------------------------------------------------------------------------------------------------------------------------------------------------------------------------------------
---------------------------------------------------------------------------------------------------------------Tt---------------------------------------------------------------------------------------
------------------------------------------------------------------------------Tt-------------------------------tt---------------------------------------------------------------------------------------
------------------------------------------------------------------------------tt-------------------------------tt---------------------------------------------------------------------------------------
------------------------------------------------------------------------------tt--------G----------------------tt---------G--------KK-------------------------------------------------------------------
------------------------------------------------------------------------------tt%%%G%%%%%%--Tt--------------%%%%%%%%%----2UCSC--SSFCC-------------------------------------------------------------------
----------------------%%%%-------------------------------------%%%-------%%%%%%%%%%%||||||--tt--------------|||||||||-------------%----------------------------GG-----------C2U-------------------------
--------%%%%%%%%%-----||||-----------------------K-------------|||-------||||||||||||%%|||--tt--------------|||||||||-------------|------------------%%%%%-----%%%%%--U2U-------------------------------
--------|||||||||-----||||-------------------%%%%%--%%%%%------|||-------||||||||||||||%%%%%%%%%%%----------|||||||||-------------|------------------|||||-----|||||-------------------%%%%%------%%%---
 XXXX X |||||||||XXXXX||||XXXXXXX XX X XXXXXX|||||--|||||XXXX X|||XXXXXXX|||||||||||XXX|||||||||||X X X  XX XXXXX XXXXXX XXXXXX XXXXXXXXXXX XX X XXXX|||||-----|||||XXXX  XXXXX X XXXXX|||||------|||XXX