---------------------------------------------------------------------------------------------------------------------------------------------------        ---------------------------------------------
---------------------------------------------------------------------------------------------------------------------------------------------------        ---------------------------------------------
---------------------------------------------------------------------------------------------------------------------------------------------------        ---------------------------------------------
---------------------------------------------------------------------------------------------------------------------------------------------------        ---------------------------------------------
---------------------------------------------------------------------------------------------------------------------------------------------------        ---------------------------------------------
-------------------------------------------------------k-------------------------------------------------------------------------------------------        ---------------------------------------------
----------------------------------------------------%%%%-------------------------------------------------------------------------------------------        ---------------------------------------------
----------------------------------------------------||||-------------------------------------------------------------------------------------------        ---------------------------------------------
----------------------------------------------------||||--------------------------22SSCS-----------------------------------------------------------        ---------------------------------------------
-----------------------------------------------%%%%%%%||------------------------------------------------SCCCU2-------------------------------------        ---------------------------------------------
-----------------------------------------------|||||||||-------------------------------------------------------------------------------------------        ---------------------------------------------
-----------------------------------------------|||||||||-------------------------------------------------------------------------------------------        ---------------------------------------------
----------------------Tt---tt------------------rg|||||||----------------------%%%%%%%%%%%---------------y-g------------------%%%%%%%---------------        ---------------------------------------------
----------------------tt---tt------%%%---%%%%%%%%%%%%%%%%%%%%-----------------|||||||||||--------------%%%%%%%%%%------------|||||||%%%%%%%%%%%%%%%        %%%%%%%%%%%%%%%%%%%%%%%%%%%%%%%%%%%%%%%%%%%%%
--------------%%---%%%%%%%%%%%%%%%%|||---||||||||||||||||||||-------%%%%--%%%%|||||||||||-----------%%%||||||||||------%%--%%||||||||||||||||||||||        |||||||||||||||||||||||||||||||||||||||||||||
XXXXXXXXXXXXXX||---|||||||||||||||||||---||||||||||||||||||||XXXXXXX||||--|||||||||||||||XXXX---XXXX|||||||||||||XX--XX||--||||||||||||||||||||||||        |||||||||||||||||||||||||||||||||||||||||||||