--------------------------------------------------------------------------------------------------------------------------------------------------------------------------------------------------------
--------------------------------------------------------------------------------------------------------------------------------------------------------------------------------------------------------
--------------------------------------------------------------------------------------------------------------------------------------------------------------------------------------------------------
--------------------------------------------------------------------------------------------------------------------------------------------------------------------------------------------------------
--------------------------------------------------------------------------------------------------------------------------------------------------------------------------------------------------------
--------------------------------------------------------------------------------------------------------------------------------------------------------------------------------------------------------
--------------------------------------------------------------------------------------------------------------------------------------------------------------------------------------------------------
--------------------------------------------------------------------------------------------------------------------------------------------------------------------------------------------------------
-----------------Tt----------------------------------------------------------Tt--------------------------------------------------Tt---------------------------------------------------------------------
-----------------tt----------------------------------------------------------tt--------------------------------------------------tt---------------------------------------------------------------------
---------------G-tt------------------------G---------------------------------tt---------------------------------------------K----tt---------------------------------------------------------------------
--------------%%%%%%%%%--------------------2S------------%%%---%%%%%%%%%%-G--tt--------------G---SSU-----------------------%%%---t ------------------------------------------------------------------G--
--------------||G||K|||----------------------------------|||---|||||||||%%%%%%%%%%%-%%%%%----%%%%----C%%%2-----------------|%%%%%%%%%%--------------G------------%%%--%%%--------------------------   %%
--------------|%%%%%|||------%%%%%%%%%%------------------|||---||||||||||||||||||||-|||||----||||-----|||------------------|||||||||||------%%%---%%%------------|||--|||--------------------------|||||
--------------|||||||||------||||||||||------------------|||---||||||||||||||||||||-|||||----||||-----|||----%%%%%%%%%%%---|||||||||||------|||---|||------------|||--|||--------------------------|||||
XXXXXXXXXXXXXXXXXXXXXXXXXXXXXXXXXXXXXXXXXXXXXXXXXXXXXXXXXXXXXXXXXXXXXXXX|||||||||||X|||||----||||XXXXXXXXXXXX|||||||||||XXXX||||||||||XXXXXX|||---|||XXXXXXXXXXXX|||--|||XXXXXXXXXXXXXXXXXXXXXXXXX |||||