--------------------------------------------------------------------------------------------------------------------------------------------------------------------------------------------------------
--------------------------------------------------------------------------------------------------------------------------------------------------------------------------------------------------------
--------------------------------------------------------------------------------------------------------------------------------------------------------------------------------------------------------
--------------------------------------------------------------------------------------------------------------------------------------------------------------------------------------------------------
--------------------------------------------------------------------------------------------------------------------------------------------------------------------------------------------------------
--------------------------------------------------------------------------------------------------------------------------------------------------------------------------------------------------------
--------------------------------------------------------------------------------------------------------------------------------------------------------------------------------------------------------
--------------------------------------------------------------------------------------------------------------------------------------------------------------------------------------------------------
------------------------------------------------------------------------Tt------------------------------------------------------------------------------------------------------------------------------
------------------------------------------------------------------------tt------------------------------------------------------------------------------------------------------------------------------
----------------------------------------Tt------------------------------tt------------------G-------------------------------------------------------K----G----------------------------------------------
----------------------------------------tt-----------------------------Ktt-----------------%%%------------------------------------F22C-----K------%%%%%%%%%%%-------------Tt----------------------------
---------------------------------UU-----tt--------GG----K-----------%%%%%%%%%--------------|||----UUCSS---------------------------%--------%%%%---|||||||||||-------------tt-----------------22C--------
-----------------------------------%%%%%%%%%%-----%%%%--%%%%--------|||||||||--------------|||------------U2C2S2S-----------------|--------||||%--||%%%%%||||-------------tt--------------------F-------
-----------------------------------||||||||||-----||||--||||--------|||||||||--------------|||------------------------------------|--------|||||--|||||||||||---------%%%%%%%%%%%--------------- -------
XXXXXXXXXXXXXXXXXXXXXXXXXXXXXXXXXXX||||||||||XXXXX||||--||||XXXXXXXX|||||||||XXXXXXXXXXXXXXXXXXXXXXXXXXXXXXXXXXXXXXXXXXXXXXXXXXXXXXXXXXXXXX||||XXXXX|||||XXXXXXXXXXXXX|||||||||||XXXXXXXXXXXXXXXXXXXXXXX