---------------------------------------------------------------------------------------------------------------------------------------------------      -----------------------------------------------
---------------------------------------------------------------------------------------------------------------------------------------------------      -----------------------------------------------
---------------------------------------------------------------------------------------------------------------------------------------------------      -----------------------------------------------
---------------------------------------------------------------------------------------------------------------------------------------------------      -----------------------------------------------
---------------------------------------------------------------------------------------------------------------------------------------------------      -----------------------------------------------
---------------------------------------------------------------------------------------------------------------------------------------------------      -----------------------------------------------
---------------------------------------------------------------------------------------------------------------------------------------------------      -----------------------------------------------
-----------------------------------------------------------------------------------------------------%%%%%-----------------------------------------      -----------------------------------------------
-----------------------------------------------------------SCS---------------------------------------|||||-----------------------------------------      -----------------------------------------------
-------------------------------------------------------------------------------------------CCSCSSS---|||||-----------------------------------------      -----------------------------------------------
--------------------------------------------------S2-US2S-------------------Tt-----------------------|K|||-----------------------------------------      -----------------------------------------------
----------------------------------------------------------------------------tt-----------------------|%%%%%%%--------------------------------------      -----------------------------------------------
------------%%%%--%%%%------------------------------%-----%%%%%%%%----------tt------------y--r---K---k|||||||-k------------------------------------      -----------------------------------------------
------------||||--||||-------%%---%%----------------|-----||||||||-------%%%%%%%%--------%%%%%%%%%%%%%%%%%%%%%%%%----------------------------------      -----------------------------------------------
------------||||--||||%%---%%||---||%%%%%%%%%%%%%%%%%%%%%%||||||||-------||||||||%%%--%%%||||||||||||||||||||||||%%%%%---%%%%%-g-------%%%--%%%%%%%      %%%%%%%%%%%%%%%%%%%%%%%%%%%%%%%%%%%%%%%%%%%%%%%
XXXXXXXXXXXX||||--||||||---||||---||||||||||||||||||||||||||||||||XX---XX|||||||||||--||||||||||||||||||||||||||||||||---|||||XXXXXXXXX|||--|||||||      |||||||||||||||||||||||||||||||||||||||||||||||