--------------------------------------------------------------------------------------------------------------------------------------------------------------------------------------------------------
--------------------------------------------------------------------------------------------------------------------------------------------------------------------------------------------------------
--------------------------------------------------------------------------------------------------------------------------------------------------------------------------------------------------------
--------------------------------------------------------------------------------------------------------------------------------------------------------------------------------------------------------
--------------------------------------------------------------------------------------------------------------------------------------------------------------------------------------------------------
--------------------------------------------------------------------------------------------------------------------------------------------------------------------------------------------------------
--------------------------------------------------------------------------------------------------------------------------------------------------------------------------------------------------------
---------------------------------------------------------------------------------------------------------------------------------------------------------------------------------------------------Tt---
---------------------------------------------------------------------------------------------------------------------------------------------------------------------------------------------------tt---
---------------------------------------------------------------------------------------------------------------------------------------------------------------------------------------------------tt---
----------------------------------------------------------------------------------------------------G--G------------------------------------------------------------------------------------------Gtt--G
----------------------------------------------------------------------------------------------------%%%%%%------------------------F------------------------------------------------------------%%%%%%%%%
-----------%%%------%%%---------------------------------------------------K-------------------------||||||------------------------%------------------------------------------------------------|||||||||
-----------|||------|||-----------------%%%%-----%%%%---------------%%%%%%%%%%----------------------||||||------------------------|-----------------------%%%%---------------------------------|F|||||||
-----------|||------|||-----------------||||-----||||---------------||||||||||----------------------||||||------------------------|-----------------------||||---------------------------------| |||||||
XXXXXXXXXXX|||------|||XXXXXXXXXXXXXXXXX||||-----||||XXXXXXXXXXXXXXX||||||||||XXXXXXXXXXXXXXXXXXXXXXXXXXXXXXXXXXXXXXXXXXXXXXXXXXXXXXXXXXXXXXXXXXXXXXXXXXXX||||XXXXXXXXXXXXXXXXXXXXXXXXXXXXXXXXXXXXXXXXXX