---------------------------------------------------------------------------------------------------------------------------------       ----------------------------------------------------------------
---------------------------------------------------------------------------------------------------------------------------------       ----------------------------------------------------------------
---------------------------------------------------------------------------------------------------------------------------------       ----------------------------------------------------------------
---------------------------------------------------------------------------------------------------------------------------------       ----------------------------------------------------------------
---------------------------------------------------------------------------------------------------------------------------------       ----------------------------------------------------------------
---------------------------------------------------------------------------------------------------------------------------------       ----------------------------------------------------------------
---------------------------------------------------------------------------------------------------------------------------------       ----------------------------------------------------------------
---------------------------------------------------------------------------------------------------------------------------------       ----------------------------------------------------------------
---------------------------------------------------------------------------------------------------------------------------------       ----------------------------------------------------------------
---------------------------------------------------------------------------------------------------------------------------------       ----------------------------------------------------------------
---------------------------------------------------------------------------------------------------------------------------------       ---------Tt-----------------------------------------------------
-----------------------------%%%%%%-----------------------------------------------------------------------K-K--------%%%%%%------       ---------tt-----------------------------------------------------
-----------------------------||%%%%%%%%%%---------------------------%%%%%%--------------------------------2SUUU2C----||||||------       ---------tt-----------------------------------------------------
-----------------------------||||||||||||----%%%%%%%%%--------------||||||------GG---KG--G-------K------G------------||||||------       -----%%%%%%%%%%%--------------------------------%%%----%%%--%%%%
-----------------------------||||||||||||----|||||||||--------------||||||----%%%%---%%%%%-----%%%%%---%%%-----------||||%%%-----       -----|||||||||||---------------%%%--%%%---------|||----|||--||||
XXXXXXXXXXXXXXXXXXXXXXXXXXXXXXXXXXXXXXXXXXXXX|||||||||XXXXXXXXXXXXXXXXXXXXXXXX||||---|||||XXXXX|||||---|||XXXXXXXXXXXXXXX|||XXXXX       XXXXXXXXXXXXXXXXXXXXXXXXXXXXXXX|||--|||XXXXXXXXX|||----|||XX||||