------------------------------------------------ -------------------------------------------------------------------------------------------------------------------------------------------------------
--------------------------------------------------------------------------------------------------------------------------------------------------------------------------------------------------------
--------------------------------------------------------------------------------------------------------------------        --------------------------------- ------------------------------------------
--------------------------------------------------------------------------------------------------------------------------------------------------------------------------------------------------------
--------------------------------------------------------------------------------------------------------------------------------------------------------------------------------------------------------
---------------------------------------------------------------------------------------------------------------------------------------------------------------------------- ---------------------------
--------------------------------------------------------------------------------------------------------------------------------------------------------------------------------------------------------
--------------------------------------------------------------------------------------------------------------------------------------------------------------------------------------------------------
--------------------------------------------------------------------------------------------------------------------------------------------------------------------------------------------------------
------------------------------------- -----------------------------------------------------------------------------------------------------------------------------------gg-----------------------------
------------------------------------------------------------------------- ---------------------------------------------------- ---- --------------------------------------------------------------------
-----------------------------------------gggggggkkgk-------------------------------------kkkggggggggg-----------------------------%%% %---------------------------------% % %%%%%%----% %% %%%  % %  F%%
-------------------------------------------|||||||-------------------------------------r--||||||||||------------------------------|||||---------------------------------||||||||||----|||||||||||||||%||
----------------------------%%%%%%%%%%%%%--|||||||-- %%%   %%%%%--------------% %%%%% %%--||||||||||-%% %%%%%% %%-----g-----------|||||------------------------- % %% %%||||||||||----||||||||||||||||||
------%%%%%-----------------|||||||||||||--|||||||--||||||||||||--------------||||||||||--||||||||||-||||||||||||---------------%%%%% %% -----%%%----- ---------||||||||||||||||||----||||||||||||||||||
  XXXX|||||XXXX  XX XXXX ---||||||||||||| X XXXX XXX||||||||||||---XXX XX X X |||||||||| XX X  X  XXX|||||||||||| ---XXX XXXXXXX|||||||||-----|||----XXX XXXX XX||||||||||||||||||----||||||||||||||||||