--------------------------------------------------------------------------------------------------------------------------------------------------------------------------------------------------------
--------------------------------------------------------------------------------------------------------------------------------------------------------------------------------------------------------
--------------------------------------------------------------------------------------------------------------------------------------------------------------------------------------------------------
--------------------------------------------------------------------------------------------------------------------------------------------------------------------------------------------------------
--------------------------------------------------------------------------------------------------------------------------------------------------------------------------------------------------------
--------------------------------------------------------------------------------------------------------------------------------------------------------------------------------------------------------
--------------------------------------------------------------------------------------------------------------------------------------------------------------------------------------------------------
--------------------------------------------------------------------------------------------------------------------------------------------------------------------------------------------------------
--------------------------------------------------------------------------------------------------------------------------------------------------------------------------------------------------------
--------------------------------------------------------------------------------------------------------------------------------------------------------------------------------------------------------
-------------------------------------------------------------------------------------rY-----------------------------------------------------------------------------------------------------------------
-------------------------------------------------------------------------------------%%%%---------------------------------------------------------------------------------------------------------------
----------------%%%%%----------------%%%%--%%%%------------------------------------Ky||r|-----------------%%%%%--%%%%%---------%%%----------------------------------------------------------------------
----------------|||||-----g----%%--%%||||--||||--------------------------#---#--%%%%%%%%%%%%%--%%--#---#--|||||--|||||---------|||%%%--%%%%%%%%%%% %%%%%%%%%%%%%%%%%%%%%%%%%%%%%%%%%%%%%%%%%%%%%%%    %%
------------%%%%%%%%%%%%%%%%%%%||--||||||--||||%%%%---%%%%-------------%%%---%%%|||||||||||||--||%%%---%%%|||||--|||||---------||||||--|||||||||||%|||||||||||||||||||||||||||||||||||||||||||||||||||||
XXXXXXXXXXXX|||||||||||||||||||||--||||||--||||||||---||||XXXXX---XXXXX|||---||||||||||||||||--|||||---||||||||--|||||XXX---XXX||||||--|||||||||||||||||||||||||||||||||||||||||||||||||||||||||||||||||