--------------------------------------------------------------------------------------------------------------------------------------------------------------------------------------------------------
--------------------------------------------------------------------------------------------------------------------------------------------------------------------------------------------------------
----------------------------------------------------------------------------------------------------------------------CSC2------------------------------------------------------------------------------
-------------------------------------------------------------------------------U------------------------------------------------------------------------------------------------------------------------
--------------------------------------------------------------------------------------------------------------------------------------------------------------------------------------------------------
--------------------------------------SSCS2SU2SSS-%%%%%%%%%%%%%----------------------%%%%%%%%%----------------------------------------------------------------------------------------------------------
--------------------------------------------------|||||||||||||--------------------ggkkgggggggkg--------------------%%%%%%%-----------------------------------------------------------------------------
---------------------------------USSSC------------|||||||||||||------------%%%%%%%%--|||||||||----------------------|||||||-----------------------------------------------------------------------------
--------------------------------------------------|||||||||||||-g----------||||||||--|||||||||--%%%%%%%%%%%%%%-gg--g|%%%%%%%%--------r---k----k---------------------------------------------------------
--------------------------------------------------|||||||||||||------------||||||||--|||||||||--||||||||||||||------|||||||||---------------------------------------------------------------------------
--------------------------------------------------|||||||||||||----%%%%%%%%||||||||%%%%%%%%%%%%%||||||||||||||----%%%%%%%%%%%%%-----%%%%%%%%------------------%%%%%-------------------------------------
-------------------------%%%%%%%%%%%%-------------|||||||||||||----|||||||||||||||||||||||||||||||||||||||||||----|||||||||||||-----||||||||------------------|||||--------------------SCCSSS-----------
-------------------------||||||||||||-------------|||||||||||||----|||||||||||||||||||||||||||||||||||||||||||----|||||||||||||-----||||||||------------k-----|||||-------%%%%%%%-----------------------
-------------------------||||||||||||-------------|||||||||||||----|||||||||||||||||||||||||||||||||||||||||||----|||||||||||||-----||||||||------------------|%%%|-------|||||||-----------------------
------%%%%%--------------||||||||||||-------------|||||||||||||----|||||||||||||||||||||||||||||||||||||||||||----|||||||||||||-----||||||||---%%%%%%%%-----%%%%%%%%------|||||||--------------%%%    %%
XXXXXX|||||XXXXXXXXXXXXXX||||||||||||XXXXXXXXXXXXX|||||||||||||----|||||||||||||||||||||||||||||||||||||||||||----|||||||||||||-----||||||||---||||||||-----||||||||----XXXXXXXXXXXXXXXXXXXXXXX|||||| ||