|||||||||||||||||||||||||||||||||||||||||||||||||||||||||||||||||||||||||||||||||||||||||||||||||||||||||Tt|||||||||||||||||||||||||||||||||||||||||||||||||||||||||||||Tt||||||||||||||||||||||||||||||
|||||||||||||||||||||||||||||||||||||||||||||||||||||||||||||||||||||||||||||||||||||||||||||||||||||||||tt|||||||||||||||||||||||||||||||||||||||||||||||||||||||||||||tt||||||||||||||||||||||||||||||
||||||||||||||||||||||||||||||||||||||||||||||||||||||||||||K||||||||||||||||||||||||||||||||||||||||||||tt|||||||||||||||||||||||||||||||||||||||||||||||||||||||||||||tt||||||||||||||||||||||||||||||
|||||||||||||||||||||||||||||||||||||||||||||||||||||||||%%%%|||||||||||||||||||||||||||||||||||||||%%%%%%%%%%%%|||||||%%%||||G|||F||||||||||||||||||||||||||||K||||||||tt|||G|||||||||||||||||||||||||||
||||||||||||||||||||||||||||||||||K|||||||||||||||||||||||||||||||||||||||||||||||||||||||||||||||||||||||||||||||||||||||||%%%%||%|||||||||||||||||||||||||||SCUU2C%%%%%%%%%%%|||||||||||||||||||||||||
|||||||||||||||||||||||%%%%%||||%%%%%%%%%%%|||||||||||||||||22S2CCU|||||||||||||||%%%%%||||||||||||||||%%%SCSSUU|||%%%%%%||||||||||||||||S2CC|||G||K|||||||||||||||||||||||||||||||||||||||||%%%%%%%%%||
|||||||||||||||||||||||||||||||||||||||||||||||||||||||||||||||||||%%%%|||%%%%||||||||||||||||||||||||||||||||||||||||||||||||||||||||||||||||||%%%%%%||||||||||||||||||||||||||||||||||||||||||||||||||
XXXXXXXXXXXXXXXXXXXXXXX|||||XXXXXXXXXXXXXXXXXXXXXXXXXXXXXXXXXXXXXXX|||||||||||XXXX|||||XXXXXXXXXXXXXXXXXXXXXXXXXXXXXXXXXXXXXXXXXXXXXXXXXXXXXXXXX||||||XXXXXXXXXXXXXXXXXXXXXXXXXXXXXXXXXXXXXXX|||||||||XX
