--------------------------------------------------------------------------------------------------------------------------------------------------------------------------------------------------------
--------------------------------------------------------------------------------------------------------------------------------------------------------------------------------------------------------
--------------------------------------------------------------------------------------------------------------------------------------------------------------------------------------------------------
--------------------------------------------------------------------------------------------------------------------------------------------------------------------------------------------------------
--------------------------------------------------------------------------------------------------------------------------------------------------------------------------------------------------------
--------------------------------------------------------------------------------------------------------------------------------------------------------------------------------------------------------
--------------------------------------------------------------------------------------------------------------------------------------------------------------------------------------------------------
--------------------------------------------------------------------------------------------------------------------------------------------------------------------------------------------------------
--------------------------------------------------------------------------------------------------------------------------------------------------------------------------------------------------------
---------------------------------------------------------------------------------------------------------------------Tt---------------------------------------------------------------------------------
--------------------------------------------------------------G------------------------------------------------------tt------------------------------------------Tt-------------------------------------
---------------SCSU-----------------------------------------%%%%%%%%%%%%---------------------------------------------tt---------G- ------------------%%%%%%%%%---tt-------------------------------------
-------------------%%%%%%%%------------------------G----K---||||||||||||---------------------------------K------%%%%%%%%%%---%%%%-%-%%%%%------------|||||||||---tt-------------------------------------
--------%%%--------||||||||--------%%%------%%%----UU2SC2---||%%2U%|||%%%%%%%%%%%-------------%%%%%--%%%%%------||||||||||---||||-|-|||||-------%%%%%%%%%|||||%%%%%%%%----------K----------G------------
--------|||--------||||||||%%%%%%--|||------|||-------------|||||||||||||||||||||-------------|||||--|||||------||||||||||---||||-|-|||||-------||||||||||||||||||||||--%%%-----%%%--------%%%--%%    %%
XXXXXXXX|||XXXXXXXX||||||||||||||XX|||------|||XXXXXXXXXXXXXXXXXXXXXXX|||||||||||XXXXXXXXXXXXX|||||--|||||XXXXXXXXXXXXXXXXXXX||||-|-|||||XXXXXXXXXXXXXXXXXXXXXXXXXXXXXXX|||-----|||XXXXXXXX|||--||||||||