--------------------------------------------------------------------------------------------------------------------------------      ------------------------------------------------------------------
--------------------------------------------------------------------------------------------------------------------------------      ------------------------------------------------------------------
--------------------------------------------------------------------------------------------------------------------------------      ------------------------------------------------------------------
--------------------------------------------------------------------------------------------------------------------------------      ------------------------------------------------------------------
--------------------------------------------------------------------------------------------------------------------------------      ------------------------------------------------------------------
--------------------------------------------------------------------------------------------------------------------------------      ------------------------------------------------------------------
--------------------------------------------------------------------------------------------------------------------------------      ------------------------------------------------------------------
--------------------------------------------------------------------------------------------------------------------------------      ------------------------------------------------------------------
------------------------------------------------Tt------------------------------------------------------------------------------      ------------------------------------------------------------------
-----------------------------------Tt-----------tt------------------------------------------------------------------------------      ------------------------------------------------------------------
-----------------------------------tt-----------tt------------------------------------------------------------------------------      ------------------------------------------------------------------
-----------------------------------tt%%%%%%%----tt-----------------------%%%%---------------------------------------------------      ------------------------------------------------------------------
--------------G--------------------tt||GG||%%%%%%%%%%-------------%%%%%--||||----------------%%%%%%--------------------------%%%      %-----------------------------------------------------------%%%%%%
--------------%%%---------------%%%%%%%%%%|||||||||||------22C----|||||--||||----------------||||||-----------------2CUS22---|||      |-----G---------------------------------------%%%%%---------||||||
--------------|||---------------|||||||||||||||||||||----------%%%|||||--||||----------------||||||--------------------------|||      |--%%%%%--%%%%----------%%%%%%%%%%%-----------|||||---------||||||
XXXXXXXXXXXXXXXXXXXXXXXXXXXXXXXXXXXXXXXXXXXXXXXXXXXXXXXXXXXXXXX|||XXXXXXXXXXXXXXXXXXXXXXXXXXXXXXXXXXXXXXXXXXXXXXXXXXXXXXXXXXXXXX      XXX|||||--||||XXXXXXXXXX|||||||||||XXXXXXXXXXXXXXXXXXXXXXXXX||||||