---------------------------------------------------------------------------------------------------------------------------------    -------------------------------------------------------------------
---------------------------------------------------------------------------------------------------------------------------------    -------------------------------------------------------------------
---------------------------------------------------------------------------------------------------------------------------------    -------------------------------------------------------------------
---------------------------------------------------------------------------------------------------------------------------------    -------------------------------------------------------------------
---------------------------------------------------------------------------------------------------------------------------------    -------------------------------------------------------------------
---------------------------------------------------------------------------------------------------------------------------------    -------------------------------------------------------------------
---------------------------------------------------------------------------------------------------------------------------------    -------------------------------------------------------------------
---------------------------------------------------------------------------------------------------------------------------------    -------------------------------------------------------------------
---------------------------------------------------------------------------------------------------------------------------------    -------------------------------------------------------------------
-------------------------------------------------------------------------------------------------------------------------Tt------    -------------------------------------------------------------------
------------------------------------------------K------------------------------------------------------------------------tt------    ----------------------------------G--------------------------------
-----------------------------------------------CUCSSCC----------------------------GK-----------Tt------------------------%%------    -------------------------%%%%%%%%%%%-------------------------------
---------US2CUCC-------------G---------------------------------------------------%%%%%%%%%-----tt--------------------%%%%||%%G-%%    %%-----------------------|||||||||||-------------------------------
-------------------------%%%%%---------------2CUS--------------------------------|||||||||-----tt--K-----------------||||||||%%%|    ||--------------------G--|||||||||||----------------G--------------
-------------------------|||||---------------------------------------------------|||||||||-%%%%%%%%%%%---------------||||||||||||    ||------------------%%%--|||||||||||----------%%%%%%%%%%---%%%%%---
XXXXXXXXXXXXXXXXXXXXXXXXX|||||XXXXXXXXXXXXXXXXXXXXXXXXXXXXXXXXXXXXXXXXXXXXXXXXXXX|||||||||X|||||||||||XXXXXXXXXXXXXXX||||||||XXXX    XXXXXXXXXXXXXXXXXXXX|||XXXXXXXXXXXXXXXXXXXXXXX||||||||||---|||||XXX