--------------------------------------------------------------------------------------------------------------------------------------------------------------------------------------------------------
--------------------------------------------------------------------------------------------------------------------------------------------------------------------------------------------------------
--------------------------------------------------------------------------------------------------------------------------------------------------------------------------------------------------------
--------------------------------------------------------------------------------------------------------------------------------------------------------------------------------------------------------
--------------------------------------------------------------------------------------------------------------- CS S C C--% %%%%  %% %------------------------------------------------------------------
--------------------------------------------------------------------------------------------------------------------------||||||||||||------------------------------------------------------------------
--------------------------------------------------------------------------------------------------------SSUSS-------------||||||||||||------------------------------------------------------------------
--------------------------------------------------------------------------------------------------------------------------||||||||||||------------------------------------------------------------------
--------------------------------------------------------------------------------------------------------------------------||||||||||||--k---- %%%%   --------------------CS22---------------------------
-------------------------------------------------------------gkggkgkgggggg------------------------------------------------||||||||||||-------||||||||---------------------------------------------------
-----------------------------------------------------------r--|||||||||||------------% %%%%%%%%%%%% %%%%%% %%-------------||||||||||||-----%% %%%%%%%%%%%---%%%%  %%%%----------------------------------
----------------------------------------------%  %% %% %% %%--|||||||||||-  %%% %% %%||||||||||||||||||||||||%   %%%%%%%% ||||||||||||-----||||||||||||||---||||||||||------------------kk--------------
----------------------------------------------||||||||||||||--|||||||||||-||||||||||||||||||||||||||||||||||||||||||||||||||||||||||||-----||||||||||||||---||||||||||% %%%%%%%-------------------------
----------------------------------------------||||||||||||||%%%%% %%%%%%%%||||||||||||||||||||||||||||||||||||||||||||||||||||||||||||-----||||||||||||||---|||||||||||||||||||----%%%%%%%   %%%%-------
------%%%%%-------------------%%%----%% %%%%% ||||||||||||||||||||||||||||||||||||||||||||||||||||||||||||||||||||||||||||||||||||||||-----||||||||||||||---|||||||||||||||||||----||||||||||||||%  %F%%
 XXXXX|||||XXXXXXXXX X  X-----|||----|||||||||||||||||||||||||||||||||||||||||||||||||||||||||||||||||||||||||||||||||||||||||||||||||-----||||||||||||||---|||||||||||||||||||----||||||||||||||||||X||