----------------------------------------------------------------------------------------------------------------------------       ---------------------------------------------------------------------
----------------------------------------------------------------------------------------------------------------------------       ---------------------------------------------------------------------
----------------------------------------------------------------------------------------------------------------------------       ---------------------------------------------------------------------
----------------------------------------------------------------------------------------------------------------------------       ---------------------------------------------------------------------
----------------------------------------------------------------------------------------------------------------------------       ---------------------------------------------------------------------
----------------------------------------------------------------------------------------------------------------------------       ---------------------------------------------------------------------
----------------------------------------------------------------------------------------------------------------------------       ---------------------------------------------------------------------
----------------------------------------------------------------------------------------------------------------------------       ---------------------------------------------------------------------
----------------------------------------------------------------------------------------------------------------------------       ---------------------------------------------Tt----------------------
----------------------------------------------------------------------------------------------------------Tt----------------       ---------------------------------------------tt----------------------
--------------------------------------------------------------------------------------------------------G-tt----------------       -------------------------------------------G-tt------------------Tt--
-----------------------------------------%%-%%%------------------------------------------------Tt%%%%%%%%%tt----------------       -----------------------------------%%%%%%%%%%tt------------UC----tt--
-------UUUSSC----------------------------||-|||------------------------------------%%%%%%%%%---tt|||||||||tt-%%%%%%%%-------       %%----SS---------------------------||||||%%%%%%%%%%%-------------tt--
----------------------------------------G||-%%%%%%%%-------------------------------|||||||||---tt|||K|%%%%%%%%%%%|||%%%%%%%%       ||-----------------------------G---|||||||||||||||||-------------tt--
--------------------------------------%%%%%%%%%%||||-------------%%%%------%%%%%---|||||||||%%%%%%%%%%||||||||||||||||||||||       ||---------------------%%%%---%%%--|||||||||||||||||---------%%%%%%%%
XXXXXXXXXXXXXXXXXXXXXXXXXXXXXXXXXXXXXX||||||||||XXXXXXXXXXXXXXXXX||||------|||||XXX||||||||||||||||||||||||||||||XXX||||||||       XXXXXXXXXXXXXXXXXXXXXXX||||---|||XXXXXXXX|||||||||||XXXXXXXXX||||||||