---------------------------------------------------------------------------------------------------------------------- --- ----------------------------------------------------------------------- -----
---------------------------------------------------------------------- ------------------------------------------ ------------------------------------- ------------------------------------------- ----
------------- ------------------------------------------------------------------------------------------------------------------------------------------------------------------------------------------
------------------------------------------------------------------------------------- --------------------------------- --------- ------------ ------------------------------------ --------------------
----------- ------------------------- --------------------    ------------------------------------------------ -----------------------------------------------------------------------------------------
--------- --------- ------------------ -------------------------------------- --------------------- -- -------------- - ---------------------------------------- ------------------- -------------------
---------------------------------------------------------------------------- ------------------------------------------------------------------------------- --------------------------------------- ---
--------------------------------------------------------------------------------------------------- ----------------------------------------------------------------------------------------------------
---- ----------------------------- - ------------------------------------------------------ ------------- ----- -- - -- ------------------------------------- ------------------------------ -----------
--------------------------------------------------------------------------------------------------------------Tt----------------------------------------------------- ------------------------------Tt--
--------------------------------------------------------- ----------------------------------------------------tt-----------------G------G -----------------Tt------------ --------------------------tt--
-------------------------------------------------------------------- ---------------------------------- ------tt----K----------% %F%%%%%%%%%%--------------tt------------------K------- ------------tt--
-------------------------%%%%%%%%%%------------ ------ -------%%%%%%%%%%%-----------------------------G ---%%% %%%%%%%%%%%%%%%%|||%||||||||||--------------tt------ ------ --%%%-------------G---%%%%%%%
-------------------------||||||||||------------------------ --||| |||||||---------------------------%%%%%%%||||||||||||||||||||||||| ||||||||--------------tt---22C ---------|||--- ---%%%%%%%%%%|||||| 
-------------------------||||||||||---%%%% -----%%%%%---------|||||||||||-------------%%%%%%%%%%----|||%%%%||||||||||||||||||||||||||||||||||---------%%%%%%%%%%------------ |||-------|||||||||||||||||
 XX    X X  XXXX XXXXXX XXX   XX  XXX ||||--- --|| ||XXXX XXXX|||||||||||    XXXXXXXXX||||||||||X XX  X||||||||||||||X  XX X X X XXX  XX  X  XX X X X |||||||||| XXXXXXX XXXX|||XXXXX XX XX    XX|||||||