-----------------------------  ---------------------------- ----------------- ------------------------------------------------------------------------------------ ----------------------- ---------- --
 ------------------------------ ------------------------------------------------------------------------------------------------------------------------------------- ----------------------------------
-- ---------------------------------------------- ------------------- ------------- ------------- ----------------------------------- ----------- ------- ------------------ ---------------------------
------------------------------------------------------------------- -------- ------------------------------------------------------------------ - -------------------------------------- --- -----------
------- ----------------------------------------------- ------------------------------------------------- --- --------------------------------------------------------- --------------------------------
---------------------- ------------------------------------------------------------------------------------ -- ---------------------------- ------------------------------------------------------ -----
----- ------ -------- --------------------------------- ----------------------- ---- ------------  ----- ------ ----------- -------- ------------------------- -----------------------------------------
----------------------- ----------------------------------------------------------------------------------------------  ------- ------------------ --------------------------------%%%%%%%%---- --------
----------------------------------------- -------------------- --------- -------- -------------------------%%%%%%%--------------------------------------------------k-------rr-----||||||||- -----------
---------------------------g----------- ---------------------------SCUS2C-%%%%%%% %%%%--------- -----------|||||||---------------------------2CS2SCSCS------------------------- ---||||||||-------------
----------------- ----------------- --------------------------------------||||||||||||%%%%%%%%%%%%%%-------| | |||-------------------------gkggggggggkgr ----------%%%%%%%%%%%---%%%%%%%%%%%%%%--- -----
------------------------ --------------------------------------UC---------|||||| ||||||||||||||||| |-------|||||||-----g--gg%%%%---------r---------- - ------------|||||||||||---||||||||| |||| --------
---------------------------- ------------------ --------------------------||||||||||||||||||||||||||-----%%%%%%%%%%%%%-----|||||--%%%%%%%%--------------%%%%%%%%%% |||||||||||---||||||||||||||-------- 
--------------------------- ----------------------------------------------||||||||||||||||||||||||||-- --|||||||||||||----%%%||| - |||||||--------------||||||||||||||||||||||---|  |||||||||||%%%%%% %%
------%%%%%------------------------------------------ --------------------||||||||||||||||||||||||||-----|||||||||||||----||||||--||| ||||%%%%%%%%%%% %%||||||||||||||||||||||---|||| |||||||||||||||%||
XXXXXX|||||XX XXXXXXXXXXX-----XXXXXXXXXXX XX---XXXXXXXXXXXXXXXXXXXXXXXXXXX|||| |||||||| ||||||||||||-----| |||||||||||---XXXXXXXXX||||||||||| ||||||||||||||||||||||||||||||||---|||||||||||||| ||||||||