----------------------------------------------------------------------------------------------------------------------------------     -----------------------------------------------------------------
----------------------------------------------------------------------------------------------------------------------------------     -----------------------------------------------------------------
----------------------------------------------------------------------------------------------------------------------------------     -----------------------------------------------------------------
----------------------------------------------------------------------------------------------------------------------------------     -----------------------------------------------------------------
----------------------------------------------------------------------------------------------------------------------------------     -----------------------------------------------------------------
----------------------------------------------------------------------------------------------------------------------------------     -----------------------------------------------------------------
----------------------------------------------------------------------------------------------------------------------------------     -----------------------------------------------------------------
----------------------------------------------------------------------------------------------------------------------------------     -----------------------------------------------------------------
------------------------------------------------------------------------------------------------Tt--------------------------------     -----------------------------------------------------------------
------------------------------------------------------------------------------------------------tt--------------------------------     ---------------------------------------Tt------------------------
------------------------------------------------------------------------K-----------------------tt--------------------------------     ---------------------------------------tt------K-K---------------
-----------------------------------------------------------------------2C2-------------------%%%%%%%%%%---------------------------     %--------------------------------------tt-K----%%%-G-------------
---------------------------------------------------------------------------------------------|||||||%%%%%%-------------------K---%     |------%%%-----------------------------tt%%%%%%%%%%%%%%%%----%%%%
---------------------%%%%----%%%%%----------------------------------------%%%%%----%%%%------|||||||||||||---------------2UCSSC--|     |------|||---------G----------------%%%%%%%%%%|||||||||||----||||
---------------------||||----|||||----------------------------------------|||||----||||------|||||||||||||-----------------------|     |------|||--------%%%%%%%%----------|||||||||||||||||||||----||||
XXXXXXXXXXXXXXXXXXXXX||||----|||||XXXXXXXXXXXXXXXXXXXXXXXXXXXXXXXXXXXXXXXX|||||----||||XXXXXXXXXXXXXXXXXXXXXXXXXXXXXXXXXXXXXXXXXXX     XXXXXXXXXXXXXXXXXX||||||||XXXXXXXXXX||||||||||XXXXXX|||||----||||