--------------------------------------------------------------------------------------------------------------------------------------------------------------------------------------------------------
--------------------------------------------------------------------------------------------------------------------------------------------------------------------------------------------------------
--------------------------------------------------------------------------------------------------------------------------------------------------------------------------------------------------------
--------------------------------------------------------------------------------------------------------------------------------------------------------------------------------------------------------
--------------------------------------------------------------------------------------------------------------------------------------------------------------------------------------------------------
--------------------------------------------------------------------------------------------------------------------------------------------------------------------------------------------------------
--------------------------------------------------------------------------------------------------------------------------------------------------------------------------------------------------------
--------------------------------------------------------------------------------------------------------------------------------------------------------------------------------------------------------
-----------------------------------------------------SCSSSSSSS---------------------------------------------------------------------------------------------------ggg--------g--r------------------------
---------------------------------------------------gggkggggggggg----------------------------------------------------------------------------------------------------------------------------------------
--------------------------g-------g--------------r--------------------------------------------------------------------------------------------------------------%%%%%%%%%%%%----------------------------
------------------------------------------%%%%%%%%--------------%%%%%%%%------------------------------------------U---gkkkgggggggggk--------------%%%%%%%%%%%%%%||||||||||||----------------------------
------------------------------------------||||||||--------------||||||||--------------------------------------------------SCCCS2SS----------------||||||||||||||||||||||||||----%%%%%%%%%---------------
------------------------------------------||||||||%%%%%%%%%%%%%%||||||||-------------------g------------g---------------------------%%%%%%%%%%%%%%||||||||||||||||||||||||||----|||||||||-------------F-
------%%%%%-------------------------------||||||||||||||||||||||||||||||------------------------------------------------------------||||||||||||||||||||||||||||||||||||||||----|||||||||------------- -
XXXXXX|||||XXXXXXXXXXXXXX-----XXXXXXXXXXXX||||||||||||||||||||||||||||||-----XXXXXXXXXXXXXX---XXXXXXXXX----XXXXXXXXXXXXXXXXXXXXXXXXX||||||||||||||||||||||||||||||||||||||||----|||||||||XXXXXXXXXXXXFXX