--------------------------------------------------------------------------------------------------------------------------------------------------------------------------------------------------------
--------------------------------------------------------------------------------------------------------------------------------------------------------------------------------------------------------
--------------------------------------------------------------------------------------------------------------------------------------------------------------------------------------------------------
--------------------------------------------------------------------------------------------------------------------------------------------------------------------------------------------------------
--------------------------------------------------------------------------------------------------------------------------------------------------------------------------------------------------------
--------------------------------------------------------------------------------------------------------------------------------------------------------------------------------------------------------
--------------------------------------------------------------------------------------------------------------------------------------------------------------------------------------------------------
------------------------------------------------------------------------------------------------------------------------------------------------------------------tt-----CCUC---------------------------
------------------------------------------------------------------------------------------------------------------------------------------------------------------tt------------------------------------
--------------------------------------------------------U-----------------------------------------------------------------------------------22S222----------------tt------------------------------------
-------------------------------------------------------------------------------------------------------------------------------------------kgkgkkggg----------%%%%%%%%%---------------------------------
------------------------------------------------------------gggggkggggkg---------%%%%%%%%%%-------%%%%%----------------------------------r--------------------|||||||||%%%%%%%%--SSC------SSS-----------
--------------------------g-g--g------------------------------||||||||-----------||||||||||-------|||||---------------------------%%%%%%%%----------%%%%%%%%%%|||||||||||||||||-----------------%%    %%
--------------------------------XXX%%%%--------%%%%%%%%%%%%%--||||||||--%%%%%%%%%||||||||||-g---%%%%%%%%%--------------%%%%%%%----||||||||----------|||||||||||||||||||||||||||-----------------||||| ||
------%%%%%--------------------XXXX||||--------|||||||||||||--||||||||--|||||||||||||||||||-----|||||||||--------------|||||||----||||||||%%%%%%%%%%|||||||||||||||||||||||||||-----------------||||||||
XXXXXX|||||XXXXXXXXXXXXXX-----XXXXXXXXXXXXX----|||||||||||||XXXXXXXXXXXX|||||||||||||||||||-----|||||||||XXXXXXXXXXXXXXXXXXXXXXXXX|||||||||||||||||||||||||||||||||||||||||||||XXXXXXXXXXXXXXXXX||||||||