--------------------------------------------------------------------------------------------------------------------------------------------------------------------------------------------------------
--------------------------------------------------------------------------------------------------------------------------------------------------------------------------------------------------------
--------------------------------------------------------------------------------------------------------------------------------------------------------------------------------------------------------
--------------------------------------------------------------------------------------------------------------------------------------------------------------------------------------------------------
--------------------------------------------------------------------------------------------------------------------------------------------------------------------------------------------------------
--------------------------------------------------------------------------------------------------------------------------------------------------------------------------------------------------------
--------------------------------------------------------------------------------------------------------------------------------------------------------------------------------------------------------
--------------------------------------------------------------------------------------------------------------------------------------------------------------------------------------------------------
--------------------------Tt----------------------------------------------------------------------------------------------------------------------------------------------------------------------------
--------------------------tt----------------------------------------------------------------------------------------------------------------------------------------------------------------------------
--------------------------tt-------K------------------Tt---------------------------------------------------------------------------------------------Tt-------------------------------------------------
-----------------------G%%%%%%%--%%%%%%-%%%%%%%%%-----tt-------------------------------------------------------------------------- ------------------tt------%%%%---------------------------------------
----------------%%%%%%%%%%%||||--||||||-|||||||||-----tt---------------------%%%%%%%%%%--------------------------------G----------%------------------tt------||||---------------------------------------
--------%%%%----|||||||||||||||--||||||-|||||||||--%%%%%%%%%%%%%%--%%%%------||||||||||----------%%%%-----%%%%%%%%%%%%-%%%%%%--%%%|%%%%%%%%%%%%--%%%%%%%%%---||||-----%%%%%-----%%%%%%%%%%-----%%%   ---
--------||||----|||||||||||||||--||||||-|||||||||--||||||||||||||--||||------||||||||||----------||||-----||||||||||||-||||||--||||||||||||||||--|||||||||---||||-----|||||-----||||||||||-----||||||---
XXXXXXXX||||XXXXXXXXXXXXXXXXXXXXXXXXXXXXXXXXXXXXXXXXXXXXXXXX|||||--||||XXXXXXXXXXXXXXXXXXXXXXXXXX||||-----||||XXXXXXXXX||||||XX|||X||||||||||||XX|||||||||XXXXXXXXXXXXXXXXXXXXXX||||||||||XXXXX|||||| XX