--------------------------------------------------------------------------------------------------------------------------------------------------------------------------------------------------------
--------------------------------------------------------------------------------------------------------------------------------------------------------------------------------------------------------
--------------------------------------------------------------------------------------------------------------------------------------------------------------------------------------------------------
--------------------------------------------------------------------------------------------------------------------------------------------------------------------------------------------------------
--------------------------------------------------------------------------------------------------------------------------------------------------------------------------------------------------------
--------------------------------------------------------------------------------------------------------------------------------------------------------------------------------------------------------
--------------------------------------------------------------------------------------------------------------------------------------------------------------------------------------------------------
--------------------------------------------------------------------------------------------------------------------------------------------------------------------------------------------------------
--------------------------------------------------------------------------------------------------------------------------------------------------------------------------------------------------------
-------------------------------------------Tt------------------------------Tt-------------------------------------------Tt-----------Tt---------------------------Tt------------------------------------
-------------------------------------------tt------------------------------tt-------------------------------------------tt-----------tt---------------------------tt------------------------------------
--------------------------------------G----tt------------------------------tt-----------------G-------------------------tt-------- --tt---------------------------tt------------------------------------
-----------------%%%%%%%%%%----------%%%%%%%%%%%---------------------------tt%%%%%%%%--------222C-------------------%%%%%%%%%%--%%%%%%%%%%%%---CUSU------------%%%%%%%%%--------------------------------
-----------------||||||||||-------%%%%%%%%%%%%%%-----------------------%%%%%%%%%%||||-----------2CSUCCC--%%%%%------||||||||||--||||||||||||-----------%%%%%%%%%%|||||||---%%%%%---%%%------------------
-----------------||||||||||-------||||||||||||||-----------------------||||||||||||||--------------------|||||------||||||||||--||||||||||||-----------|||||||||||||||||---|||||---|||-----%%%%%%%   ---
XXXXXXXXXXXXXXXXX||||||||||XXXXXXX|||||XXXXXXXXXXXXXXXXXXXXXXXXXXXXXXXX||||||||||XXXXXXXXXXXXXXXXXXXXXXXXXXXXXXXXXXX||||||||||XXXXXXXXXXXXXXXXXXXXXXXXXXXXXXXXXXXXXXXXXXXXX|||||---|||XXXXX|||||||||| XX