--------------------------------------------------------------------------------------------------------------------------------------------------------------------------------------------------------
--------------------------------------------------------------------------------------------------------------------------------------------------------------------------------------------------------
--------------------------------------------------------------------------------------------------------------------------------------------------------------------------------------------------------
--------------------------------------------------------------------------------------------------------------------------------------------------------------------------------------------------------
--------------------------------------------------------------------------------------------------------------------------------------------------------------------------------------------------------
--------------------------------------------------------------------------------------------------------------------------------------------------------------------------------------------------------
--------------------------------------------------------------------------------------------------------------------------------------------------------------------------------------------------------
--------------------------------------------------------------------------------------------------------------------------------------------------------------------------------------------------------
--------------------------------------------------------------------------------------------------------------------------------------------------------------------------------------------------------
------------------------------Tt-------------------------------------------------------------------------Tt---------------------------------------------------------------------------------------------
------------------------------tt-------------------------------------------------------------------------tt--------------------K-----------------------------------------------Tt-----------------------
------------------------------tt-----------------------K----------------------------------------------G--tt---------%%%%%%%%%%-%-KF---------------------K-G------K-------------tt------%%%%-------------
---------------------22222%%%%%%%-%%------------------%%%------%%%%---------------------------------%%%%%%%%%%------||||||%%%%%G%%%%%-------------------%%%%---%%%%------------tt------||||SUU----------
--------------------------|||||||%||%%----------------|||------||||----%%%%%%-----------------------||||||||||------|||||||||%%%|||||-------------------||||---||||---------%%%%%%%%---||||-------------
-------%%%%%%%%%%%--------||||||||||||----------------|||------||||----||||||-%%%%%------%%%%-------||||||||||------|||||||||||||||||-------------------||||---||||---------||||||||---||||-------------
 X    X||||||||||| X X XXX|||||||X||XX XX XXX    XXX  |||------||||XXXX||||||X|||||------|||| X  XX X XXX X  X XXXXXXX  XXXXXXX X X X X  XX  XXX   XX X ||||---|||| XXXXXXXX||||||||  XX XXX  XXXX XX XX