--------------------------------------------------------------------------------------------------------------------------------------------------------------------------------------------------------
--------------------------------------------------------------------------------------------------------------------------------------------------------------------------------------------------------
--------------------------------------------------------------------------------------------------------------------------------------------------------------------------------------------------------
--------------------------------------------------------------------------------------------------------------------------------------------------------------------------------------------------------
--------------------------------------------------------------------------------------------------------------------------------------------------------------------------------------------------------
--------------------------------------------------------------------------------------------------------------------------------------------------------------------------------------------------------
--------------------------------------------------------------------------------------------------------------------------------------------------------------------------------------------------------
--------------------------------------------------------------------------------------------------------------------------------------------------------------------------------------------------------
--------------------------------------------------------------------------------------------------------------------------------------------------------------------------------------------------------
---------------------------------------------Tt---------------------------------------------------------------------------------------------------------------------------------------------------------
---------------------------------------------tt----------------------------------------------------------------------------------------------------------------K---K------------------------------------
------------------------%%%%%%---------------tt-----------------------------------------------------------------------------------F---------------------------2UCCSCU--G----------------------------%%%%
-------%%%---%%%%-------||||||--------G--%%%%%%%%%%-------------------------------------------------------------K-----------------%-----------%%%%%----%%%%%--------%%%%----------------------------||||
-------|||---||||-------|||%%%%%%%%%%%%--||||||||||%%%%--%%%%%-------------------------------%%%%%%--%%%%%%%%%%%%%%%%%%%%---------K-----------|||||----|||||--------||||----------------------------F|||
-------|||---||||-------|||||%%%%%%%%||--||||||||||||||--|||||-------------------------------||||||--||||||||||||||||||||-%%%%--%%%-----------|||||----|||||--------||||---------%%%-----%%%-------- |||
XXXXXXX|||---||||XXXXXXXXXXXX||||||||XXXX||||||||||||||--|||||XXXXXXXXXXXXXXXXXXXXXXXXXXXXXXX||||||XX||||||||||||||||||||X||||--|||XXXXXXXXXXX|||||----|||||XXXXXXXXXXXXXXXXXXXXX|||-----|||XXXXXXXXXXXX