--------------------------------------------------------------------------------------------------------------------------------------------------------------------------------------------------------
--------------------------------------------------------------------------------------------------------------------------------------------------------------------------------------------------------
--------------------------------------------------------------------------------------------------------------------------------------------------------------------------------------------------------
--------------------------------------------------------------------------------------------------------------------------------------------------------------------------------------------------------
--------------------------------------------------------------------------------------------------------------------------------------------------------------------------------------------------------
--------------------------------------------------------------------------------------------------------------------------------------------------------------------------------------------------------
------------------------------------------------------------------------------------------------------------------------------2SUS2SCSC-%%%%%%%%%-------------------------------------------------------
----------------------------------------------------------------------------------------------------------------------------------------|||||||||--------------------%%%%%%-----------------------------
-------------------------------------------------------------------------------------------r---------------SSSC--------2SSU-------------|||||||||-r------------------||||||-----------------------------
----------------------------------------------------------------------ggkggggk-----------------k----k-----------------------------------|||||||||--------------------||||||-----------------------------
--------------------------------------------------------------------r--||||||-----------------------------------------------------------|||||||||----%%%%%%%%%%-----%%%||||---%%%%%%%%%%----------------
----------------------------------------------------------%%%%%%%%%%%--||||||-%%%%%%%%%%%%-----%%%%%%%%%--------------------------------|||||||||----||||||||||----%%%%%%%%%%%||||||||||----------------
------------------------------%%%%%%----------------------|||||||||||--||||||-||||||||||||-----|||||||||%%%%%%%%%%%%%%%%%%%%------------|||||||||----||||||||||----|||||||||||||||||||||%%%%%%%%%%    %%
--------------------------g---|||g||----------------------|||||||||||%%%%%%%%%||||||||||||-----|||||||||||||||||||||||||||||------------|||||||||----||||||||||----|||||||||||||||||||||||||||||||||| ||
------%%%%%-------------------||||||----------------------||||||||||||||||||||||||||||||||-----|||||||||||||||||||||||||||||------------|||||||||----||||||||||----|||||||||||||||||||||||||||||||||||||
XXXXXX|||||XXXXXXXXXXXXXX---XXXXXXXXXXX-----XXXXXXXXXXXXXX||||||||||||||||||||||||||||||||-----|||||||||||||||||||||||||||||XXXXXXXXXXXX|||||||||----||||||||||----|||||||||||||||||||||||||||||||||||||