--------------------------------------------------------------------------------------------------------------------------------------------------------------------------------------------------------
--------------------------------------------------------------------------------------------------------------------------------------------------------------------------------------------------------
--------------------------------------------------------------------------------------------------------------------------------------------------------------------------------------------------------
--------------------------------------------------------------------------------------------------------------------------------------------------------------------------------------------------------
--------------------------------------------------------------------------------------------------------------------------------------------------------------------------------------------------------
--------------------------------------------------------------------------------------------------------------------------------------------------------------------------------------------------------
--------------------------------------------------------------------------------------------------------------------------------------------------------------------------------------------------------
---------------------------------------------------------------------------------------------------------------Tt---------------------------------------------------------------------------------------
---------------------------------------------------------------------------------------------------------------tt---------------------------------------------------------------------------------------
---------------------------------------------------------------------------------------------------------------tt-------------------------------------------------------------------Tt------------------
---------------------------------------------------------------------------------------------------------------tt---KG--------------------------------------------------------------tt------------------
--------------------------------------SS22C---------------------------------------------------------------%%%%%%%%%%%%---------%%%F%%%%%----------------------------------------G---tt------------------
-----------------------------------------------------------------------%-%------------------------G-------||||||||||||----%%%%%%%%%|||||---------------------------------------%%%%%%%%%%%%-------------
-----------------------------------------------------------------------|-|---------------------USCUS2C----||||||||||||----||||||||||||||---------------------------------------||||||||||||-------------
--------------------------------------------------------------------%%%%%%%%%-----------------------------||||||||||||----||||||||||||||---------------------------------------||||||||||||-------------
 XXXX XXXX XXXXX XXXX XXXXXXX XXXXXXXX XXXXXXXX XX XXXXXXXX  XX XXXX|||||||||XXXXXXXXXXXX XXXXXX XX XXXXXXX XX XX  XX XX X XXXXX X XXXXX XXX X   XXXXXXXXXXXX XXXXXXX X X X   X||||||||||||XX  XXXX XXXX