----------------------------------------------------------------------------------------------------------------------------------------------------    ------------------------------------------------
----------------------------------------------------------------------------------------------------------------------------------------------------    ------------------------------------------------
----------------------------------------------------------------------------------------------------------------------------------------------------    ------------------------------------------------
----------------------------------------------------------------------------------------------------------------------------------------------------    ------------------------------------------------
----------------------------------------------------------------------------------------------------------------------------------------------------    ------------------------------------------------
---------------------------------------------------------------------------------------------------------------------------S2SSS2S------------------    ------------------------------------------------
----------------------------------------------------------------------------------------------------------------------------------------------------    ------------------------------------------------
----------------------------------------------------------------------------------------------------------------------------------------------------    ------------------------------------------------
----------------------------------------------------------------------------------------------------------------------------------------------------    ------------------------------------------------
----------------------------------------------------------#--#----------------------------------------------#--#-----------%%%%%%%--------tt--------    ------------------------------------------------
---------------------------------------------------------##--##--------------------------------------------##--##----------|||||||--------tt--------    ------------------------------------------------
-----------------------------------------------#--#-----###--###------------------------------------------###--###---------|||||||--------tt--------    ------------------------------------------------
-------------%%%--%%%%%%%%---%%%%%------------##--##--%%%%%--%%%%%-----------------------%%---%%--------%%%%%--%%%%%----rG-|||y||k-----%%%%%%%%-----    ------------------------------------------------
-------------|||--||||||||---|||||%%--%%%%%%%%%%--%%%%|||||--|||||------%%%%---%%%%%%--%%||---||%%%%%%%%|||||--|||||%%%%%%%%%%%%%%%%%%%||||||||-----    ------------------------------------------------
-------------|||--||||||||---|||||||--||||||||||--|||||||||--|||||%%--%%||||---||||||--||||---|||||||||||||||--||||||||||||||||||||||||||||||||-----    ------------------------------------------------
XXXXXXXXXXXXX|||--||||||||---|||||||--||||||||||--|||||||||--|||||||--||||||---||||||--||||---|||||||||||||||--||||||||||||||||||||||||||||||||XXXXX    XXXXXXXXXXXXXXXXXXXXXXXXXXXXXXXXXXXXXXXXXXXXXXXX