--------------------------------------------------------------------------------------------------------------------------------------------------------------------------------------------------------
--------------------------------------------------------------------------------------------------------------------------------------------------------------------------------------------------------
--------------------------------------------------------------------------------------------------------------------------------------------------------------------------------------------------------
--------------------------------------------------------------------------------------------------------------------------------------------------------------------------------------------------------
--------------------------------------------------------------------------------------------------------------------------------------------SUCCCSS-%%%%%%%%%%------------------------------------------
----------------------------------------------------------------------------------------------------------------------------------------------------||||||||||------------------------------------------
---------------------------------------------------------------------------------------------------------------------------------------US-----------||||||||||------------------------------------------
----------------------------------------------------------------------------------------------------------------------------------------------------||||||||||------------------------------------------
-------------------------------------------------------------------------------g--------U-----------------------------------------------------------||||||||||-g------g---------------------------------
----------------------------------------------------------------------------------------------------------------------------------------------------||||||||||------------------------------------------
----------------------------------------------------------------------------------------------%%%%%%%%%--------------------------%%%%%%%%%----------||||||||||----%%%%%%%%%%-----%%%%%------------------
----------------------------------------------------gggggggggggg----------------------------gkgkkgkkgkggg------------------------|||||||||----------||||||||||----||||||||||-----|||||--%%%%%%%%%%    %%
----------------------------------------------------------------------------------%%%%%%%%%%--|||||||||--------------------------|||||||||----------||||||||||----||||||||||---%%%%%%%%%||||||||||||| ||
--------------------------------------------------r-------------%%%%%%%%%%%%%%----||||||||||--|||||||||--%%%%%%%%%%--------------|||||||||----------||||||||||----||||||||||---|||||||||||||||||||||||||
------%%%%%-----------------------------%%%%%%%%%%%-------------||||||||||||||----||||||||||--|||||||||--||||||||||---%%%%%%%%%%%|||||||||%%%%%%%%%%||||||||||----||||||||||---|||||||||||||||||||||||||
XXXXXX|||||XXXXXXXXXXXXXX---XXXXXXXXXXXX|||||||||||XXXXXXXXXXXXX||||||||||||||----||||||||||XXXXXXXXXXXXX||||||||||---||||||||||||||||||||||||||||||||||||||||----||||||||||---|||||||||||||||||||||||||