---------------------------------------------------------------------------------------------------------------------------------------------------       ----------------------------------------------
---------------------------------------------------------------------------------------------------------------------------------------------------       ----------------------------------------------
---------------------------------------------------------------------------------------------------------------------------------------------------       ----------------------------------------------
---------------------------------------------------------------------------------------------------------------------------------------------------       ----------------------------------------------
---------------------------------------------------------------------------------------------------------------------------------------------------       ----------------------------------------------
---------------------------------------------------------------------------------------------------------------------------------------------------       ----------------------------------------------
---------------------------------------------------------------------------------------------------------------------------------------------------       ----------------------------------------------
---------------------------------------------------------------------------------------------------------------------------------------------------       ----------------------------------------------
---------------------------------------------------------------------------------------------------------------------------------------------------       ----------------------------------------------
-------------------------------------------------------------------------------UUC2----------------------------------------------------------------       ----------------------------------------------
--------------------------------------------SUS2S--------------Tt-------------------------------------------------#--#-----------------------------       ----------------------------------------------
---------------------------------------------------------------tt------------------------------------------------##--##----------------------------       ----------------------------------------------
-------------------------------------------------------------%%%%%---------------------------------------------%%%%--%%%%--------------------------       ----------------------------------------------
---------------------------%%%%%--%%%-------------%%%%---%%%%|||||-----------%%%%%%%%-------------%%%%%---%%%%%||||--||||%%---%%-----------%%%%%%%%       %%%%%%%%%%%%%%%%%%%%%%%%%%%%%%%%%%%%%%%%%%%%%%
--------------%%%%%---%%%%%|||||--|||------%%%%%%%||||---|||||||||-----------||||||||-------------|||||---|||||||||--||||||---||-----------||||||||       ||||||||||||||||||||||||||||||||||||||||||||||
XXXXXXXXXXXXXX|||||---||||||||||--|||XX--XX|||||||||||---|||||||||XXXX---XXXX||||||||XXXXX---XXXXX|||||---|||||||||--||||||---||XXXXXX---XX||||||||       ||||||||||||||||||||||||||||||||||||||||||||||