--------------------------------------------------------------------------------------------------------------------------------------------------------------------------------------------------------
--------------------------------------------------------------------------------------------------------------------------------------------------------------------------------------------------------
--------------------------------------------------------------------------------------------------------------------------------------------------------------------------------------------------------
--------------------------------------------------------------------------------------------------------------------------------------------------------------------------------------------------------
--------------------------------------------------------------------------------------------------------------------------------------------------------------------------------------------------------
--------------------------------------------------------------------------------------------------------------------------------------------------------------------------------------------------------
--------------------------------------------------------------------------------------------------------------------------------------------------------------------------------------------------------
--------------------------------------------------------------------------------------------------------------------------------------------------------------------------------------------------------
-------------------------------------------------------------------------------------------gg---------------------------------------------------------------------------------------------r-------------
----------------------------------------------------------------------USSSCSS2S--%%%%%%%%%----------------------------------------------------SSS-------------------------------------------------------
---------------------------------------------------------------------------------|||||||||-----%%%%%%%--------------------------------------gkggkrr----------%%%%%%%%-------------------%%%%%-----------
-----------------------------------------------------------------SU2-------------|||||||||-----|||||||------------------------------------r------------------||||||||------------------%%%%%%%----------
--------------------------------------gg-------g------%%%%%----------------------|||||||||-----|||||||----------------------------%%%%%%%%%--------%%%%%%%%%%||||||||------------------|||||||----------
------------------------------%%%--------------------%%%%%|----------------------|||||||||---%%%%%%%%%%%%%------------------------|||||||||--------||||||||||||||||||------------------|||||||---%    %%
------%%%%%-------------------|||----%%%%%%%%%%%-----||||||----------------------|||||||||---|||||||||||||------------------------|||||||||%%%%%%%%||||||||||||||||||----%%%%%%%%%%%%%%%%%%%%%%%%|||| ||
XXXXXX|||||XXXXXXXXXXXXXX-----|||----|||||||||||---XXXXXXXXXXXXXXXXXXXXXXXXXXXXXX|||||||||---|||||||||||||XXXXXXXXX----XXXXXXXXXXX|||||||||||||||||||||||||||||||||||----|||||||||||||||||||||||||||||||