------------------------------------------------------------------------------------------------------------------------------      --------------------------------------------------------------------
------------------------------------------------------------------------------------------------------------------------------      --------------------------------------------------------------------
------------------------------------------------------------------------------------------------------------------------------      --------------------------------------------------------------------
------------------------------------------------------------------------------------------------------------------------------      --------------------------------------------------------------------
------------------------------------------------------------------------------------------------------------------------------      --------------------------------------------------------------------
------------------------------------------------------------------------------------------------------------------------------      --------------------------------------------------------------------
------------------------------------------------------------------------------------------------------------------------------      --------------------------------------------------------------------
------------------------------------------------------------------------------------------------------------------------------      --------------------------------------------------------------------
------------------------------------------------------------------------------------------------------------------------------      --------------------------------------------------------------------
------------------------------------------------------------------------------------------------------------------------------      --------------------------------------------------------------------
----------------------G------G-----------------------------------------------------G------------Tt----------------------------      --------------------------------------------------------------------
--------------------%%%%%%%%%%--------------------------------------------------S222------------tt----------------------------      ----------------2CS22-----------------K-----------K-----------------
--------------------|K||||||||-------------------------------%%%%%%-----%%%%--------------------tt--G-----------------------G-      %%%%%------------------------%%%%%%%%%%-----%%%%%%%%--------%%%%--%%
-------------------%%%||||||||-------------------S2S2--------||||||-----||||-----------------%%%%%%%%------------%%%%------%%%      |||||------------------------||||||||||-----||||||||--------||||--||
-------------------|||||||||||-------------------------------||||||-----||||-----------------||||||||------------||||------|||      %%%%%------------------------||||||||||-----||||||||--------||||--||
XXXXXXXXXXXXXXXXXXXXXXXXXXXXXXXXXXXXXXXXXXXXXXXXXXXXXXXXXXXXX||||||XXXXX||||XXXXXXXXXXXXXXXXX||||||||XXXXXXXXXXXX||||------|||      |||||XXXXXXXXXXXXXXXXXXXXXXXX||||||||||XXXXXXXXXXXXXXXXXXXXX||||--||