--------------------------------------------------------------------------------------------------------------------------------------------------------------------------------------------------------
--------------------------------------------------------------------------------------------------------------------------------------------------------------------------------------------------------
--------------------------------------------------------------------------------------------------------------------------------------------------------------------------------------------------------
--------------------------------------------------------------------------------------------------------------------------------------------------------------------------------------------------------
--------------------------------------------------------------------------------------------------------------------------------------------------------------------------------------------------------
--------------------------------------------------------------------------------------------------------------------------------------------------------------------------------------------------------
------------------------------------------------------------------------------------------------------------------------------SSCSSSSUS2-%%%%%%%%%------------------------------------------------------
-----------------------------------------------------------------------------------------------------------------------------------------|||||||||------------------------------------------------------
------------------------------------------------------------------------------------------------------------------------CSSSUS-----------|||||||||---------------------%%%%%%---------------------------
-----------------------------------------------------------------------------------------------------------------------------------------|||||||||---------------------||||||---------------------------
----------------------------------------------------------------------------------------------------g---------g--------------------------|||||||||-----%%%%%%%%%%------||||||---------------------------
-------------------------------------gkgkkggggkg-----------------------------------------------------------------------------------------|||||||||-----||||||||||------||||||---------------------------
--------------------------------------%%%%%%%%%----------------g-g----g----------------------------%%%%%%%%%%%%%%%%%%%%%%%%%%------------|||||||||-----||||||||||----%%%%%%%%%%-rr-----------%%%%%    %%
-----------------------------------r--|||||||||-%%%%%%%%%%%----------------------------------------||||||||||||||||||||||||||------------|||||||||-----||||||||||----||||||||||--------------|||||||| ||
------%%%%%--------------%%%%%%%%%%%--|||||||||-|||||||||||---%%%%%%%%%%%--------------------------||||||||||||||||||||||||||------------|||||||||-----||||||||||----||||||||||%%%%%%%%%%%%%%|||||||||||
XXXXXX|||||XXXXXXXXXXXXXX|||||||||||XXXXXXXXXXXX|||||||||||---|||||||||||-----XXX----XXXXXXXXXXXXXX||||||||||||||||||||||||||XXXXXXXXXXXX|||||||||-----||||||||||----|||||||||||||||||||||||||||||||||||