--------------------------------------------------------------------------------------------------------------------------------------------------------------------------------------------------------
--------------------------------------------------------------------------------------------------------------------------------------------------------------------------------------------------------
--------------------------------------------------------------------------------------------------------------------------------------------------------------------------------------------------------
--------------------------------------------------------------------------------------------------------------------------------------------------------------------------------------------------------
--------------------------------------------------------------------------------------------------------------------------------------------------------------------------------------------------------
--------------------------------------------------------------------------------------------------------------------------------------------------------------------------------------------------------
--------------------------------------------------------------------------------------------------------------------------------------------------------------------------------------------------------
--------------------------------------------------------------------------------------------------------------------------------------------------------------------------------------------------------
-----------------------------------------------------------------Tt-------------------------------------------------------------------------------------------------------------------------------------
-----------------------------------------------------------------tt---Tt----------------Tt------------------------------------------------------------------------------------------------------------Tt
------------------------Tt---------------------------------------tt---tt----------------tt-K----------------------------------------------------------------------------------------------Tt----------tt
------------------------tt------------------------------------G--tt---tt----------------tU2UC22--------------------%%%%----------- -------------------------------------------------------tt---------Gtt
------------------------tt----------------------------------%%%%%%%%K%tt----------------tt--------%%%%--%%%%-------||||---%-%-----%-------------------------------------------------------tt------    %%
--------%%%%%%-----%%%%%%%%%%%----2SSS----------------------|||||||%%%%%%%%%-------%%%%%%%%%%%----||||--||||-------|||%%%%%%%%%%%%|------------%%%------%%%-------%%%%%%%%%%-----------%%%%%%%%%%-||||||
--------||||||-----|||||||||||------------------------------||||||||||||||||--%%%--|||||||||||----||||--||||-------||||||||||||||||------------|||------|||-------||||||||||-----------||||||||||-||||||
XXXXXXXXXXXXXXXXXXXXXXXXXXXXXXXXXXXXXXXXXXXXXXXXXXXXXXXXXXXXXXXXXXXXXXXXXXXXXX|||XXXXXXXXXXXXXXXXX||||--||||XXXXXXXXXX||||||||||||XXXXXXXXXXXXX|||------|||XXXXXXX||||||||||XXXXXXXXXXX||||||||||X||||||