--------------------------------------------------------------------------------------------------------------------------------------------------------------------------------------------------------
--------------------------------------------------------------------------------------------------------------------------------------------------------------------------------------------------------
--------------------------------------------------------------------------------------------------------------------------------------------------------------------------------------------------------
--------------------------------------------------------------------------------------------------------------------------------------------------------------------------------------------------------
--------------------------------------------------------------------------------------------------------------------------------------------------------------------------------------------------------
--------------------------------------------------------------------------------------------------------------------------------------------------------------------------------------------------------
--------------------------------------------------------------------------------------------------------------------------------------------------------------------------------------------------------
-------------------------------------------------------------------------------------U------------------------------------------------------------gkkgggggggggg-----------------------------------------
--------------------------------------------------------------------------------------------SC2SS-----------------------------------------------r--|||||||||||------------g----g------------------------
----------------------------------------------------------------------------------------------------------------------------------------%%%%%%%%%--|||||||||||-%%%%%%%%%%-------------------------------
-----------------------------------------------------------------------------------------kgkgkgggkg----------------------------%%%%%%---|||||||||--|||||||||||-||||||||||%%%%%%%%--------%%%%%%%%%    %%
--------------------------------------------%%%%%%-----------------------CU---%%%%%%%%%%%--------------------------------------||||||---|||||||||%%%%%%%%%%%%%%||||||||||||||||||%%%%%%%%|||||||||||| ||
--------------------------------------------||||||----------------------------|||||||||||----------%%%%%%%%------------------%%%%%%%%%%%||||||||||||||||||||||||||||||||||||||||||||||||||||||||||||||||
--------------------------g-g---------------||||||----------------------------|||||||||||----------||||||||--------gg--------|||||||||||||||||||||||||||||||||||||||||||||||||||||||||||||||||||||||||||
------%%%%%---------------------------------||||||----------------------------|||||||||||%%%%%%%%%%||||||||------------------|||||||||||||||||||||||||||||||||||||||||||||||||||||||||||||||||||||||||||
XXXXXX|||||XXXXXXXXXXXXXX----XXXXXXXXX----XXXXXXXXXXX---XXXXXXXXXXXXXXXXXXXXXX|||||||||||||||||||||||||||||----XXXXXXXXXXXXXX|||||||||||||||||||||||||||||||||||||||||||||||||||||||||||||||||||||||||||