--------------------------------------------------------------------------------------------------------------------------------------------------------------------------------------------------------
--------------------------------------------------------------------------------------------------------------------------------------------------------------------------------------------------------
--------------------------------------------------------------------------------------------------------------------------------------------------------------------------------------------------------
--------------------------------------------------------------------------------------------------------------------------------------------------------------------------------------------------------
--------------------------------------------------------------------------------------------------------------------------------------------------------------------------------------------------------
--------------------------------------------------------------------------------------------------------------------------------------------------------------------------------------------------------
--------------------------------------------------------------------------------------------------------------------------------------------------------------------------------------------------------
--------------------------------------------------------------------------------------------------------Tt----------------------------------------------------------------------------------------------
--------------------------------------------------------------------------------------------------------  ----------------------------------------------------------------------------------------------
--------------------------------------------------------------------------------------------------------tt----------------------------------------------------------------------------------------------
---------------------------------------- t--------------------------------------------------------------tt-K--------------------------------------------------------------------------------------------
----------------------------------------  -----------------------------------------------------------%%% %%%%---------------------F---------------------------------------------------------------------
---------------------------------------Gtt--------------------------------------K---------K----------||||||||--------------K------%-K------------------%%%%%%--------------------G-------K-K------------
-----------------------------------% %%% %%%%%---------------------------------%%%%-----%%%%%--------||||||||--------------%%%----%%%% ----------------||||||-------------%%%--%%% ----%%% %------------
-----------------------------------|||||||||||---------------------------------||||-----|||||--------||||||||--%%%% %------|||----|||||----------------||||||-------------|||--||||----|||||------------
 XXXX XXX X XX XX XXX  XXXXXX XXXXXXXXXX   XXXX XXXXXXX X X XX XXX X   X X  X  ||||-----|||||X X XXXXXXXXXXXXXX||||||  X   |||----|||||XXXXXXXXXXXXXXXXXXX  XXX X XXXXXXXX|||--||||XXXX|||||XXXXXXXXXXXX