--------------------------------------------------------------------------------------------------------------------------------------------------------------------------------------------------------
--------------------------------------------------------------------------------------------------------------------------------------------------------------------------------------------------------
--------------------------------------------------------------------------------------------------------------------------------------------------------------------------------------------------------
--------------------------------------------------------------------------------------------------------------------------------------------------------------------------------------------------------
--------------------------------------------------------------------------------------------------------------------------------------------------------------------------------------------------------
--------------------------------------------------------------------------------------------------------------------------------------------------------------------------------------------------------
--------------------------------------------------------------------------------------------------------------------------------------------------------------------------------------------------------
--------------------------------------------------------------------------------------------------------------------------------------------------------------------------------------------------------
--------------------------------------------------------------------------------------------------------------------------------------------------------------------------------------------------------
--------------------------------------------------------------------------------------------------------------------------------------------------------------------------------------------------------
-----------------------------------------------------------------------------------------%%%%%%%%-----------------------------------------------------------------------------------%%%%%---------------
-----------------------------------------------------------------------------------------||||||||--------------------------------------------------------SSCUCSC--------------------|||||---------------
---------------------------------------------------------------------------------------%%%%%%%%%%%%%%--------------------------------------k----------------------------------------|||||---------------
-------------------------------------------------g------------------g-------------Tt---||||||||||||||-g--k--r----------------rk-r-%%%%%%--------------------------------------r-----|||||----------F----
------%%%%%--------------------------%%%%%%%%-------------------------------------tt---||||||||||||||-----------------------------||||||---------------------------%%%%%%%%%%-----%%%%%%%%--------- ----
XXXXXX|||||XXXXXXXXXXXXXX-----XXX----||||||||---XXXXXXXXXXXXX----XXXXXXXXXXXXXXXXXXXXXX||||||||||||||XXXXXXXXXXXXXXXXXXXXXXX----XXXXXXXXXX----XXXXXXXXXXXXXXXXXXXXX||||||||||-----||||||||XXXXXXXXXXXFXX