--------------------------------------------------------------------------------------------------------------------------------------------------------------------------------------------------------
--------------------------------------------------------------------------------------------------------------------------------------------------------------------------------------------------------
--------------------------------------------------------------------------------------------------------------------------------------------------------------------------------------------------------
--------------------------------------------------------------------------------------------------------------------------------------------------------------------------------------------------------
--------------------------------------------------------------------------------------------------------------------------------------------------------------------------------------------------------
--------------------------------------------------------------------------------------------------------------------------------------------------------------------------------------------------------
--------------------------------------------------------------------------------------------------------------------------------------------------------------------------------------------------------
-----------------------------------------------------------------------------------------------------------------------------ggggggk--------------------------------------------------------------------
-------------------------------------------------------------------------------------------------------g---g---------------r--|||||---------------------------------------------------------------------
-----------------------------------U---------------------------------------------------------------------------%%%%%%%%%%%%%--|||||-%%%%%%%%%%%%-------%%%%%%%--------------------%%%%%%%---------------
-------------------------------------------SS22C2C----------------------------------------------------%%%%%%%%%|||||||||||||--|||||-||||||||||||-------|||||||-----------------k--|||||||---------------
--------------------------g------------ggkgggkgkgggk--------------------------------------------------||||||||||||||||||||||%%%%%%%%||||||||||||------%%%%||||--------------------|||||||---------------
-----------------------------------------------------------------------------------%%%----------------||||||||||||||||||||||||||||||||||||||||||-----%%%%%%%%%%%%%---%%%%%%%%%%%%%%%%%%%%%%%------------
-----------------------------%%%%%%%%%%-------------%%%%%%%%%%%%------g------------|||----%%%%%%%%%%%%||||||||||||||||||||||||||||||||||||||||||-----|||||||||||||-gg|||||||||||||||||||||||------------
------%%%%%------------------||||||||||-------------||||||||||||-------------------|||----||||||||||||||||||||||||||||||||||||||||||||||||||||||-----|||||||||||||---|||||||||||||||||||||||------------
XXXXXX|||||XXXXXXXXXXXXXX----||||||||||XXXXXXXXXXXXX||||||||||||-----XXXXXXXXX-----|||----||||||||||||||||||||||||||||||||||||||||||||||||||||||-----|||||||||||||---|||||||||||||||||||||||XXXXXX    XX