--------------------------------------------------------------------------------------------------------------------------------------------------------------------------------------------------------
--------------------------------------------------------------------------------------------------------------------------------------------------------------------------------------------------------
--------------------------------------------------------------------------------------------------------------------------------------------------------------------------------------------------------
--------------------------------------------------------------------------------------------------------------------------------------------------------------------------------------------------------
--------------------------------------------------------------------------------------------------------------------------------------------------------------------------------------------------------
--------------------------------------------------------------------------------------------------------------------------------------------------------------------------------------------------------
--------------------------------------------------------------------------------------------------------------------------------------------------------------------------------------------------------
--------------------------------------------------------------------------------------------------------------------------------------------------------------------------------------------------------
--------------------------------------------------------------g-------g------------------------------------------------------------------------------------CCCCSS---------------------------------------
-------------------------------------gggggggggggkk-------------------------------------------------------------------------------------------------------ggkggkggkg-------------------------------------
-----------------------------------r--|||||||||||-----------------------------------------CSU2SCCCS-------------------------g----g---------------------r----------------------------------%%%%%%%%    %%
-------------------------%%%%%%%%%%%--|||||||||||-%%%%%%%%%%%-----------------------------------------------------------------------------%%%%%%%%%%%%%%-----------%%%%%%%%%%%-----g------||||||||||| ||
-------------------------|||||||||||--|||||||||||-|||||||||||--------------------%%%%%--------------------%%%---------------%%%%%%%%%%%%%%||||||||||||||-----------|||||||||||------------||||||||||||||
-------------------------|||||||||||%%%%%%%%%%%%%%|||||||||||---%%%%%%%%%%%g-----|||||--------------------|||---------------||||||||||||||||||||||||||||%%%%%%%%%%%|||||||||||----%%%%%%%%||||||||||||||
------%%%%%--------------||||||||||||||||||||||||||||||||||||---|||||||||||----%%%%%%%%%%%%%%%%%%%%%%-----|||----%%%%%%%%%%%||||||||||||||||||||||||||||||||||||||||||||||||||----||||||||||||||||||||||
XXXXXX|||||XXXXXXXXXXXXXX||||||||||||||||||||||||||||||||||||---|||||||||||----||||||||||||||||||||||-----|||----|||||||||||||||||||||||||||||||||||||||||||||||||||||||||||||----||||||||||||||||||||||