--------------------------------------------------------------------------------------------------------------------------------    --------------------------------------------------------------------
--------------------------------------------------------------------------------------------------------------------------------    --------------------------------------------------------------------
--------------------------------------------------------------------------------------------------------------------------------    --------------------------------------------------------------------
--------------------------------------------------------------------------------------------------------------------------------    --------------------------------------------------------------------
--------------------------------------------------------------------------------------------------------------------------------    --------------------------------------------------------------------
--------------------------------------------------------------------------------------------------------------------------------    --------------------------------------------------------------------
--------------------------------------------------------------------------------------------------------------------------------    --------------------------------------------------------------------
--------------------------------------------------------------------------------------------------------------------------------    --------------------------------------------------------------------
--------------------------------------------------------------------------------------------------------------------------------    --------------------------------------------------------------------
------------------------Tt------------------------------------------------------------------------------Tt----------------------    -----------------------------------Tt-------------------------------
----------Tt------------tt--------------------Tt--------------------------------------------K-----------tt----------------------    -----------------------------------tt------------G------------------
----------tt------------tt------------SCC2C---tt--------------------K-------------2SC-----2CU-----------tt-K---------%%%%%%%Tt%%    -----------------------------------tt-----%%%%%%%%%%%---------------
----------tt--------%%%%%%%%%%------------G---tt---------------%%%--%%%------------------------------%%%%%%%%%-----K-|||||||tt||    -------------------------------%%%%%%%%%--|||||||||||--------%%%%%--
----------tt--------||||||||||---%%%%%%%%%%%%%%%%%%%%----------|||--|||--------------------UC--------|||||||||%%%%%%-||||%%%%%%%    -------------------------------|||||||||--%%%%|||UCS|--------|||||--
-------%%%%%%%%%%---||||||||||---||||||||||||||||||||----------|||--|||------------------------------|||||||||||||||-|||||||||||    -------------------------------|||||||||--|||||||||||--------|||||--
XXXXXXX||||||||||XXX||||||||||XXXXXXXXXXXXXXXXXXXXXXXXXXXXXXXXX|||--|||XXXXXXXXXXXXXXXXXXXXXXXXXXXXXXXXXXXXXXX||||||XXXXXXXXXXXX    XXXXXXXXXXXXXXXXXXXXXXXXXXXXXXXXXXXXXXXXXX||||XXXXXXXXXXXXXXX|||||--