----------------------------------------------------------------------------------------------------------------------------        --------------------------------------------------------------------
----------------------------------------------------------------------------------------------------------------------------        --------------------------------------------------------------------
----------------------------------------------------------------------------------------------------------------------------        --------------------------------------------------------------------
----------------------------------------------------------------------------------------------------------------------------        --------------------------------------------------------------------
----------------------------------------------------------------------------------------------------------------------------        --------------------------------------------------------------------
----------------------------------------------------------------------------------------------------------------------------        --------------------------------------------------------------------
----------------------------------------------------------------------------------------------------------------------------        --------------------------------------------------------------------
----------------------------------------------------------------------------------------------------------------------------        --------------------------------------------------------------------
-----------------------------Tt---------------------------------------------------------------------------------------------        --------------------------------------------------------------------
--------------Tt-------------tt---------------------------------------------------------------------------------------------        --------------------------------------------------------------------
--------------tt-------------tt----------------G----------------------------------------------------------------------------        --------------------------------------------------------------------
--------K-----tt--G----%%%%%%%%%G-G--------%%%%%%---------------------------------------------------------------------------        ---------------------------------------------------K----------------
--------2%%%%%%%%%%%---||%%%%%%%%%%----%%%%||||||-%%%%-----------K----------------------------------------------------------        -------------------------------------K----------%%%%------%%%-------
---------|||||||||||---||||||||||||----||||||||||-||||--%%%%%--%%%%-------------K-----%%%--------------SS2SU----------------        ----------------K-------------------%%%%%%%%%%--||||------|||----%%%
---------|||||||||||---||||||||||||----||||||||||-||||--|||||--||||----%%%%%----%%%%--|||-----------------------------------        ----------%%%-%%%%%%%%%%------------||||||||||--||||------|||----|||
XXXXXXXXX|||||||||||XXXXXXXXXXXXXXXXXXXXXXXXXXXXXXXXXXXX|||||--||||XXXX|||||----||||XX|||XXXXXXXXXXXXXXXXXXXXXXXXXXXXXXXXXXX        XXXXXXXXXX|||X||||||||||XXXXXXXXXXXXXXXXXXXXXXXX||||------|||XXXX|||