--------------------------------------------------------------------------------------------------------------------------------------------------------------------------------------------------------
--------------------------------------------------------------------------------------------------------------------------------------------------------------------------------------------------------
--------------------------------------------------------------------------------------------------------------------------------------------------------------------------------------------------------
--------------------------------------------------------------------------------------------------------------------------------------------------------------------------------------------------------
--------------------------------------------------------------------------------------------------------------------------------------------------------------------------------------------------------
--------------------------------------------------------------------------------------------------------------------------------------------------------------------------------------------------------
--------------------------------------------------------------------------------------------------------------------------------------------------------------------------------------------------------
-------------------------------------------------------------------------------------------------------------------Tt-----------------------------------------------------------------------------------
-------------------------------------------------------------------------------------------------------------------tt-----------------------------------------------------------------------------------
-------------------------Tt--------------------------------Tt------------------------------------------------------tt-----------------------------------------------------------------------------------
-------------------------tt--------------------Tt----------tt------------------------------------------------------tt-----------------------------------------Tt----------------------------------------
-------------------------tt--------------------tt----------tt---------------------------------------------------%%%%%%%%%--------- --------------K---------G--tt----------------------------------------
---------------K---------tt-------%%%%%%%%%%CK2tt----------t--GG-----------------------------------------------S|||||||||---------%--------%%%%%%%%-%%%%%%%%%%tt--------K-G-----------------------------
----------%%%%%%----%%%%%%%%%%%---||||||||||%%%%%%%%%-%%%%%%%%%%-------------------%%%%-------------------------||||||||%%%%%%%%%-|--------||||||||-|||||||%%%%%%%%-----%%%%%-----%%%%------------------
----------||||||----|||||||||||---|||||||||||||||||||-||||||||||-------------------||||-------------------------|||||||||||||||||-|-%%%%%%%%%%%||||-|||||||||||||||-----|||||-----||||------------------
XXXXXXXXXXXXXXXXXXXXXXXXXXXXXXXXXX||||||||||XXXXXXXXXXXXXXXXXXXXXXXXXXXXXXXXXXXXXXX||||XXXXXXXXXXXXXXXXXXXXXXXXXXXXXXXXXXXXXXXXXXXXX|||||||||||XXXXXXXXXXXXXXXXXXXXXXXXX|||||-----||||XXXXXXXXXXXX    XX