--------------------------------------------------------------------------------------------------------------------------------------------------------------------------------------------------------
--------------------------------------------------------------------------------------------------------------------------------------------------------------------------------------------------------
--------------------------------------------------------------------------------------------------------------------------------------------------------------------------------------------------------
--------------------------------------------------------------------------------------------------------------------------------------------------------------------------------------------------------
--------------------------------------------------------------------------------------------------------------------------------------------------------------------------------------------------------
--------------------------------------------------------------------------------------------------------------------------------------------------------------------------------------------------------
--------------------------------------------------------------------------------------------------------------------------------------------------------------------------------------------------------
-------------------------------------------------------------------------------------------------------------------------------------U------------------------------------------------------------------
--------------------------------------------------------------------------------------------------------------------------------------------------------------------------------------------------------
----------------------------------------S22SS------------g-------gg------------------------------------------------------------------------%%%%%%%------------------------------------------------------
--------------------------------------ggkgkkkkgg-------------------------------------gggggggggg------------------------------------------ggggggggggg----------------------------------------------------
------------------------------------r----------------------------------------------r--||||||||--------------------------------%%%%%%%%%%%--|||||||--------------------------------U2S---%%%%%%%%%%    %%
-------------------------%%%%%%%%%%%%-----------%%%%%%%%-------------------%%%%%%%%%--||||||||-%%%%%%%%-----------------------|||||||||||--|||||||--%%%%%%%%%%%%------------------------||||||||||||| ||
-------------------------||||||||||||-----------||||||||-------------------|||||||||--||||||||-||||||||-----g----g------------|||||||||||--|||||||--||||||||||||------gg----------------||||||||||||||||
------%%%%%--------------||||||||||||%%%%%%%%%%%||||||||-------------------|||||||||%%%%%%%%%%%||||||||-----------------------|||||||||||%%%%%%%%%%%||||||||||||------------------------||||||||||||||||
XXXXXX|||||XXXXXXXXXXXXXX|||||||||||||||||||||||||||||||-----XXXXXXXXXXXXXX||||||||||||||||||||||||||||----XXXXXXXXXXXXXXXXXXX||||||||||||||||||||||||||||||||||-----XXXXXXXXXXXXXXXXXXX||||||||||||||||