--------------------------------------------------------------------------------------------------------------------------------------------------------------------------------------------------------
--------------------------------------------------------------------------------------------------------------------------------------------------------------------------------------------------------
--------------------------------------------------------------------------------------------------------------------------------------------------------------------------------------------------------
--------------------------------------------------------------------------------------------------------------------------------------------------------------------------------------------------------
--------------------------------------------------------------------------------------------------------------------------------------------------------------------------------------------------------
--------------------------------------------------------------------------------------------------------------------------------------------------------------------------------------------------------
--------------------------------------------------------------------------------------------------------------------------------------------------------------------------------------------------------
--------------------------------------------------------------------------------------------------------------------------------------------------------------------------------------------------------
--------------------------------------------------------------------------------------------------------------------------------------------------------------------------------------------------------
-------------------------------U------------------------------------------------------------------------------------------------------------------------------------------------------------------------
---------------------------------------SSSC2C----------------------------------------------------------------------------------------------------------------------------------r------------------------
-----------------------------------gkgggkggkggg-------------------------------------------g----g-----------------------SC2S------------------------------------r------------------------tt--------------
--------------------------------------------------------------------------------------------------------gg------------------------------------------------------------k-----------------tt-----%%%    %%
-------------------------%%%%%%%%%%------------%%%%%%%%%%%%%%-----g-----------------------------%%%%%-------------------------------g---g---------r----------%%%%%%---------------------tt-----|||||| ||
------%%%%%--------------||||||||||------------||||||||||||||-----------------------------------|||||--------------------------------------------------------||||||--%%%%%%%%----%%%%%%%%%%%%%%|||||||||
XXXXXX|||||XXXXXXXXXXXXXX||||||||||XXXXXXXXXXXX||||||||||||||----XXXXXXXXXXX---XXXXXXXXXX-----XXXXXXXXX---XXXXXXXXXXXXXXXXXXXX-----XXXXXXXXXX----XXXXXXXXXXXXXXXXXXXX||||||||----|||||||||||||||||||||||