---------------------------------------------------------------------------------------------------------------------------------         --------------------------------------------------------------
---------------------------------------------------------------------------------------------------------------------------------         --------------------------------------------------------------
---------------------------------------------------------------------------------------------------------------------------------         --------------------------------------------------------------
---------------------------------------------------------------------------------------------------------------------------------         --------------------------------------------------------------
---------------------------------------------------------------------------------------------------------------------------------         --------------------------------------------------------------
---------------------------------------------------------------------------------------------------------------------------------         --------------------------------------------------------------
---------------------------------------------------------------------------------------------------------------------------------         --------------------------------------------------------------
---------------------------------------------------------------------------------------------------------------------------------         --------------------------------------------------------------
---------------------------------------------------------------------------------------------------------------------------------         ------------Tt------------------------------------------------
---------------------------------------------------------------------------------------------------------------------------------         ------------tt------------------------------------------------
----------------------------------------------------------------------------------------Tt---------------------------------------         ------------tt---------G--------------------Tt------------G---
------------------------------------Tt-------------------------------TK-----------------tt----%%%%U2CU--------%%%%%%%%%----------         ------------tt------%%%%%%%%%%%%------------tt-%%%%%%%%%%%----
------------------------------------tt---------G----------K----------tt%%%--------------tt----||||--------%%%%%%%%|||||--------%%         ---K-----%%%GG%%%---||||||||||||------------tt-|||||||||||----
------------%%%%%%2SCCC---%%%%%-----tt---------%%%%%----%%%----------tt%%K---------%%%%%%%%%%-||||--------|||||||||||||--------||         %%%%%%%%%%%%%%|||---||||||||||||---------%%%tt-|||||||%%%%%%%%
------------||||||--------|||||-%%%%%%%%%%-----|||||----|||------%%%%%%%%%%--------||||||||||-||||--------|||||||||||||-------%%%         |||||||||||||||||---||||||||||||---------%%%%%%%%%%|||||||||||
XXXXXXXXXXXX||||||XXXXXXXX|||||X||||||||||XXXXX|||||----|||XXXXXX||||||||||XXXXXXXX||||||||||XXXXXXXXXXXXX||||||||XXXXXXXXXXXX|||         XXXXXXXXXXXXXXXXXXXXXXXXXXXXXXXXXXXXXXXXX||||||||||XXX||||||||