--------------------------------------------------------------------------------------------------------------------------------------------------------------------------------------------------------
--------------------------------------------------------------------------------------------------------------------------------------------------------------------------------------------------------
--------------------------------------------------------------------------------------------------------------------------------------------------------------------------------------------------------
--------------------------------------------------------------------------------------------------------------------------------------------------------------------------------------------------------
--------------------------------------------------------------------------------------------------------------------------------------------------------------------------------------------------------
--------------------------------------------------------------------------------------------------------------------------------------------------------------------------------------------------------
--------------------------------------------------------------------------------------------------------------------------------------------------------------------------------------------------------
--------------------------------------------------------------------------------------------------------------------------------------------------------------------------------------------------------
----------------------------------------Tt--------------------------------------------------------------------------------------------------------------------------------------------------------------
----------------------------------------tt-------------------------------------Tt-----------------------------------------------------------------------------------------------------------------------
----------------------------------------tt-------------------------------------tt-------------------------------------------------------------------------------------------------------------G---------
------------------------------------%%%%%%%%%%-------------------%%%-----------tt------2USSSS------------------------------------- --------------------------------------------------%%%%%%%%%%---------
-----------------K--------2SU-------||%%%|||||-------------------|||----------Ktt-G-----------------------------------------G-----%%%%----------------G------------------------------||||||||||---------
---------%%%%%%%%%%-----------------||||||||||------K---------G--USS-------%%%%%%%%%%-----------------------------%%%%%----%%%----||||------------%%%%%%%%%%----------G--------------||||||||||---------
---------||||||||||-----------------||||||||||-----%%%%-----%%%%%|||-------||||||||||-----------------------------|||||----|||----||||------------||||||||||-%%%-----%%%%------------||%%%%%|||------ %%
XXXXXXXXXXXXXXXXXXXXXXXXXXXXXXXXXXXXXX|||XXXXXXXXXX||||-----|||||XXXXXXXXXX||||||||||XXXXXXXXXXXXXXXXXXXXXXXXXXXXX|||||----|||XXXXXXXXXXXXXXXXXXXXXXXXXXXXXXX|||-----||||XXXXXXXXXXXXXX|||||XXXXXX   |||