------------------------------------------------------------------------------------------------------------------------------------------------------------------------------- ------------------------
--------------------------------------------------------------------------------------------------------------------------------------------------------------------------------------------------------
--------------------------------------------------------------------------------------------------------------------------------------------------------------------------------------- ----------------
-------------------------------------------------------------------------------------------------------------------------------------- -----------------------------------------------------------------
--------------------------------------------------------------------------------------------------------------------------------------------------------------------------------------------------------
-------------------------------------------------------------------------------------------------------- --------------- -------------------------------------------------------------------------------
--------------------------------------------------------------------------------------------------------------------------------------------------------------------------------------------------------
--------------------------------------------------------------------------------------------------------------------------------------------- ------------------- --------------------------------------
-------------- ---------------------------------------CCSSSCSS------------------------------------------------------------------------------%%%%%%%-----------------------------------------------------
---- -----------------------------------------------gkgggkgkggkg------------------------------------SSUCS222-%%%%%%%%%%---------------------|||||||-------SSSSC2S----------------- ---------------------
--------------------------------------------------r---------------------------------------------------- -----||||||||||---------------------||||| |-------------------------- ------------ -------------
--------------------------------------%%%%%%%%%%%%%-------------%%%%%%%%----------------------SCU2S----------||||||||||-----%%%%%%%%%%%%%%%%%%%%%%%%%%%-k-----------------------------------------------
--------------------------------------|||||||||||||-------------||||||||-------------------------------------||||||||||-----|||||||||||||||||||||||||||---------- ------------- ------------------------
----------------------- -------%%%%%--|||||||||||||%%%%%%%%%%%%%||||||||----gg-------g-----------------------||||||||||-----|||||||||||||||||||||||||||%%%%%%%%%% %--------r----------------------------
------%%%%%--------------------|||||--||||||||||||||||||||||||||||||||||-------------------------------------||||||||||-----|||||||||||||||||||||||||||||||||||||||-------------------------------------
XXXXXX|||||XXXXXXXXXXXXXX----XXXXXXXXX||||||||||||||||||||||||||||||||||---XXXXXXXXXXXXXXXXXXXXXXXXXXXXXXXXXX||||||||||-----|||||||||||||||||||||||||||||||||||||||-----XXXXXXXXXXXXXX---XXXXXXXXXXXX XX