--------------------------------------------------------------------------------------------------------------------------------------------------------------------------------------------------------
--------------------------------------------------------------------------------------------------------------------------------------------------------------------------------------------------------
--------------------------------------------------------------------------------------------------------------------------------------------------------------------------------------------------------
--------------------------------------------------------------------------------------------------------------------------------------------------------------------------------------------------------
--------------------------------------------------------------------------------------------------------------------------------------------------------------------------------------------------------
--------------------------------------------------------------------------------------------------------------------------------------------------------------------------------------------------------
--------------------------------------------------------------------------------------------------------------------------------------------------------------------------------------------------------
--------------------------------------------------------------------------------------------------------------------------------------------------------------------------------------------------------
--------------------------------------------------------------------------------------------------------------------------------------------------------------------------------------------------------
--------------------------------------------------------------------------------------------------------------------------------------------------------------------------------------------------------
------------------------------------------------------------------------K----------------------------------------------------Tt-------------------------------------------------------------------------
----------------------------------%%%%%-----------------------------SCUSCUS------------%%%%--------%%%%%%%%%%----------------tt---F-----------------GK-2----------G--------------Tt----------Tt---------
----------------------K-----------|||||------------------------------------------------||||----CCSU||||||||||----------------tt---%------%%%%%-----%%%%--------%%%%%-----%%%-----tt----------tt--------S
----------------%%%%--%%%%--------|||||------------------------------------------------||||--------||||||||||----------------tt---|------|||||-----||||--------|||||-----|||-----tt----------tt-----F---
----------------||||--||||--------|||||------------------%%%%%%%%%%--------------------||||--------||||||||||------------%%%%%%%%%|------|||||-----||||--------|||||-----|||%%%%%%%%%%---%%%%%%%%%%- ---
XXXXXXXXXXXXXXXX||||--||||XXXXXXXXXXXXXXXXXXXXXXXXXXXXXXX||||||||||XXXXXXXXXXXXXXXXXXXXXXXXXXXXXXXXXXXXXXXXXXXXXXXXXXXXXX|||||||||XXXXXXX|||||-----||||XXXXXXXX|||||-----|||||||||||||XXX||||||||||XXXXX