--------------------------------------------------------------------------------------------------------------------------------        ----------------------------------------------------------------
--------------------------------------------------------------------------------------------------------------------------------        ----------------------------------------------------------------
--------------------------------------------------------------------------------------------------------------------------------        ----------------------------------------------------------------
--------------------------------------------------------------------------------------------------------------------------------        ----------------------------------------------------------------
--------------------------------------------------------------------------------------------------------------------------------        ----------------------------------------------------------------
--------------------------------------------------------------------------------------------------------------------------------        ----------------------------------------------------------------
--------------------------------------------------------------------------------------------------------------------------------        ----------------------------------------------------------------
--------------------------------------------------------------------------------------------------------------------------------        ----------------------------------------------------------------
-------------------------------------------Tt-----------------------------------------------------------------------------------        ----------------------------------------------------------------
-------------------------------------------tt-----------------------------------------------------------------------------------        ----------------------------------------------------------------
-------------------------------------------tt------------------------------------------------------------G----Tt----------------        -------------------------------------G-Tt-----------------------
------------------------2C---------------K-tt--2S---------SUKS2C-----------------------G----------------222---tt----------------        --------%%%%%%%%%%%%--------Tt------%%%tt-----------------------
---------------------------------------%%%%%%%%%----%%%%%%%%%%--------------%%%--%%%--%%%%%Tt%%%%%----------%%tt%%%%%-----------        --------||||||||||||--------tt------|||tt----2%%%%%%%%----------
------------%%%---%%%%------------G----|||||||||----||||||||||--------2S2---|||--|||--|||||tt|||||----------||tt|||||-----------        ----%%%%%%%|||||||||-----G--tt------%%%%%%%%%-|||%%%||----------
------------|||---||||-----%%%%--%%%%--|||||||||----||||||||||--------------|||--|||--%%%%%%%%%%%%---------%%%%%%%%%|%%%%---%%%%        ----||||||||||||||||----%%%%%%%%%%%-|||||||||-||||||||------%%%%
XXXXXXXXXXXX|||---||||XXXXX||||--||||XXXXXXXXXXXXXXXXXXXXXXXXXXXXXXXXXXXXXXX|||--|||XX||||||||||||XXXXXXXXX|||||||||X||||---||||        XXXX||||XXXXXXXXXXXXXXXX|||||||||||X|||||||||XXXXXXXXXXXXXXX||||