--------------------------------------------------------------------------------------------------------------------------------------------------------------------------------------------------------
--------------------------------------------------------------------------------------------------------------------------------------------------------------------------------------------------------
--------------------------------------------------------------------------------------------------------------------------------------------------------------------------------------------------------
--------------------------------------------------------------------------------------------------------------------------------------------------------------------------------------------------------
--------------------------------------------------------------------------------------------------------------------------------------------------------------------------------------------------------
--------------------------------------------------------------------------------------------------------------------------------------------------------------------------------------------------------
--------------------------------------------------------------------------------------------------------------------------------------------------------------------------------------------------------
--------------------------------------------------------------------------------------------------------------------------------------------------------------------------------------------------------
--------------------------------------------------------------------------------------------------------------------------------------------------------------------------------------------------------
--------------------------------------------------------------------------------------------------------------------------------Tt----------------------------------------------------------------------
-----------------------------------------------------------------------------------------Tt-------------------------------------tt----------------------------------------------------------------------
--------------------------%%%%%%---G-G-Tt---------------------UU--------------------%%%%%tt%%%-----------------------------S----tt -----------------------------------------------G----U2CC-------------
-----------------------K--|||%%%---%%%-tt%%%%%%%%------------------%%%%------%%%----|||||tt%%%%%%%%%%---------------------------tt%-----------------------------------------%%%--%%%%%----------------%%
---------------------%%%%%%|||||---|G|-tt||||||||------------------||||------|||----|||||tt||||||||||----------%%%%---%%%%%-%%%%%%%%%%-----------G-----------%%%%%%%%%------|||--|||||----------------||
---------------------|||||||||||--%%%%%%%%%%%%|||------------------||||------|||----||%%%%%%%%|||||||----------||||---|||||-||||||||||----------%%%%%--------|||||||||------|||--|||||----------------||
XXXXXXXXXXXXXXXXXXXXXXXXXXXXX|||XX||||||||||||XXXXXXXXXXXXXXXXXXXXX||||------|||XXXXXX||||||||XXXXXXXXXXXXXXXXX||||---|||||X||||||||||XXXXXXXXXX|||||XXXXXXXX|||||||||XXXXXX|||--|||||XXXXXXXXXXXX    XX