--------------------------------------------------------------------------------------------------------------------------------------------------------------------------------------------------------
--------------------------------------------------------------------------------------------------------------------------------------------------------------------------------------------------------
--------------------------------------------------------------------------------------------------------------------------------------------------------------------------------------------------------
--------------------------------------------------------------------------------------------------------------------------------------------------------------------------------------------------------
--------------------------------------------------------------------------------------------------------------------------------------------------------------------------------------------------------
--------------------------------------------------------------------------------------------------------------------------------------------------------------------------------------------------------
--------------------------------------------------------------------------------------------------------------------------------------------------------------------------------------------------------
--------------------------------------------------------------------------------------------------------------------------------------------------------------------------------------------------------
----------------------------------------------------------------------------------------------------------------------------------------------------------------------------------------Tt--------------
----------------------------------------------------------------------------------------------------------------------------------------------------------------------------------------tt--------------
---------------------------------------------KG----------------------------------------------------------------------------------K------------------------------------------------------tt--------------
--------------------------------------------%%%%%------------------------------------G------------G--------------------------G-%%% %%%%-------------------G--------------------------GG-tt--------------
--------------------------------------------||||G---------------------------%%%%%%%%%%%%---%%%%%%%%%%-----------------------%%%%%%%||||-----------------%%%--%%%%%----%%%%----------%%%%%%%%%%%---------
--------------------------------------------||%%%%%%%%%%--------------------||||||||||||---||||||||||-----------------------|||||||||||-----------------|||--|||||----||||----------|||||||||||--------%
--------------------------------------------||||||||||||--------------------||||||||||||---||||||||||-----------------------|||||||||||-----------------|||--|||||----||||----------|||||||||||--------|
XXXXXXXXXXXXXXXXXXXXXXXXXXXXXXXXXXXXXXXXXXXXXX||||||||||XXXXXXXXXXXXXXXXXXXX||||||||||||XXX||||||||||XXXXXXXXXXXXXXXXXXXXXXX||||||XXXXXXXXXXXXXXXXXXXXXX|||--|||||XXXXXXXXXXXXXXXXXX|||||||||||XXX    X|