--------------------------------------------------------------------------------------------------------------------------------------------------------------------------------------------------------
--------------------------------------------------------------------------------------------------------------------------------------------------------------------------------------------------------
--------------------------------------------------------------------------------------------------------------------------------------------------------------------------------------------------------
--------------------------------------------------------------------------------------------------------------------------------------------------------------------------------------------------------
--------------------------------------------------------------------------------------------------------------------------------------------------------------------------------------------------------
--------------------------------------------------------------------------------------------------------------------- C CC SCSS-- %%%%%%%%--------------------------------------------------------------
---------------------------------------------------------------------------------------------------------------------------------|||||||||--------------------------------------------------------------
---------------------------------------------------------------------------------------------------------------S US--------------|||||||||--------------------------------------------------------------
-----------------------------------U---------------------------------------------------------------------------------------------|||||||||----------------------------g---g-----------------------------
------------------------------------------C S------------------------------------------------------------------------------------|||||||||-------------------%%%%% -------------------------------------
---------------------------------------------------------------------------------------------------------------------------------|||||||||% % %%%%%%%%%-g----||||||-------------------------------------
---------------------------------------kkkgkkggk---------------%%%------------------------------CSSSCSSC-- %%%%%%% --------------||||||||||||||||||||||---- % %%%%%% -----------------SU---% % %% %%% F 
------------------------------%%%%%  %%------------------------|||-------------------% %%%%---------------|||||||||--------------||||||||||||||||||||||----||||||||||----------------------||||||||||%||
--------------------------gg--|||||||||---------%%%%%%%%%------| % %%%---g---g-------| %%%%---------------|||||||||% %%%%%%% %% %||||||||||||||||||||||----||||||||||---------------g-r----|||||||||||||
------% %%%-------------------|||||||||---------|||||||||------|||||||---------------||||||---------------|||||||||||||||||||||||||||||||||||||||||||||----||||||||||----------------------|||||||||||||
 X XX |||||XXXXXXX XXXX X-----|||||||||XXXXX  XX|||||||||----- X XX  X X XXXXX X---- XXXXXXXXXXX XXXX XXXX|||||||||||||||||||||||||||||||||||||||||||||----||||||||||-----XXXXXXX XX  X XXX|||||||||||||