--------------------------------------------------------------------------------------------------------------------------------------------------------------------------------------------------------
--------------------------------------------------------------------------------------------------------------------------------------------------------------------------------------------------------
--------------------------------------------------------------------------------------------------------------------------------------------------------------------------------------------------------
--------------------------------------------------------------------------------------------------------------------------------------------------------------------------------------------------------
--------------------------------------------------------------------------------------------------------------------------------------------------------------------------------------------------------
--------------------------------------------------------------------------------------------------------------------------------------------------------------------------------------------------------
--------------------------------------------------------------------------------------------------------------------------------------------------------------------------------------------------------
--------------------------------------------------------------------------------------------------------------------------------------------------------------------------------------------------------
--------------------------------Tt-------------------------------------------------------------------------------------------------------------------Tt-------------------------------------------------
--------------------------------tt---------------------Tt--------------------------------------------------------------------------------------------tt-------------------------------------------------
------------Tt----------------K-tt--K------------------tt--------------------------------------------------------------------------------------------tt-------------------------------------------------
------------tt-------------%%%%%%%%%%------------------tt--------G-------2UU2UCC----------------G-----------K--------K-----Tt-----F%%%-----------%%%%%%%%%----------------------------------------------
------------tt---G---------||||||||||------------------tt-----%%%%%---%%%------------%%%%%----%%%%--%%%%%%%%%%%---%%%%%%---tt-----%|||-----------|||||||||----------------------------------------G-----
-------%%%%%%%%%%%%--------||||||||||--------------%%%%%%%%%--|||||---|||------------|||||----||||--|||||||||||---||||||---tt-K---||||-----------|||||||||--------------------------K------------%%%F%%%
-------||||||||||||--------||||||||||--------------|||||||||--|||||---|||------------|||||----||||--|||||||||||---||||||%%%%%%%%%%||||-----------|||||||||%%%------%%%%-----%%%%%---%%%%---------||| |||
XXXXXXXXXXXXXXXXXXXXXXXXXXXXXXXXXXXXXXXXXXXXXXXXXXX|||||||||XX|||||---|||XXXXXXXXXXXX|||||----||||XX|||||||||||XXXXXXXXX||||||||||XXXXXXXXXXXXXXXXXXXXXXXX|||------||||XXXXX|||||---||||XXXXXXXXXXXXXXXX