--------------------------------------------------------------------------------------------------------------------------------------------------------------------------------------------------------
--------------------------------------------------------------------------------------------------------------------------------------------------------------------------------------------------------
--------------------------------------------------------------------------------------------------------------------------------------------------------------------------------------------------------
--------------------------------------------------------------------------------------------------------------------------------------------------------------------------------------------------------
--------------------------------------------------------------------------------------------------------------------------------------------------------------------------------------------------------
--------------------------------------------------------------------------------------------------------------------------------------------------------------------------------------------------------
--------------------------------------------------------------------------------------------------------------------------------------------------------------------------------------------------------
--------------------------------------------------------------------------------------------------------------------------------------------------------------------------------------------------------
--------------------------------------------------------------------------------------------------------------------------------------------------------------------------------------------------------
--------------------------------------------------------------------------------------------------------2SCSS2----------------------------------------------------------------------  %%%---------------
-------------------------------------------------------------------------------------------------------gggkgkggkg---------- %%%%%  %%%%% -------------------------r---------r-------|||||--%%%%%%%% %F %
-----------------------------------------------------------------------------------------------------r---------------------||||||||||||||-------------------------------------------|||||--||||||||||%||
--------------------------------%% %% %----------- %%%%%%------------------g-----g--g---- %%%%%%% % %%-----------%%%%%% %%%||||||||||||||-gg-------r-------------%% %  %%%%  %%---%%%%%%%%%|||||||||||||
--------------------------g-----|||||||-----------|||||||--------------------------------|||||||||||||-----------||||||||||||||||||||||||------------ %  %%%%% %%||||||||||||||---||||||||||||||||||||||
------ %%%%---------------------|||||||-----------|||||||--------------------------------|||||||||||||%%%  %% %% ||||||||||||||||||||||||% %%%%%%%%%%||||||||||||||||||||||||||---||||||||||||||||||||||
 XXXXX|||||XXX X XXX X XX-----XXXX XXXXX XX-----XXXXXXXX XXX---X XXXX X   ---- X X X   XX||||||||||||||||||||||||||||||||||||||||||||||||||||||||||||||||||||||||||||||||||||||---||||||||||||||||||||||