---------------------------------------------------------------------------------------------------- -- - ---- ------------ ----------------------------------------------------------------------------
---------------------------------------------------------------------------------------------------------------------- --------- ---------------------------------------- ------------------------------
 ----------------------------- --------------------------------------------------------------------------------------------------------------------- ----------------------------------------------- ---
-------------------------------------------------- ----------------------------------------------------------- ----------------------------------------------------------------------------------- -----
------ -- ---------------------------------------------- ----- --------------------------------------- -------------------------------------------------------------------------------------------------
--------------------------------------- ------------- ------------------------------------------------------------------------------ ---------------------------------------- --------------------------
--------------------------------------------------------------------------------------------------------------------------------------------------------------------------------------------------------
----------------------------------------------- ---------------------------------------------------------------------------------- --------     --- -- -------------------------------------------------
------------------------------------------------------Tt------------------------------------------------------------------------------------------ ---- ------------------------------------------------
--------- ---- Tt-------------------------------------tt------ -------------------- -------------------------------------------------Tt------- ------------- ------- ------------------------Tt---------
---------------tt---------------------------------K---tt--------------------------------- ---------------Tt--------------------------tt------------------------------------------------------t ---------
---------------tt--------------------------------%%%% %% %%%%-----Tt-------------------------------------tt----------------------- --tt--------------%% -- ------G--------- --Tt-------------tt---------
------------%%%%%%%%------------- %-%% % %%------||||GK||||||---%%tt%%---------G-----%%   %%%% -------- -tt----------------------%% %%% %% %%----% %%|||% %%%---%  %%---------tt-------------tt---------
------------||||||||----------% %|| |||||||------|||%% % %|||---||tt||-K- -----%% ---||||||||||----------tt----------------------||||||||||||----|||| |||||||---|||||--- ----- t----------%% %%%%%------
------------||||||||----------|||||||||||||------||||||||||||--%    %%%%-------|||---||||||||||-------%% %% %%%----%% ---% %%----||||||||||||----||||||||||||---|||||------%%%%%%% %------||||||||------
XXXXXXXXXXXX||||||||XXXXXXXX XXXX||X|||||||XXXXXXXXX||||||XXXXX||||||||| XXXXXXXX XXX||||||||||XXXXXXX||||||| |XXXX|||---||||XXXX||||||||||||----||||XXX|||||---||||| XXXXX|||||||||XXXXXXXXXXX XXXXXXXX