--------------------------------------------------------------------------------------------------------------------------------------------------------------------------------------------------------
--------------------------------------------------------------------------------------------------------------------------------------------------------------------------------------------------------
--------------------------------------------------------------------------------------------------------------------------------------------------------------------------------------------------------
--------------------------------------------------------------------------------------------------------------------------------------------------------------------------------------------------------
----------------------------------------------------------------------------------------------------------------------SCSSCCC---------------------------------------------------------------------------
--------------------------------------------------------------------------------------------------------------------gggggggggkrr------------------------------------------------------------------------
------------------------------------------------------------------------------------------------------------------r-----------------------------------------SSCS2SCS------------------------------------
-------------------------------------SUSSSSCC2-%%%%%%%%%%%%%%-------------------------------------------%%%%%%%%%%%-------------%%%%%%%%%---------------------------------------------------------------
-----------------------------------------------||||||||||||||-g-----------------------------------------|||||||||||-------------|||||||||------%%%%%%%-----------------r--------------------------------
-------------------------------UCCS------------||||||||||||||------------------g--------------g---------|||||||||||%%%%%%%%%%%%%|||||||||------|||||||--------------------------------------------------
-----------------------------------------------||||||||||||||-----%%%%%%%%%-----------------------------|||||||||||||||||||||||||||||||||----%%%%%%%%%%%%%%%%%%%%%%%%%----------------------------------
-----------------------------------------------||||||||||||||-----|||||||||---%%%%%%%%%%%%---%%%%%%%%%%%|||||||||||||||||||||||||||||||||----|||||||||||||||||||||||||----------------------------------
-----------------------------------------------||||||||||||||-----|||||||||---||||||||||||---||||||||||||||||||||||||||||||||||||||||||||----|||||||||||||||||||||||||---%%%%%%%%%----------------------
-------------------------%%%%%%%%%%%%%%%%%%%%%%||||||||||||||-----|||||||||---||||||||||||---||||||||||||||||||||||||||||||||||||||||||||----|||||||||||||||||||||||||---|||||||||----r---r-------------
------%%%%%--------------||||||||||||||||||||||||||||||||||||-----|||||||||---||||||||||||---||||||||||||||||||||||||||||||||||||||||||||----|||||||||||||||||||||||||---|||||||||----------------------
XXXXXX|||||XXXXXXXXXXXXXX||||||||||||||||||||||||||||||||||||-----|||||||||---||||||||||||---||||||||||||||||||||||||||||||||||||||||||||----|||||||||||||||||||||||||---|||||||||---XXXXXXXXXXXXX    XX