--------------------------------------------------------------------------------------------------------------------------------------------------------------------------------------------------------
--------------------------------------------------------------------------------------------------------------------------------------------------------------------------------------------------------
--------------------------------------------------------------------------------------------------------------------------------------------------------------------------------------------------------
--------------------------------------------------------------------------------------------------------------------------------------------------------------------------------------------------------
--------------------------------------------------------------------------------------------------------------------------------------------------------------------------------------------------------
--------------------------------------------------------------------------------------------------------------------------------------------------------------------------------------------------------
--------------------------------------------------------------------------------------------------------------------------------------------------------------------------------------------------------
--------------------------------------------------------------------------------------------------------------------------------------------------------------------------------------------------------
---------------------------------------------------------------------------------------------------------------------------------------------------------------g----------------------------------------
--------------------------------- ----------------------------------------------------------------------gg--------------------------------------------%% %%%--------------------------------------------
-------------------------------------------------------gg----------------------- S C CSS--------------------------------------------------------------||||||-------   %% -------------------------------
-------------------------------------ggkggkgkg---------------------------------gkgggggkkggg----------------------------------------------------------    |||-------||||||-------------------------------
---------------------------------------|||||---------------------------------r---------------------------------------------------------------------- %%   %%%%-----||||||-------------------------------
-------------------------%  %%   %% %--|||||--%%%%  % ---------------%%   %%%%-------------%%%%%  %%% %-----%%% %%% -gg----------------g-g--g-------||||||||||---%%%%% %%% -----------------------------
------%%% %--------------||||||||||||--|||||--||||||||---------------|||||||||-------------||||||||||||-----||||||||--------------------------------||||||||||---||||||||||----------------------%% %F  
 X    |||||XX  XX  X   XX||||||||||||XX  XX X ||||||||----    XXXXX X|||||||||  XXXX   X  X||||||||||||-----||||||||---XXX   XXXXX ---XXXXXXXX    X ||||||||||---||||||||||X X XX  XX XX  XX XXX ||||X||