--------------------------------------------------------------------------------------------------------------------------------------------------------------------------------------------------------
--------------------------------------------------------------------------------------------------------------------------------------------------------------------------------------------------------
--------------------------------------------------------------------------------------------------------------------------------------------------------------------------------------------------------
--------------------------------------------------------------------------------------------------------------------------------------------------------------------------------------------------------
--------------------------------------------------------------------------------------------------------------------------------------------------------------------------------------------------------
--------------------------------------------------------------------------------------------------------------------------------------------------------------------------------------------------------
---------------------------------------------------------------------------------------------------------------------------------------------------------------%%%%%------------------------------------
------------------------------------------------------------------------------------------------------2S2C-----------------------------------------------------|||||------------------------------------
---------------------------------------------------------------------------------------------------------------------------------------------------------------|||||------------------------------------
-------------------------------------UCCSS2C2--%%%%%%%%--------------------------------------------------------------------------------------------------------|||||------------------------------------
-----------------------------------------------||||||||------------------------------------------------------------------------------------------------r-----%%%%%%%%%%%%%%%%%%%-k----------------------
------------------------------2CSCUC-----------||||||||----g-----g-----------------------------------%%%%%%%------------------ggkgkgk------------------------|||||||||||||||||||------%%%%%%%-----------
-----------------------------------------------||||||||-----------------%%%%%%%%-----gg--------------|||||||--------------------------------------%%%%%%%%%%%|||||||||||||||||||------|||||||---%%    %%
-----------------------------------------------||||||||---%%%%%%%%------||||||||---------------------|||||||----------------r--------%%%%%%%%%%%%%||||||||||||||||||||||||||||||------|||||||---||||| ||
------%%%%%------------------------------------||||||||---||||||||----%%%%%%%%%%%%%%-----------------|||||||---%%%%%%%%%%%%%%--------|||||||||||||||||||||||||||||||||||||||||||----%%%%%%%%%%%%||||||||
XXXXXX|||||XXXXXXXXXXXXXXXXXXXXXXXXXXXXXXXXXXXX||||||||---||||||||----||||||||||||||---XXXXXXXXXXXXXXXXXXXXXXXX||||||||||||||XXXXXXXX|||||||||||||||||||||||||||||||||||||||||||----||||||||||||||||||||