----------------------------------------------------------------------------------------------- ------------------------------------------------- ------------------------------------- ----------------
---------- ----------------------------------------------------------------------------------------------- --------- ----------------- -------- --------------------------------------------------------
--- --------- ----------------------------------------------------------- -- ------------------------------------------------------------------------------------------------------------------ - ------
------------------------------------------------------------------------------------------------------------ ------------------- ----------------------------------------------------------- -----------
------------------------------------------------------------------------------------------------- ------------------------------------------- ------------------------------------------------------- --
--------------------------------------- ---------- ----------------------------------------------------------------------------------------------------------------------------------------------- -----
------------------------ ----------------------- ---------------------------- ------------------- --------------------------------------------------------------- -------------------- -----------------
------------------------------------------ ----- -----------------%%%%%%--------------------------------------------------------------------------------------------------------------------------------
---------------------- --------------- - -------------------------||||||------------------------------------------------------------------------------- --------------- ------------------- ------------
---- ------------------- --------------ggggkggkkgg----------------|%%%%%--------------U----- ------- ------------------------------------------ ------------------------- ------------------------------
----------- ----------- -------------r--|||||||||-----------------||||||----------------------------- -------------- ----g-----------CSSSSCSS--------------------- -------------------------------------
-------------------------%%%%%%%%%%%%%--|||||||||-%%%%%% %%%%---%%%%%%%%%%----------------ggggggkkg------ ----------------%%%%%% %%-------------------------k----------------------------- -------------
-------------------------|||||||||||||--|||||||||-|||||||||||---||||||||||------------------|||||---------------%%%%%%%%% |||||||||-------------------------------------------%%%%%%%---------- --------
-------- ----------------| |||||||||||%%%%%%%%%%%%|||||||||||---||||||| ||---%%%%%%%%%%%%%--|||||--%%%%%%%%%%%%%|||||||||||||||||||-----------------%%%----%%%%%%%%%%%%-------|||||||-------------------
------%%%%%--------------|||||||||||||||||||||||||||||||||| |---||||||||||---|||||||||||||--|||||--||||||||||||||||||||| ||||||||||%%%%%%%%%%%%-----|||----||||||||||||-------|||||||-------------------
 XXXXX|||||XXXXXXXXXXXXXX||||||||||||||||| ||||||||||||||||||---||||||||||---|||  ||||||||XXXXXXXXX|||||||||||| || ||||| ||||||||||||||||||||||-----|||----||||||||||||-----XXXXXXXXXXXXXXXXXXXXXXXXXFXX