--------------------------------------------------------------------------------------------------------------------------------------------------------------------------------------------------------
--------------------------------------------------------------------------------------------------------------------------------------------------------------------------------------------------------
--------------------------------------------------------------------------------------------------------------------------------------------------------------------------------------------------------
--------------------------------------------------------------------------------------------------------------------------------------------------------------------------------------------------------
--------------------------------------------------------------------------------------------------------------------------------------------------------------------------------------------------------
--------------------------------------------------------------------------------------------------------------------------------------------------------------------------------------------------------
--------------------------------------------------------------------------------------------------------------------------------------------------------------------------------------------------------
--------------------------------------------------------------------------------------------------------------------------------------------------------------------------------------------------------
----------------------------------------------------------------------------------------------------------------------------------------------------------------Tt--------------------------Tt----------
----------------------------------------------------------------------------------------------------------Tt------------------------------Tt--------------------tt--------------------------tt----------
----------------------------------------------------------------------------------------------------------tt------------------------------tt--------------------tt--------------------------tG----------
--------------------------------------------------------------------------------S-------------------------tt----------------------F--UC2SUTUSCUC-----2CC--------tt--------------------------tt%%-K------
---------------------------------------------------------------------------------UUUC22--------------%%%%%%%%%%------%%%-%%%%%%%%-%-------tt----------------%%%%%%%%%%-------------------%%%%%%%%%------
-----------------------------------------------------------------%%%%------%%%%%----C222%%%----%%%%%-||||||||||-----%%%%%%%%%||||-|---%%%%%%%%%-------------||||||||||-------------------|||||||||-F----
-------------------------------------------%%%%-----%%%----------||||------|||||--------|||----|||||-||||||||||-----|||||||||||||-|---|||||||||-------------||||||||||-------------------|||||||||- ----
XXXXXXXXXXXXXXXXXXXXXXXXXXXXXXXXXXXXXXXXXXX||||-----|||XXXXXXXXXX||||------|||||XXXXXXXX|||----|||||XXXXXXXXXXXXXXXX|||||||||XXXXXXXXXXXXXXXXXXXXXXXXXXXXXXX||||||||||XXXXXXXXXXXXXXXXXXX|||||||||XXXXXX