--------------------------------------------------------------------------------------------------------------------------------------------------------------------------------------------------------
--------------------------------------------------------------------------------------------------------------------------------------------------------------------------------------------------------
--------------------------------------------------------------------------------------------------------------------------------------------------------------------------------------------------------
--------------------------------------------------------------------------------------------------------------------------------------------------------------------------------------------------------
--------------------------------------------------------------------------------------------------------------------------------------------------------------------------------------------------------
--------------------------------------------------------------------------------------------------------------------------------------------------------------------------------------------------------
--------------------------------------------------------------------------------------------------------------------------------------------------------------------------------------------------------
--------------------------------------------------------------------------------------------------------------------------------------------------------------------------------------------------------
--------------------------------------------------------------------------------------------------------------------------------------------------------------------------------------------------------
--------------------------------------------SS-S2-------------------------------------------------------------------------------------------------------------------------------------------------------
-----------------SS2-----------------S2CS---------------------------------------------------------------------------------------------------------------------------------------------------------------
----------------------------------------------|---------------------------------------------------------------------------------------------------------------------------------------------------------
--------------------------------------------k-r--------------------------------------------------------------------------%%%%%--%%%%%--#---#------------------------------------------------------------
------------------------------%%%%%%-r---k-%%%%%%%%-----------------------%%%--%%%-------%%%--%%%------------------------|||||--|||||%%%---%%%--------------------------------------------------------F-
-------------%%%%%%%%---------||||||%%%%%%%||||||||------------%%%%---%%%%|||--|||%%---%%|||--|||------------------------|||||--||||||||---|||-------------------------------------------------------- -
XXXXXXXXXXXXX||||||||XXX---XXX|||||||||||||||||||||XXXXX--XXXXX||||---|||||||--|||||---|||||--|||XXXX---XXXXXXXXX---XXXXX|||||--||||||||---|||XXXXXXXXFXXXXXXXXXXXXXXXXXXXXXXXXXXXXXXXXXXXXXXXXXXXXXXXXX