--------------------------------------------------------------------------------------------------------------------------------------------------------------------------------------------------------
--------------------------------------------------------------------------------------------------------------------------------------------------------------------------------------------------------
--------------------------------------------------------------------------------------------------------------------------------------------------------------------------------------------------------
--------------------------------------------------------------------------------------------------------------------------------------------------------------------------------------------------------
--------------------------------------------------------------------------------------------------------------------------------------------------------------------------------------------------------
--------------------------------------------------------------------------------------------------------------------------------------------------------------------------------------------------------
------------------------------------------------------------------------------------------------------------------------------------------%%% %%%----------------------------------S2USC C--------------
------------------------------------------------------------------------------------------------------------------------------------------|||||||-------------------------------------------------------
----------------------------------U-------------------------------------------------------------------------------------------------------|||||||--------------------------------g-----g----------------
-----------------------------------------------------------------------------------------CSSCSSS------------------------------g-----------|||||||-------------------------------------------------------
--------------------------g------------- %%%-------------------------------------------gkgggkgggggg-------------------------------------%%%%%%%  %%%---------------%% %%%%%%%%%%%%%%%%% %%%%------------
--------------------------------------gkkkkggg---------------------------------------r---------------------------------------%%%%%%%%% %||||||||||||------g--------|||||||||||||||||||||||||------------
-----------------------------%%% %% %%--||||----------------------------%%% %  %%%%%  -------------%%%%%%%%%% %--------------|||||||||||||||||||||||---------------|||||||||||||||||||||||||------------
-----------------------------|||||||||--||||--%%%%% % % %%%%------------||||||||||||||-------------||||||||||||---------Tt---|||||||||||||||||||||||-----%%%%%%%% %|||||||||||||||||||||||||------------
------%%%%%------------------|||||||||--||||--||||||||||||||---%%%%%  %%||||||||||||||%%%% %%%% % %||||||||||||---------tt---|||||||||||||||||||||||-----|||||||||||||||||||||||||||||||||||%%%%%%% %F%%
 XXXXX|||||XXXXX XX  XXXX----|||||||||XXXXXX X||||||||||||||---||||||||||||||||||||||||||||||||||||||||||||||||----- XXXXXX X|||||||||||||||||||||||-----||||||||||||||||||||||||||||||||||||||||||||X||