--------------------------------------------------------------------------------------------------------------------------------------------------------------------------------------------------------
--------------------------------------------------------------------------------------------------------------------------------------------------------------------------------------------------------
--------------------------------------------------------------------------------------------------------------------------------------------------------------------------------------------------------
--------------------------------------------------------------------------------------------------------------------------------------------------------------------------------------------------------
--------------------------------------------------------------------------------------------------------------------------------------------------------------------------------------------------------
--------------------------------------------------------------------------------------------------------------------------------------------------------------------------------------------------------
-----------------------------------------------------------------------------------------------------------------------------------------------CCCSC------S2CSSSSS--------------------------------------
--------------------------------------------------------------------------------------------------------------------------------------------------------------------------------------------------------
----------------------------------------------------------------------------------------g----------g----------------------------------------------------------------------------------------------------
----------------------------------------------------------------------------------------------------------------------------USSSSSC-%%%%%%%%--------------------------r---------------------------------
-------------------------g--------------------------------------gggggkgkgkgkg-----------------r-------------------------------------||||||||%%%%%%%%%%%%%%%%%%%%%%%%%---------------tt-----%%%%%%%    %%
-------------------------------------------%%%%%--------------r--|||||||||||------------------------------------------U2SC----------|||||||||||||||||||||||||||||||||%%%%%%%%-------tt-----|||||||||| ||
-------------------------------------------|||||--%%%%%%%%%%%%%--|||||||||||-%%%%%%%%%%-----%%%%%%%%--------------------------------|||||||||||||||||||||||||||||||||||||||||%%%%%%%%%%%%%%|||||||||||||
---------------------------------------g---|||||--|||||||||||||--|||||||||||-||||||||||-----||||||||----%%%%%%%%%-------------------||||||||||||||||||||||||||||||||||||||||||||||||||||||||||||||||||||
------%%%%%--------------------------------|||||--|||||||||||||%%%%%%%%%%%%%%||||||||||-----||||||||----|||||||||-------------------||||||||||||||||||||||||||||||||||||||||||||||||||||||||||||||||||||
XXXXXX|||||XXXXXXXXXXXXXX----XXXXXXXXX---XXXXXXXXX|||||||||||||||||||||||||||||||||||||-----||||||||----|||||||||XXXXXXXXXXXXXXXXXXX||||||||||||||||||||||||||||||||||||||||||||||||||||||||||||||||||||