-------------------------------------------------------------------------------------------------------------------------------     --------------------------------------------------------------------
-------------------------------------------------------------------------------------------------------------------------------     --------------------------------------------------------------------
-------------------------------------------------------------------------------------------------------------------------------     --------------------------------------------------------------------
-------------------------------------------------------------------------------------------------------------------------------     --------------------------------------------------------------------
-------------------------------------------------------------------------------------------------------------------------------     --------------------------------------------------------------------
-------------------------------------------------------------------------------------------------------------------------------     --------------------------------------------------------------------
-------------------------------------------------------------------------------------------------------------------------------     --------------------------------------------------------------------
-------------------------------------------------------------------------------------------------------------------------------     --------------------------------------------------------------------
-------------------------------------------------------------------------------------------------------------------------------     --------------------------------------------------------------------
-------------------------------------------------------------------------------------------------------------------------------     --------------------------------------------------------------------
------------------------------------------------------------Tt-----------------------------------------------------------------     --------------------------------------------------------------------
--------------------------------------SUCUUCC-%%%%%%%%%-----tt-------------------------------%%%--------Tt---%%%%%%%%%----%%%%%     -%%%%%%-------------------------------------------------------------
-------------------------%%%%%---%%%%---------|||||||||-----tt----------------%%%%%---%%%%%--|||--------tt---|||||||||----|||||     -||||||----------G---SUUU----------------------------K--------------
-------------%%%----%%%%-|||||---||||---------|||||||||--%%%%%%%%-------------|||||---|||||--||%%%%%%%%%tt---||||||||%%%%%%%%%%     -||||||---%%%%%%%%%%%-----%%%------%%%%--------------%%%%%----%%%%--
-------------|||----||||-|||||---||||---------|||||||||--||||||||-------------|||||---|||||--||||||%%%%%%%%%%%%||||||||||||||||     %%%%%||---|||||||||||-----|||------||||--------------|||||----||||--
XXXXXXXXXXXXX|||----||||X|||||---||||XXXXXXXXXXXXXXXXXXXX||||||||XXXXXXXXXXXXX|||||---|||||XXXXXXXX||||||||||||XXXXXXXXXXXXXXXX     |||||XXXXX|||||||||||XXXXX|||------||||XXXXXXXXXXXXXX|||||----||||XX