--------------------------------------------------------------------------------------------------------------------------------------------------------------------------------------------------------
--------------------------------------------------------------------------------------------------------------------------------------------------------------------------------------------------------
--------------------------------------------------------------------------------------------------------------------------------------------------------------------------------------------------------
--------------------------------------------------------------------------------------------------------------------------------------------------------------------------------------------------------
--------------------------------------------------------------------------------------------------------------------------------------------------------------------------------------------------------
--------------------------------------------------------------------------------------------------------------------------------------------------------------------------------------------------------
----------------------------------------------------------------------------------------------------------------------------------------------------------------------------SSSSS-----------------------
--------------------------------------------------------------------------------------------------------------------------------------------------gggggggkggkgg-----------------------------------------
-------------------------------------------------------------------g----------------------------------------------------------------------------r--|||||||||||-----------------------gk--r--------------
-------------------------------------------------------------------------------------------------------------------------------------%%%%%%%%%%%%--|||||||||||-%%%%%%%%%%-------------------------------
------------------------------------U---------------------------------%%%%%%-----------------------------g-----g---------------------||||||||||||--|||||||||||-||||||||||%%%%%%%%%%%%%%%%%%%%%%%%%    %%
----------------------------------------gggkgggkggg-------------------||||||----SSSS2SSU---------------------------------------------||||||||||||%%%%%%%%%%%%%%|||||||||||||||||||||||||||||||||||||| ||
------------------------------------------%%%%%%%---------------------||||||----------------------------%%%%%%%%%%%%%----------------|||||||||||||||||||||||||||||||||||||||||||||||||||||||||||||||||||
--------------------------g----g----------|||||||--%%%%%%%%%%%%%------||||||----------------g----------g|||||||||||||----%%%%%%%%%%%%|||||||||||||||||||||||||||||||||||||||||||||||||||||||||||||||||||
------%%%%%-----------------%%%%%%%%%%%%--|||||||--|||||||||||||----%%%%%%%%%%--------------------------|||||||||||||----|||||||||||||||||||||||||||||||||||||||||||||||||||||||||||||||||||||||||||||||
XXXXXX|||||XXXXXXXXXXXXXX---||||||||||||XXXXXXXXXXX|||||||||||||----||||||||||XXXXXXXXXXXXX---XXXXXXXXXX|||||||||||||----|||||||||||||||||||||||||||||||||||||||||||||||||||||||||||||||||||||||||||||||