---------------------------------------------------------------------------------------------------------------------------------      -----------------------------------------------------------------
---------------------------------------------------------------------------------------------------------------------------------      -----------------------------------------------------------------
---------------------------------------------------------------------------------------------------------------------------------      -----------------------------------------------------------------
---------------------------------------------------------------------------------------------------------------------------------      -----------------------------------------------------------------
---------------------------------------------------------------------------------------------------------------------------------      -----------------------------------------------------------------
---------------------------------------------------------------------------------------------------------------------------------      -----------------------------------------------------------------
---------------------------------------------------------------------------------------------------------------------------------      -----------------------------------------------------------------
---------------------------------------------------------------------------------------------------------------------------------      -----------------------------------------------------------------
-------------------------------------------------Tt------------------------------------------------------------------------------      -----------------------------------------------------------------
-------------------------------------------------tt------------------------------------------------------------------------------      -----------------------------------------------------------------
-------------------------------------------------tt---------------Tt-----------------------------------------G-----G-------------      -----------------------------------------------------------------
------------%%%----------------------------------tt---------------tt---------------------------------------%%%Tt%%%%%%-----------      -----------------------------------------------------------------
------------|||-------------------------------%%%%%%%%%%----------tt-G------G--------%%%-G--CU222-----K----|||tt||||||-----------      ----%%%------%%%%----------------------G-------------------------
------------|||-----------------G-------------||||||||||-------%%%%%%%%%%%%%%-----%%%||%%%%%%%%%%-----22C--|||t-|||G||-----------      %%--|||------||||--------------------2UC%%%%%--%%%%-------------%
------------|||--------------%%%%%--%%%%------||||||||||-------||||||||||||||-----|||||||||||||||--------%%%%%%%%%%%||-%%%-------      ||--|||------||||----%%%%----%%%%%------|||||--||||-------------|
XXXXXXXXXXXXXXXXXXXXXXXXXXXXX|||||--||||XXXXXXXXXXXXXXXXXXXXXXX||||||||||||||-----|||XXXXXXXXXXXXXXXXXXXX|||||||||||XXX|||XXXXXXX      XXXX|||------||||XXXX||||----|||||XXXXXX|||||--||||XXXXXXXXXXXXX|