--------------------------------------------------------------------------------------------------------------------------------------------------------------------------------------------------------
--------------------------------------------------------------------------------------------------------------------------------------------------------------------------------------------------------
--------------------------------------------------------------------------------------------------------------------------------------------------------------------------------------------------------
--------------------------------------------------------------------------------------------------------------------------------------------------------------------------------------------------------
--------------------------------------------------------------------------------------------------------------------------------------------------------------------------------------------------------
--------------------------------------------------------------------------------------------------------------------------------------------------------------------------------------------------------
--------------------------------------------------------------------------------------------------------------------------------------------------------------------------------------------------------
--------------------------------------------------------------------------------------------------------------------------------------------------------------------------------------------------------
--------------------------------------------------------------------------------------------------------------------------------------------------------------------------------------------------------
---------------------------------------------------------------Tt---------------------------------------------------------------------------------------------------------------------------------------
---------------------------------------------------------------tt-----------------------------------------Tt-------------------Tt-----------------------------------------------------------------------
---------------------------------------------------------------tt----------------------------------22-----tt----------------G--tt-F-----%%%%------------------------------------------------------------
-----------------------------------------------------G---------tt-G-------%%%%--%%%----------------------Gtt-G-----------%%%%%%tt%%%----||||----------------------------------------------------G-------
---------%%%%%%%%%-------------%%%%%%%%%-%%%%%%%%%--%%%%----%%%%%%%%%-----||||--|||------------------%%%%%%%%%%%---------||||K|tt|||----||||----------------------------------------K--%%%%----%%%%%--F-
---------|||||||||-------------|||||||||-|||||||||--||||----|||||||||-----||||--|||------------------|||||||||||---------|||%%%%%%%%----||||--------------------------------%%%----%%%%||||----|||||-- -
XXXXXXXXXXXXXXXXXXXXXXXXXXXXXXX|||||||||X|||||||||XXXXXXXXXXXXXXXXXXXXXXXX||||--|||XXXXXXXXXXXXXXXXXX|||||||||||XXXXXXXXXXXX||||||||XXXXXXXXXXXXXXXXXXXXXXXXXXXXXXXXXXXXXXXX|||----||||||||----|||||XXXX