--------------------------------------------------------------------------------------------------------------------------------------------------------------------------------------------------------
--------------------------------------------------------------------------------------------------------------------------------------------------------------------------------------------------------
--------------------------------------------------------------------------------------------------------------------------------------------------------------------------------------------------------
--------------------------------------------------------------------------------------------------------------------------------------------------------------------------------------------------------
--------------------------------------------------------------------------------------------------------------------------------------------------------------------------------------------------------
--------------------------------------------------------------------------------------------------------------------------------------------------------------------------------------------------------
--------------------------------------------------------------------------------------------------------------------------------------------------------------------------------------------------------
------------------------------------------------------------------------------------------------------------------------------------Tt------------------------------------------------------------------
----------------------------------------------------------------------------------------------Tt------------------------------------tt--Tt--------------------------------------------------------------
----------------------------------------------------------------------------------------------tt------------------------------------tt--tt--------------------------------------------------------------
----------------------------------------------------------------------------------------------tt------------------------------------tt-KKt------------------------G-------------------------------------
------------2CU2C--------------------------------------------------------------------------%%%%%%%%%-----------------------------% %%%%%tt%-G--------------------%%%%-------------------------------- t-
--------------------------K-------------------------G-----%%%%%%%%%%-----------------------|||||||||-------CC2CU-----------------|%|%%%%%%%%%%%------------------||||-------------------G------------ t-
--------------------------%%%-%%%%-----%%%--%%%%%%%%%-----||||||||||-----------------------%%%%%||||-----------------------------||||||||||||||-K----------------||||------------%%%---%%%%%-------   t%
--------%%%%%-------------|||-||||-----|||--|||||||||-----||||||||||-----------------------|||||||||-------------------%%%%%%%%%-||||||||||||%%%%----------------||||------------|||---|||||----%%    %%
XXXXXXXX|||||XXXXXXXXXXXXXXXXX||||-----|||XX|||||||||XXXXX||||||||||XXXXXXXXXXXXXXXXXXXXXXXXXXXXXXXXXXXXXXXXXXXXXXXXXXX|||||||||XXXXXXXXXXXXX||||XXXXXXXXXXXXXXXXXXXXXXXXXXXXXXXX|||---|||||XXXX||||||||