----------------------------- --------------------------------------------------------------------------------- -- ------------------------------------------------------------------------------------ 
--------------------------- ------------------------------------------------------------------------------------------------------------------------ - ------------------- -----------------------------
------------------------------------------------------------------------------------------- ------------------------------------------------------------------------------------------------------------
----------------------------------------------------------- --------------------------------------------------------------------------------------------------------------------------------------------
----------- ---------------------- - --------------------------------- ------ --------------------------------------------------------------------------------------------------- SC--------------------
----------------------- ------------------------------------------------------------------ -------------------- ----------------------------------------------------------------------------------------
---------------------------------------------------------------------------------------------------------------------------------- ---------------------------------------------------------------------
----------------------------------------------------------------------------------------------------------------------------------------kgggggkggg------------------------------------------------------
--------------------- ---------------------------------------------------------- --------------------- ----- --g----------------------r--||||||||-------------------- ---------%%%% %-------------------
------------------------------------- SCC----------------------------------------- ---C CCCS US S2-%%% % %% %---------------%%% %%% %%%--||||      % %%  %%%%%%%---------------||||||---k---------------
-----------------------------------gggggggk--------------------------------------------------------||| ||||||----% %%%%%%%%%|||||||||||--||||||||-||||||||||||||%%%%  %%---- -- |||||-------------------
---------- - --------------------r-----------------------------%%%%%%%%----------S2U---------------|||  |||||----|||||| |||||||||||||||%%%%%%%%%%%||||||||||||||||||||||-r---   %%%%%  % %  %%%%% % ----
-------------------------%%% %%%% ---------% %% %%%%%%%%-------||||||||------------ ---------------||| ||||||----|||||||||||||||||||||||||||||||||||||||||||||||||||||||-----|||||||||||||||||||||||----
--- -- ------------------|||||||||---------|||||||||||||-------||||||||----------------------------||| ||||||----|||||||||||||||||||||||| ||||||||||||||||||||||||||||||-----||||||||||||||||||||||| F%%
------%%% %------ -------|||||||||%%%%%%%%%||||||| |||||-------||| ||||----------------- ----------||| | ||||----||| ||||||||||||||||||||||||||||||||| |||||||||||||||||-----|||||||||||||||||||||||| ||
   XXX|||||XXXX XXXXXX XX|||||||||||| ||||||||||||||||||-----X X X  XXX  XX XXX XXXXXX XXXXXXXX XXX||| ||||||----|||||||||||||||||||||||||||||||||||||||||||||||||||||||-----|||||||||||||||||||||||||||