--------------------------------------------------------------------------------------------------------------------------------------------------------------------------------------------------------
--------------------------------------------------------------------------------------------------------------------------------------------------------------------------------------------------------
--------------------------------------------------------------------------------------------------------------------------------------------------------------------------------------------------------
--------------------------------------------------------------------------------------------------------------------------------------------------------------------------------------------------------
--------------------------------------------------------------------------------------------------------------------------------------------------------------------------------------------------------
--------------------------------------------------------------------------------------------------------------------------------------------------------------------------------------------------------
--------------------------------------------------------------------------------------------------------------------------------------------------------------------------------------------------------
--------------------------------------------------------------------------------------------------------------------------------------------------------------------------------------------------------
---------------------------------------------------------------- ------------------------------------------------------------------------------------------------------  -------------------------------
----------------------------------------- SCC SCS-------------------------------------------------------------------------------------------------------------------------------------------------------
---------------------------------------             ----------------------------------------------------------------------------------------------------------------------------------------------------
------------------------------------- ---------------------------------------------------------------------------       ---------------------------------- ---------------------------- -------- -------
-------------------------%%%%%% %%%% %--------------% %%% %%%% ---------------------------------------------------%% %%---------------------------------------------------------------------------------
-------------------------|||||||||||||--------------|||||||||||----------------- ------------------------------ --|||||-%%%  %%%%%%%%%-------------------%%%%%%%%%% %%%---------------%%%%%%%%%%%%------
------%%%%%--------------|||||||||||||%%%%  %%% %% %|||||||||||---------------------------------------%%%%%%%%%%--|||||-||||||||||||||-------------------||||||||||||||---------------||||||||||||------
 X XX ||||| XXXXXXXX XXXX||||||||||||||||||||||||||||||||||||||--- XXX XX ----- X X XX X---XX XXXXXXXX||||||||||XXX XXX ||||||||||||||-----XXXXXXXXXX  XX||||||||||||||----XXXXXXXXXXX||||||||||||  XFXX