--------------------------------------------------------------------------------------------------------------------------------------------------------------------------------------------------------
--------------------------------------------------------------------------------------------------------------------------------------------------------------------------------------------------------
--------------------------------------------------------------------------------------------------------------------------------------------------------------------------------------------------------
--------------------------------------------------------------------------------------------------------------------------------------------------------------------------------------------------------
--------------------------------------------------------------------------------------------------------------------------------------------------------------------------------------------------------
--------------------------------------------------------------------------------------------------------------------------------------------------------------------------------------------------------
--------------------------------------------------------------------------------------------------------------------------------------------------------------------------------------------------------
----------------------------------------------------------------------------------------------------------------------------------------------------CCSS------------------------------------------------
---------------------------------------------------------------------------------------------------------------------------------------------------ggggggg----------------------------------------------
-----------------------------------------------------------gg-g----------------------------------------------------------------------------------r------------------------------------------------------
------------------------------------------2SSS--------------------------------------------------------------------------------------%%%%%%%%%%%%%%--------%%%%%%%%%%%-----------------------------------
----------------------------------------ggkgkkkk---------------------------g------------------------------UCSCSC22SS----------------||||||||||||||--------|||||||||||------------g----------------------
--------------------------------------r------------------------%%%%%%%--------%%%%---------------------------------------g----------||||||||||||||%%%%%%%%|||||||||||-----------------------------------
-------------------------%%%%%%%%%%%%%%---------%%%%%%%%%%-----|||||||--------|%%%%%%--------------------g---gg---------------------|||||||||||||||||||||||||||||||||-----------%%%%%%%%----------------
------%%%%%--------------||||||||||||||---------||||||||||-----|||||||--------|||||||---------------------------------%%%%%%%%%%%%%%|||||||||||||||||||||||||||||||||---%%%%%%%%||||||||----------------
XXXXXX|||||XXXXXXXXXXXXXX||||||||||||||XXXXXXXXX||||||||||---XXXXXXXXXXXXX---XXXXXXXXXX----XXXXXXXXXXXXXXXXXXXXXXXXXXX|||||||||||||||||||||||||||||||||||||||||||||||---||||||||||||||||XXXXXXXXXX    XX