--------------------------------------------------------------------------------------------------------------------------------------------------------------------------------------------------------
--------------------------------------------------------------------------------------------------------------------------------------------------------------------------------------------------------
--------------------------------------------------------------------------------------------------------------------------------------------------------------------------------------------------------
--------------------------------------------------------------------------------------------------------------------------------------------------------------------------------------------------------
--------------------------------------------------------------------------------------------------------------------------------------------------------------------------------------------------------
--------------------------------------------------------------------------------------------------------------------------------------------------------------------------------------------------------
--------------------------------------------------------------------------------------------------------------------------------------------------------------------------------------------------------
-------------------------------------------------------------------------------------------------------------------------------------------------Tt-------------------------------------------------  --
-------------------------------------------------------------------------------------------------------------------------------------------------tt-------------Tt----------------------------------  --
-------------------------------------------------------------------------------------------------------------------------------------------------tTt------------tt----------------------------------  --
--------------------------------------------------------------Tt---------------------------------------------------------------------------------ttt------------tt----------------------------------  --
----------------------------------------------%%%%%%----------tt-----------%%%%%%%%%%--------------------------------------------- ----------%%%%%tt%%----------t--K---------------------------%%%    %%
---------------------------------------%%%%%%-||||||----------tt---G-------||||||||||---------------------------------------------%--G-------||%%%%%%%%-----%%%%%%%%%%----%%%%%%%%-------------|||||||||
---------------------------------------|||%%%-||||||-------%%%%%%%%%%------||||||||||------------------------------------------SC2S2S2-------||||%%%%%%-----||||||||||----||||||||-------------|||||||||
----------------%%%---%%%--------------||||||-||||||-------||||||||||------||||||||||------------------------------------%%%%----------------||||||||||-----||||||||||----||||||||-------------|||||||||
XXXXXXXXXXXXXXXX|||---|||XXXXXXXXXXXXXXXXXXXXXXXXXXXXXXXXXXXXXXXXXXXXXXXXXXXXXXXXXXXXXXXXXXXXXXXXXXXXXXXXXXXXXXXXXXXXXXXX||||XXXXXXXXXXXXXXXXXXXXXXXXXXXXXXX||||||||||XXXXXXXXXXXXXXXXXXXXXXXXXXXX    XX