------------------------------------------------------------------------------------------------------------------------------        ------------------------------------------------------------------
------------------------------------------------------------------------------------------------------------------------------        ------------------------------------------------------------------
------------------------------------------------------------------------------------------------------------------------------        ------------------------------------------------------------------
------------------------------------------------------------------------------------------------------------------------------        ------------------------------------------------------------------
------------------------------------------------------------------------------------------------------------------------------        ------------------------------------------------------------------
------------------------------------------------------------------------------------------------------------------------------        ------------------------------------------------------------------
------------------------------------------------------------------------------------------------------------------------------        ------------------------------------------------------------------
----------------------------------------------------------------------------Tt------------------------------------------------        -------------------------------------------------------------Tt---
----------------------------------------------------------------------------tt------------------------------------------------        -------------------------------------------------------------tt---
----------------------------------------------------------------------------tt------------------------------------------------        -------------------------------------------------------------tt---
----------------------------------KG----------------------------------------tt-G------------------------------G---------------        ---------Tt--------------------------------------------------tt---
---------------------------%%%%%%%%%------G-----------------------------%%Tt%%%%%%--------G------------------%%%%%%%%Tt%------        ---------tt-----------------------------------------------%%%%%%%%
---------------------------|||||||||-%%%%%%-----------------------------||tt||||||--%%%--%%%%%---------------||||||K|tt|------        ---------tt-----------------------------------------------||||||||
------%%%%------%%%%%------|||||||||-||||||--%%%%%------%%%%%----------%%%%%%%%%||--|||--|||||---------------|||%%%%%%%%%%----        %%%%%%%G-tt---------------%%%%------%%%%------------------||||||||
------||||------|||||------|||||||||-|||%%%%%|||||------|||||----------|||||||||||--|||--|||||---------%%%%%%%%%||||||||||-%%%        ||||%%%%%%%%%%------------||||------||||------------------||||||||
XXXXXX||||------|||||XXXXXXXXXXXXXXXXXXX||||||||||------|||||XXXXXXXXXXXXXXXXXXXXXXX|||--|||||XXXXXXXXX|||||||||XXXXXXXXXXX|||        XXXX||||||||||XXXXXXXXXXXX||||------||||XXXXXXXXXXXXXXXXXXXXXXXXXX