-----------------------------------------------------------------------------------------------------------------------------------------------    -----------------------------------------------------
-----------------------------------------------------------------------------------------------------------------------------------------------    -----------------------------------------------------
-----------------------------------------------------------------------------------------------------------------------------------------------    -----------------------------------------------------
-----------------------------------------------------------------------------------------------------------------------------------------------    -----------------------------------------------------
-----------------------------------------------------------------------------------------------------------------------------------------------    -----------------------------------------------------
-----------------------------------------------------------------------------------------------------------------------------------------------    -----------------------------------------------------
-----------------------------------------------------------------------------------------------------------------------------------------------    -----------------------------------------------------
-----------------------------------------------------------------------------------------------------------------------------------------------    -----------------------------------------------------
-----------------------------------------------------------------------------------------------------------------------------------------------    -----------------------------------------------------
-----------------------------------------------------------------------------------------------------------------------------------------------    -----------------------------------------------------
--------------------------------------------------------------------------r-----------------------------------------------%%%%-----------------    -----------------------------------------------------
-----------------------------------------------------------------------%%%%%--------------------------tt----Tt------------||||-----------------    -----------------------------------------------------
-----------%%%--%%%---------%%%%%--%%%%%%%---%%------------------------|||||--------------------------tt----tt---Tt-------||||----------%%%%%%%    %%%%%%%%%%%%%%%%%%%%%%%%%%%%%%%%%%%%%%%%%%%%%%%%%%%%%
-----------|||--|||---------|||||--|||||||---||%%%---%%%%%%%--%%%%-----y||||----k-----------------%%%%%%%%%%%%%%-tt-------||||r-----krr-|||||||    |||||||||||||||||||||||||||||||||||||||||||||||||||||
-----------|||--|||---------|||||--|||||||---|||||---|||||||--||||%%%%%%%%%%%%%%%%%%%%%%%%---%%%%%||||||||||||||-tt------%%%%%%%%%%%%%%%|||||||    |||||||||||||||||||||||||||||||||||||||||||||||||||||
XXXXXXXXXXX|||--|||XXXXXXXXX|||||--|||||||---|||||---|||||||--||||||||||||||||||||||||||||---|||||||||||||||||||XXXXXXXXX||||||||||||||||||||||    |||||||||||||||||||||||||||||||||||||||||||||||||||||