-------------------------- -----------------------------------------------------------------------------------------------------------------------------------------------------------------------------
--------------------- ------------------------------------------------------ ------------------- -- ------------ ------------------------ --------------------------------------------------------------
----------------------------- --------------------------------------------------------------------------------------------------------------------------------------------------------------------------
------------------- ----------- --------- ----- ---------------------------------------------------------------------------------------------------------- ---------------------------------------------
--------- --------------------------------------------------------------------------------------------------------------------------------------------- ------------------------------------------------
---------------------------------------- ------------------------------------------------------------------------------------------------------------------------------------------------------------- -
--------------------------------------------------------------------------------------------------- ------------ -------------- ----------------------- ---------- -------------------------------------
------------------------------------- ------------------------------------------------ ------------------------------------------------------------------------ ---------------------%%%%%%%------------
------------------------------------------------------------------------------ ------U-----------------------------------------------------------------------------------------------|||||||------------
-----------------------------------------SCSSSSS----------------g-------------------------------------------------g-g----------------------------------------------------------------|%%%|||------------
----------------------------------- ---gkgkkkkkgggg----------------------------------------%%%%%%%-----------------------------------------------          -------- -----------------|||||||----%%%%% %%
-------------- -- -------------------r----------- ---------------------------------------gggggg gggg--------------------------------------- ---------------------------------------%%%%%%%%%%%%%|||||%||
-------------------------%%%%%%%%%%%%%- ----------- %%%%%%%%%%------%%%%%-----%%%%%%%%%%%--|||||||------------------------------------------------tt-------------------------------|||||||||||||||||||||
-------------------------|||||||||||||-------------|||||||||||------|||||-----|||||||||||--|||||||--%%%%%%%%%%%%%---------------------------------tt--------g---------------g------|||||||||||||||||||||
------%%%%%--------------|||||||||||||%%%%%%%%%%%%%|||||||||||----%%%%%%%%%---|||||||||||--|||||||--|||||||||||||---------------------------%%%%%%%%%%%%%--------------------------|||||||||||||||||||||
XXXXXX|||||XXXXXXXXXXXXXX|||||||||||||||||||||||||||||||||||||----|||||||||---|||||||||||XXXXXXXXXXX|||||||||||||---XXXXXXXXXXXX-----XXX----|||||||||||||----XXXXXXXXXXXXXXXXXXXXXX|||||||||||||||||||||