--------------------------------------------------------------------------------------------------------------------------------------------------------------------------------------------------------
--------------------------------------------------------------------------------------------------------------------------------------------------------------------------------------------------------
--------------------------------------------------------------------------------------------------------------------------------------------------------------------------------------------------------
--------------------------------------------------------------------------------------------------------------------------------------------------------------------------------------------------------
--------------------------------------------------------------------------------------------------------------------------------------------------------------------------------------------------------
--------------------------------------------------------------------------------------------------------------------------------------------------------------------------------------------------------
--------------------------------------------------------------------------------------------------------------------------------------------------------------------------------------------------------
-----------------------------Tt-------------------------------------------------------------------------------------------------------------------------------------------------------------------------
-----------------------------tt-------------------------------------------------------------------------------------------------------------------------------------------------------------------------
-----------------------------tt------Tt-----------------------------------------------------------------------------------------------------------------------------------------------------------------
-----------------------------tt------tt----------------------------------------------------------------K------------------------------------------------K-------------------------------------------F---
-------------------------%%-%%%%%%%%-tt----------------------------2SCCS---------------G--------%%G%%%%%%-------------------------F--------------------2SC2CSTt------------------------------------- ---
--------%%%%%---%%%----%%%%%%%%%%%||-tt---------------------------------%%%%---%%%%-%%%%---G----||%%%||||-------------------------%------K-G----------%%%%%%-tt-----------------------------------%%%---
--------|||||---|||----|||||||||%%%%%%%%%%%------%%%%%------%%%%%-%%%%%-||||---||||-||||%%%%----|||||U||%%%%%%%%%%----------------|------%%%----%%%%--|||%%%%%%%%%--%%%---%%%%--------------------|||%%%
--------|||||---|||----|||%%%%%%|||||||||||------|||||------|||||-|||||-||||---||||-||||||||----||||||||||||||||||-------%%%----%%%------|||----||||--||||||||||||--|||---||||-----------%%%------||||||
XXXXXXXX|||||---|||XXXXXXX||||||XXXXXXXXXXXXXXXXX|||||------|||||XXXXXXX||||---||||X||||XXXXXXXXXX|||XXX||||||||||XXXXXXX|||----|||XXXXXX|||----||||XXXXXXXXXXXXXXXX|||---||||XXXXXXXXXXX|||XXXXXX|||XXX