--------------------------------------------------------------------------------------------------------------------------------------------------------------------------------------------------------
--------------------------------------------------------------------------------------------------------------------------------------------------------------------------------------------------------
--------------------------------------------------------------------------------------------------------------------------------------------------------------------------------------------------------
--------------------------------------------------------------------------------------------------------------------------------------------------------------------------------------------------------
--------------------------------------------------------------------------------------------------------------------------------------------------------------------------------------------------------
--------------------------------------------------------------------------------------------------------------------------------------------------------------------------------------------------------
--------------------------------------------------------------------------------------------------------------------------------------------------------------------------------------------------------
--------------------------------------------------------------------------------------------------------------------------------------------------------------------------------------------------------
------------------------------------------------------------g-------------------------------------------------------------------------------------------------------------------------------------------
----------------------------------gggkggkgkkkk----------------------------------------------------------------------------------------------------------------------------------------------------------
--------------------------------r--||||||||||-----------------------------------------------------------------------------------------------------------------------------------------------------------
-------------------------%%%%%%%%--||||||||||-%%%%%%%%%%%%%%----------U---gggggggggggg------------------------------------------------%%%%%%%%--------------------------------SCSSSSC-----SCSCSCC2------
-------------------------||||||||--||||||||||-||||||||||||||--------------------------------------------------------------tt-----g---g||||||||----------------------------------------------------------
-------------------------||||||||%%%%%%%%%%%%%||||||||||||||----------------%%%%%%%%--%%%%%%%%%%%-------------------------tt----------||||||||----g------g----------gg----------------------------------
------%%%%%--------------|||||||||||||||||||||||||||||||||||----------------||||||||--|||||||||||-------------------------tt----------||||||||----------------------------------------------------------
XXXXXX|||||XXXXXXXXXXXXXX|||||||||||||||||||||||||||||||||||---XXXXXXXXXXXXXXXXXXXXXXX|||||||||||---XXXXXXXXXXXX----XXXXXXXXXXXX----XXXXXXXXXXXXXXXXXXXXXXXXXXX----XXXXXXXXXXXXXXXXXXXXXXXXXXXXXXX    XX