--------------------------------------------------------------------------------------------------------------------------------------------------------------------------------------------------------
--------------------------------------------------------------------------------------------------------------------------------------------------------------------------------------------------------
--------------------------------------------------------------------------------------------------------------------------------------------------------------------------------------------------------
--------------------------------------------------------------------------------------------------------------------------------------------------------------------------------------------------------
--------------------------------------------------------------------------------------------------------------------------------------------------------------------------------------------------------
--------------------------------------------------------------------------------------------------------------------------------------------------------------------------------------------------------
--------------------------------------------------------------------------------------------------------------------------------------------------------------------------------------------------------
--------------------------------------------------------------------------------------------------------------------------------------------------------------------------------------------------------
------------------------------------------------------------------------------------------------------------------------------------------------------------------Tt------------------------------------
-------------------------------------------------------------------------------------------Tt---------------------------------------------------------------------tt------------------------------------
-------------------------------------------------------------------------------------------tt---------------------------------------------------------------------tt------------------------------------
----------------------------------------------------------------------%%-%%--UC------------tt----------------Tt-------------------F---------------------------%%%%%%%%%----------------------------F----
----------------------------------------------%%%---------------------||-||-------------%%%tt%K--------------tt-----------CC------%--------------------%%%%---|||||||||--------------------G------- ----
--------------%%%%--------K-------------------|||---------------------||-%%%------------%%%%%%%%%%-----------tt-------------------|--------------------||||---|||||||||-------------%%%----%%%--%%%%%---
--------------||||----%%%%%-----%%%-----------|||-------%%%%%%%%%%%-%%%%%%%%%-----------||||||||||------%%%%%%%%%%%---------------|--------------------||||---|||||||||-------------|||----|||--|||||---
XXXXXXXXXXXXXX||||XXXX|||||-----|||XXXXXXXXXXX|||XXXXXXX|||||||||||X|||||||||XXXXXXXXXXX||||||||||XXXXXX|||||||||||XXXXXXXXXXXXXXXXXXXXXXXXXXXXXXXXXXXXXXXXXXXXXXXXXXXXXXXXXXXXXXXXX|||----|||XX|||||XXX