--------------------------------------------------------------------------------------------------------------------------------------------------------------------------------------------------------
--------------------------------------------------------------------------------------------------------------------------------------------------------------------------------------------------------
--------------------------------------------------------------------------------------------------------------------------------------------------------------------------------------------------------
--------------------------------------------------------------------------------------------------------------------------------------------------------------------------------------------------------
--------------------------------------------------------------------------------------------------------------------------------------------------------------------------------------------------------
--------------------------------------------------------------------------------------------------------------------------------------------------------------------------------------------------------
--------------------------------------------------------------------------------------------------------------------------------------------------------------------------------------------------------
--------------------------------------------------------------------------------------------------------------------U----------------------------------------%%%%%%-------------------------------------
---------------------------------------------------------------------------------------------------------------------------SCSS2SS--------------g--g---------||||||-------------------------------------
-------------------------------------------------------------------------------------------------------------------------------------------------------------||||||-------------------------------------
-----------------------------g------------------------------------------------------------------------------------------gkgggkgkggggg----------%%%%%%%%------||||||------U2SCCS2------------------------
--------------------------------------------------------------------------kggggggggkk---------------------------%%%%%%%%-----------------------||||||||----%%%%%%%%%%%------------------------------- %%
--------------------------------%%%%%-----------------------------------r--|||||||||----------------------------||||||||-------------%%%%%%%%%%||||||||----|||||||||||------------------------------- ||
--------------------------------|||||---g-----g----------g-----g-%%%%%%%%--|||||||||-%%%%%%%%%%%%%--------------||||||||-------------||||||||||||||||||----|||||||||||-----------------g--g----------|||
------%%%%%---------------------|||||----------------------------||||||||--|||||||||-|||||||||||||--------------||||||||%%%%%%%%%%%%%||||||||||||||||||----|||||||||||%%%%%%%%%%%%%------------------|||
XXXXXX|||||XXXXXXXXXXXXXX-----XXXXXXXXX---XXXXXXXXXXXXXXXXXXXXXXX||||||||XXXXXXXXXXXX|||||||||||||----XXXXXXXXXX|||||||||||||||||||||||||||||||||||||||----||||||||||||||||||||||||----XXXXXXXXXXX   |||