--------------------------- ------------------------- ------------------------------ ---------------------------------------------------------------- ----------------------- ------------- ------------
------------------------------------------------------------------------------------ ----------------------------------------------------------- -------------------------------------------------------
----------------------------------------------------------------------------------------------------- --------------------------------------------------------------------------------------------------
----------------- --------------------------------------------------------------------------------------------------------------------------------------------------------------------------------------
-------------------------------------------------- ----- --------------------------------------------------------------------------C2USS----------------------------------------------------------------
------------------------------------------------------------------------------------- ------------------------------------------------------------------------------------------------------------------
---------------------------------------------------- ----------------------------------------------------------------------------------------------------------------------------- ---------------------
--------------------------------------------- ------------------------------------------------------------------------------------y---------------------------------------------------------------------
---------------------------------- ---------------------------------------------------------------------------------------------- %%%%%%----------------------------------------------------------------
-------------------- -----------------------------------------------------------------------------------------------         -----||g|||----------------------------------------------------------------
----------------------------------------------------------------------------------------------------------- ----------------------||%%%%%%%------------------------------------------ ------------------
--------- ------------------------------------------------------------------------------------------------------------------------|||||||||---------------------------------------------- -- -----------
-----------------------------------------------%%%%%%%%%%%-----------------------------------------------# --#--------------------| |||||||-------------------------------------------------------------
--------------------%%%%%%%%--%%%%-------------|||||||||||--------------- -%%--%%--#--#---------%%---%%%%%---%%%------------------|||||||y|-------------------------------------------------------------
--  ----------%%--%%||||||||--||||-------------|||||||||||-----------------||--||%%%--%%%-------||---|||||---| |%%---%%%%--%%----%%%%%%%%%%%%------------------------------------------------ ----------
    XXXXXXXXXX||--||||||||||--||||XX   ---XXXXX|||||||||||X ---XXXX XXXXXXX||--|||||--||| X---   |---|||||---|||||---||||--|| X X||||||||||||XX   XXX X FXXXX XXXXX   XX XX X      XXX X X  XXX X   XXX 