--------------------------------------------------------------------------------------------------------------------------------    --------------------------------------------------------------------
--------------------------------------------------------------------------------------------------------------------------------    --------------------------------------------------------------------
--------------------------------------------------------------------------------------------------------------------------------    --------------------------------------------------------------------
--------------------------------------------------------------------------------------------------------------------------------    --------------------------------------------------------------------
--------------------------------------------------------------------------------------------------------------------------------    --------------------------------------------------------------------
--------------------------------------------------------------------------------------------------------------------------------    --------------------------------------------------------------------
--------------------------------------------------------------------------------------------------------------------------------    --------------------------------------------------------------------
--------------------------------------------------------------------------------------------------Tt----------------------------    --------------------------------------------------------------------
--------------------------------------------------------------------------------------------------tt----------------------------    --------------------------------------------------------------------
--------------------------------------------------------------------------------------------------tt----------------------------    --------------------------------------------------------------------
------------------------------------------------------------------------------------------------G-tt--K-------------------------    --------------------------------------------------------------------
---------------------------------------------------------------------------Tt----------------C%%%%%%%%%%---------------Tt-------    --------------------------------------------------------------------
---------------------------------------------------------------------SC----tt-----------------||||||||||%%%---%%%----G-tt-------    %%--%%%-------------------------------------------------------------
----------------------------G-------------G--------------------------------tt-----------2SCCC-|||||||||||||---|||-%%%%%tt-K-----    ||--|||------------------------------%%%%%%%%%%----------------%%%%%
--------------------------%%%---%%%----%%%%%%%%%%----------------------%%%%%%%%%%%------------|||||||||||||---|||-||%%%%%%%%----    ||--|||----------------------%%%%%%--||||||||||--%%%%%------%%%|||||
XXXXXXXXXXXXXXXXXXXXXXXXXX|||---|||XXXX||||||||||XXXXXXXXXXXXXXXXXXXXXX|||||||||||XXXXXXXXXXXXXXXXXXXXXX|||---|||XXX||||||||XXXX    ||--|||XXXXXXXXXXXXXXXXXXXXXX||||||XX||||||||||XX|||||XXXXXX||||||||