--------------------------------------------------------------------------------------------------------------------------------------------------------------------------------------------------------
--------------------------------------------------------------------------------------------------------------------------------------------------------------------------------------------------------
--------------------------------------------------------------------------------------------------------------------------------------------------------------------------------------------------------
--------------------------------------------------------------------------------------------------------------------------------------------------------------------------------------------------------
--------------------------------------------------------------------------------------------------------------------------------------------------------------------------------------------------------
--------------------------------------------------------------------------------------------------------------------------------------------------------------------------------------------------------
--------------------------------------------------------------------------------------------------------------------------------------------------------------------------------------------------------
---------------------Tt------------------------------------------------------------------------------------------------------------------------------------------------Tt-------------------------------
--------------Tt-----tt------------------------------------------------------------------------------------------------------------------------------------------------tt-------------------------------
--------------tt-----tt------------------------------------------------------------------------------------------------------------------------------------------------tt-------------------------------
--------------tt-----tt--Tt--------------------------------------------------------------------------------------------------------------------------------------------tt-------------------------------
--------------tt--%%%%%%%tt%------------%%%%%%%%%%--------------------------------------------------------------------------------F-------------------------------%%%%%%%%%%%------Tt-------------------
----------%%%%%%%%%||||||tt|------------||||||||||---------------%%%%%%%%%%%%%%-----------------------------------------------%%%%%%------%%%%%------%%%%---------|%%%%%%||||------tt-------------------
----------||||||||||%%%%%%%%%%%%--------||||||||||-----%%%%%%%%--||||||||||||||---------------------------------------%%%%%%%%%%||||------|||||------||||---------|||||||||||--K---tt--K---------F------
----------||||||||||||||||||||||----%%%%%%%%%%||||-----||||||||--||||||||||||||-----------%%%----------%%%---%%%------||||||||||||||------|||||------||||---------|||||||||||-%%%%%%%%%%%-------- ------
XXXXXXXXXXXXXXXXXXXXXXXXXXXXXXXXXXXX||||||||||XXXXXXXXX||||||||XX||||||||||||||XXXXXXXXXXX|||XXXXXXXXXX|||---|||XXXXXXXXXXXXXXXXXXXXXXXXXX|||||------||||XXXXXXXXXXXXXXXXXXXXX|||||||||||XXXXXXXXXXXXXXX