--------------------------------------------------------------------------------------------------------------------------------------------------------------------------------------------------------
--------------------------------------------------------------------------------------------------------------------------------------------------------------------------------------------------------
--------------------------------------------------------------------------------------------------------------------------------------------------------------------------------------------------------
--------------------------------------------------------------------------------------------------------------------------------------------------------------------------------------------------------
--------------------------------------------------------------------------------------------------------------------------------------------------------------------------------------------------------
--------------------------------------------------------------------------------------------------------------------------------------------------------------------------------------------------------
--------------------------------------------------------------------------------------------------------------------------------------------------------------------------------------------------------
--------------------------------------------------------------------------------------------------------------------------------------------------------------------------------------------------------
--------------------------------------------------------------------------------------------------------------------------------------------------------------------------------------------------------
----------------------------------------------------------------------------------------------Tt--------------------------------------------------------------------------------------------------------
----------------------------------------------------------------------------------------------tt------------------------G------------------------------G---------G--------------------------------------
-------------------%%%%%---------------------------------K---G--------G-----------------------tt---------------%%%%%%%%%%--------- -----------------SSUU%%%%%%%%%%--------------------------------------
------%%%----------|||||----------%%%%---%%%%%-----------%%%%%------%%%-------------------%%%%%%%%%------------||||||||||---%%%%%%%%%-------------------||||||||||----------%%%-------------G-----K-----
------|||----------|||||-------K--||||---|||||-----------|||||------|||-------------------|||||||||------------%%%|||||||---|||||||||-------------------||||||||||----------|||------------%%%%%%%  ----
------|||----------|||||-%%%---%%%||||---|||||-----------|||||------|||%%%%%%%%%%---------|||||||||------------||||||||||---|||||||||-------------------||||||||||-%%%%%%%%%%||------------|||||||||----
XXXXXX|||XXXXXXXXXXXXXXXX|||---|||||||---|||||XXXXXXXXXXX|||||------|||||||||||||XXXXXXXXX|||||||||XXXXXXXXXXXXXXXXXXXXXXXXX|||||||||XXXXXXXXXXXXXXXXXXXXXXXXXXXXXX||||||||||XXXXXXXXXXXXXX|||||||||  XX