--------------------------------------------------------------------------------------------------------------------------------    --------------------------------------------------------------------
--------------------------------------------------------------------------------------------------------------------------------    --------------------------------------------------------------------
--------------------------------------------------------------------------------------------------------------------------------    --------------------------------------------------------------------
--------------------------------------------------------------------------------------------------------------------------------    --------------------------------------------------------------------
--------------------------------------------------------------------------------------------------------------------------------    --------------------------------------------------------------------
--------------------------------------------------------------------------------------------------------------------------------    --------------------------------------------------------------------
--------------------------------------------------------------------------------------------------------------------------------    --------------------------------------------------------------------
--------------------------------------------------------------------------------------------------------------------------------    --------------------------------------------------------------------
--------------------------------------------------------------------------------------------------------------------------Tt----    --------------------------------------------------------------------
---------------------------------------Tt---------------------------------------------------------------------------------tt----    --------------------------------------------------------------------
---------------------------------------tt---------------------------------------------------------------------------------tt----    --------------------------------------------------------------------
--------%%%----%%%---------------------tt----------SSS-----------------------------------%%%----------------------------CStt----    %%%%------%%%%Tt%%%---------------------------------------------Tt--
--------|||----|||------------------%%%%%%%%%%-------------------------------------------|||--------------------------%%%%%%%%%%    ||||-%%%%%%%%%tt%||--------------G------------------------------tt--
--------|||----|UUSC--%%%%------%%%-||||||||||-%%%%%--%%%------%%%%%%%--%%%%%------------||CSC------------G-----------||||||||%%    ||||-||||%%%%%%%%%%-----------%%%%%----%%%--------------------G-tt--
--------|||----|||----||||------|||-||||||||||-|||||--|||------|||||||--|||||------------|||------%%%%--%%%%----------||||||||||    ||||-||||||||||||||-----------|||||----|||-------------------%%%%%%%
XXXXXXXXXXXXXXXXXXXXXX||||------|||XXXXXXXXXXXX|||||XX|||------|||||||--|||||XXXXXXXXXXXXXXXXXXXXX||||--||||XXXXXXXXXXXXXXXXXX||    XXXXXXXXX||||||||||XXXXXXXXXXX|||||----|||XXXXXXXXXXXXXXXXXXX|||||||