--------------------------------------------------------------------------------------------------------------------------------------------------------------------------------------------------------
--------------------------------------------------------------------------------------------------------------------------------------------------------------------------------------------------------
--------------------------------------------------------------------------------------------------------------------------------------------------------------------------------------------------------
--------------------------------------------------------------------------------------------------------------------------------------------------------------------------------------------------------
--------------------------------------------------------------------------------------------------------------------------------------------------------------------------------------------------------
--------------------------------------------------------------------------------------------------------------------------------------------------------------------------------------------------------
--------------------------------------------------------------------------------------------------------------------------------------------------------------------------------------------------------
--------------------------------------------------------------------------------------------------------------------------------------------------------------------------------------------------------
--------------------------------------------------------------------------------------------------------------------------------------------------------------------------------------------------------
--------------------------------------------------------------------------------------------------------------------------------------------------------------------------------------------------------
---------------- ------------- -------------------------------------------- - --------------------------------------------------------------------------------------------------------------------------
----------------2CS2C-%% %%%%% -------------------------------------------- SC----------------------------------------------------F---------------------------------------------------------------------
-----------------%%%%%%%%%|||||--------- ------------------------ -------  -------------- %%%%  %--------------------------------- -----------------%% %------------------------------------------------
-----------------||||||||||||||--------%%%%%%% %%% ------------ %% ---%%%%%-----U CU2%% -||||||||---------------------------------|---------------2U||U|----------------------%%% %--%%%  --------------
-----------------||||||||||||||--------||||||||||||------------||||---|||||----------|||-||||||||--------------------%%%%%%% %%---|-----------------||-|----------------------|||||--|||||--------------
 XXXX XXXXXXXXXXXXX XXXX XXXX XXXXX  XXXXXXXXXX XXXXX X XXXXXXX||||---|||||XXXXXXX XX|||XXX XXX XXXXXXXXX X XXXXXXXXX||||||||||XX XX XXX X XXX XX XX|| X  XXXXXXXXXXXXXX X X X|||||--|||||X XXXXXXXXXXXX