--------------------------------------------------------------------------------------------------------------------------------------------------------------------------------------------------------
--------------------------------------------------------------------------------------------------------------------------------------------------------------------------------------------------------
--------------------------------------------------------------------------------------------------------------------------------------------------------------------------------------------------------
--------------------------------------------------------------------------------------------------------------------------------------------------------------------------------------------------------
--------------------------------------------------------------------------------------------------------------------------------------------------------------------------------------------------------
--------------------------------------------------------------------------------------------------------------------------------------------------------------------------------------------------------
--------------------------------------------------------------------------------------------------------------------------------------------------------------------------------------------------------
--------------------------------------------------------------------------------------------------------------------------------------------------------------------------------------------------------
---------------------------------------------------------------------------------------------------------------------------------------------g--g-------------------------------------------------------
--------------------------gg--g--------------------------------------------------------------------------------------SCCSC2S2SC-------------------------------------------------------------------------
---------------------------------U----------------------------------------------------------------------------------kggkkgggggggg-----------------------------------------------------------------------
-------------------------------------ggkgkggggggk-------------------------------------------%%%%%%%---------------r--------------------------------%%%%%%-----------------------------------------------
---------------------------------------%%%%%%%%----------------------------g----%%%%%-------|||||||----%%%%%%%%%%%%--------------%%%%%%%%%%%-------|%%%%%----g-----%%%%%%%%-----------------------------
---------------------------------------||||||||--%%%%%%%%%%%%%------------------|||||---g---|||||||----||||||||||||--------------|||||||||||-------||||||----------||||||||-----------------------------
------%%%%%------------------%%%%%%%%--||||||||--|||||||||||||------------------|||||-------|||||||----||||||||||||%%%%%%%%%%%%%%|||||||||||-------||||||----------||||||||-----------------------------
XXXXXX|||||XXXXXXXXXXXXXX----||||||||XXXXXXXXXXXX|||||||||||||-----XXXXXXXX---XXXXXXXXX---XXXXXXXXXXXXX|||||||||||||||||||||||||||||||||||||-----XXXXXXXXXXX-----XXXXXXXXXXXXXXXXXXXXXXXXXXXXXXXXX    XX