---------------------------------------------------------------------------------------------------------------------------------      -----------------------------------------------------------------
---------------------------------------------------------------------------------------------------------------------------------      -----------------------------------------------------------------
---------------------------------------------------------------------------------------------------------------------------------      -----------------------------------------------------------------
---------------------------------------------------------------------------------------------------------------------------------      -----------------------------------------------------------------
---------------------------------------------------------------------------------------------------------------------------------      -----------------------------------------------------------------
---------------------------------------------------------------------------------------------------------------------------------      -----------------------------------------------------------------
---------------------------------------------------------------------------------------------------------------------------------      -----------------------------------------------------------------
---------------------------------------------------------------------------------Tt----------------------------------------------      -----------------------------------------------------------------
--------------------------------------------------Tt-----------------------------tt----------------------------------------------      -----------------------------------------------------------------
--------------------------------------------------tt-----------------------------tt----------------------------------------------      -----------------------------------------------------------------
--------------------------------------------------tt------------------Tt--------Ktt-----------------------------------Tt---------      -----------------------------------------------------------------
--------------------U2U--------------------U2USUSStt------------------tt----%%%%%%%%%%%--------G-------K--------------tt---------      -------G------------------Tt-%%%%%%%%%%--------------------------
--------%%%-----%%%%----------------K----------%%%%%%%%%%-------------tt----|||||||||||------%%%%------%%%%%----------tt----G----      ------%%%%%%%%%%----------tt-||||||||||--------------------------
--------|||-----||||---%%%%%%------%%%%%%%%%---||||||||||---------%%%%%%%%%%|||||||||||------||||------|||||-----%%%%%%%%%%%%----      ------||||||||||----------tt-|||K||||||-------------------------%
--------|||-----||||---||||||------|||||||||---||||||||||---------|||||||||||||||||||||------||||------|||||-----||||||||||||----      ------||||||||||------%%%%%%%%%%%||||||-------------------------|
XXXXXXXX|||-----||||XXXXXXXXXXXXXXXXXXXXXXXXXXXXXXXXXXXXXXXXXXXXXXXXXXXXXXXXXXXXXXXXXXXXXXXXX||||------|||||XXXXX||||||||||||XXXX      XXXXXX||||||||||XXXXXX|||||||||||XXXXXXXXXXXXXXXXXXXXXXXXXXXXXXX|