--------------------------------------------------------------------------------------------------------------------------------------------------------------------------------------------------------
--------------------------------------------------------------------------------------------------------------------------------------------------------------------------------------------------------
--------------------------------------------------------------------------------------------------------------------------------------------------------------------------------------------------------
--------------------------------------------------------------------------------------------------------------------------------------------------------------------------------------------------------
--------------------------------------------------------------------------------------------------------------------------------------------------------------------------------------------------------
--------------------------------------------------------------------------------------------------------------------------------------------------------------------------------------------------------
--------------------------------------------------------------------------------------------------------------------------------------------------------------------------------------------------------
--------------------------------------------------------------------------------------------------------------------------------------------------------------------------------------------------------
--------------------------------------------------------------------------------------------------------------------------------------------------------------------------g-----------------------------
--------------------------------------------------------------------------------------------------------------------------------------------------------------------------------------------------------
------------------------------------------------------------------------------------------------------------------------------CCS CSSSS-------------------------------g-g-------------------------------
----------------------------- %%%----------------------------------------------------------- S SS----------------------------ggggggkkgkgkg--------------------------------------------------------------
-----------------------------||||------------------------------------------------------------------------------------------r-------------------------------------% % %%% %--------------r-------r-------
-----------------------------|% %%%  ----------g--------------g-------------------------------------------------  %%%% %   %--------------%%%  % % -----g---g--g-|||||||||------------------------------
------%  %%------------------||||||||---------------------------------------------------------------------------||||||||||||--------------|||||||||--------------|||||||||---  % %% %%%-----------------
    XX|||||X X XX  X  XX ---XXXXXX   X X -----XX   XXXX ----- XX XX    XX X--- X X      XXX  XXXX       X   X X |||||||||||| XX  XXXX  X  |||||||||----XX X XX X |||||||||---||||||||||---XXX X XX X FXX