-------------------------------------------------------------- ---------------------------------------------------------------------------------------------------------------- ------------------------
-------- ------------------------------------------------------------------ ----------------------------------------------------------------------------------------------------------------------------
---------------------------------------------------------------------------------------------------------------------------------------------------------- ---------------------------------------------
--------------------- -------------------------------------------------- --------- --------------------------------- -----------------------------------------------------------------------------------
----------------------------------------------------------------------------------------------------------------------------------------- --------------------------------------------------------------
--------------------------------------------------------------------------------------------------------------------------------------------------------------------------------------------------------
----------------------------------------------------------------------------------------------------- ------------ ------------------------------------------------ -------------------- ---------------
------------------------------------------------------------------------------ ------------------------------------ ------------------- ----------------------------------------------------------------
-------------------------- ------------------------------------------------------------------ --------------------------------------------------------------------------------- ------------------------
---------------------------- --------------------------------------------------------------------------------------------------------------------------------------------------------- t----------------
-- --------------------------------------------------------------------------------------------------------------------------------------------------------------  - -----------------tt----------------
-- --------------------------------2S2U2S-------------------------------------------------------------------- --U2UU2U2----------- --CUU----- - ----------------U2U2S-----------------tt---------%% %---
-------------------------------------2--------------- ----------------- ---------------- -----------------%%%%--------------------%----------%%%%%-------------------- ------ -----%%%%%%%%%-----|%% ---
---------------------------------------------------%%%%%%%%%%---------%%%%%%%%---------- -----------------||||------------------ -|-----%%%%%%%%%|----------------------------- ---|||||||||-----||||---
---------------------------------------------------||||||||||---------||||||||----------------------------||||--------------------|-----||||||||||----------------------------- ---|||||||||-----||||---
XX X XXXXXXXXXXXX XXXXXX X XX XXXXXXXXX XXX  XXX XXXXXX XXXXXXXX XX XX||||||||XX XXXX  XX XX   XXX X XXXXXXXXXXXXXXXXXXX XXXXX XXXXXXXXX|||||||||XX X  XXXXXX XXXXXXXXXX XXXXXXXXXX X XX X XXXXXXX|||XXX