------------------------------------------------------------------------------------------ -------------------------------------------------------------------------------------------------------------
------------------------------------------------------------ ----------------------------- -------------------------------------------------------------------------------------------------------------
------------------------------------------------------------------------------------------ -------------------------------------------------------------------------------------------------------------
------------------------------------------------------------------------------------------ -------------------------------------------------------------------------------------------------------------
------------------------------------------------------------------------- ---------------- -------------------------------------------------------------------------------------------------------------
------------------------------------------------------------------------------------------ -------------------------------------------------------------------------------------------------------------
------------------------------------------------------------------------------------------ -------------------------------------------------------------------------------------------------------------
------------------------------------------------------------------------------------------ -------------------------------------------------------------------------------------------------------------
------------------------------------------------------------------------------------------ -----------------------------S2 C----------------------------------------------------------------------------
-------------------- SSSSC---------------------------------------------------------------- -------------------------------------------------------------------------------------------------------------
--------------------------------------------------------- ----------------------------------------------------------------------------------------------------------------------------------------------
---------------------------------------------------------- ------------------------------------------------------% %%---------y-------------------------------------------------------------------------
--------------------y-------------------------------------------- %   %%  --%%%%------------------%%%%-- %  --k--||||k- %  %%%    -------------------------------------------------------------- -------
------- -----------%%% %%    %-----------------------------------|||||||||--||||%% %---%%%%-------||||--||||   %%%%%%  |||||||||||-------- -------------------------------------------------------------
-------------------|||||||||||-----------%%-- %------%% %%-------|||||||||--||||||||---||||% ---%%||||--||||||||||||||||||||||||||-------- %%%%%% F% %%  %   %%%  %   %% % %%%% % %%%%  %    %%%%%%%%  %
 X  XXXXXXX XXX--XX||||||| |||XXXX---XXX ||--|| X--X |||||XX---XX|||||||||--||||||||---||||||---||||||--||||||||||||||||||||||||||XX  XXX |||||||| |||||||||||||||||||||||||||||||||||||||||||||| ||||||