-------------------------------------------------------------------------------------------------------------------------------      -------------------------------------------------------------------
-------------------------------------------------------------------------------------------------------------------------------      -------------------------------------------------------------------
-------------------------------------------------------------------------------------------------------------------------------      -------------------------------------------------------------------
-------------------------------------------------------------------------------------------------------------------------------      -------------------------------------------------------------------
-------------------------------------------------------------------------------------------------------------------------------      -------------------------------------------------------------------
-------------------------------------------------------------------------------------------------------------------------------      -------------------------------------------------------------------
-------------------------------------------------------------------------------------------------------------------------------      -------------------------------------------------------------------
-------------------------------------------------------------------------------------------------------------------------------      -------------------------------------------------------------------
----------------------------------------------------------------------------------------------------------Tt-------------------      -------------------------------------------------------------------
---------------------------------------------------------Tt-----------------------------------------------tt-------------------      -------------------------------------------------------------------
---------------------------------------------------------tt-----------------------------------------------ttTt-----------------      -------------------------------------------------------------------
-------------------------------------------G-------------tt-------------------%%%%%%-%%%-------------%%%%%%%tt%%%--------------      --------------------------------------G-----------------------SUS--
----------------------------%%%---%%%---%%%%%%%%%%-G%%%%%%%%%%----------------||%%%%%%%%%%-----------|||||||tt|||--------------      -------------------%%%%%%-----------%%%%%%%%%%%%%%-----------------
---------------SUU----------|||---|||--%||||||||||-%%%%%||||||-----%%%%-------||||||||||||-----------||%%%%%%%%%%%%------------      -------------------||||||-----------||||||||||||||-----------------
----------------------------|||---|||--|||||||||||-|||||||||||-----||||-------||||||||||||-----------||||%%%%%%||||--%%%------%      -------------------||||||-----------||||||||||||||---------------%%
XXXXXXXXXXXXXXXXXXXXXXXXXXXX|||---|||XXX||||||||||XXXXXXXXXXXXXXXXXXXXXXXXXXXXXX||||||||||XXXXXXXXXXXXXXX||||||XXXXXX|||------|      XXXXXXXXXXXXXXXXXXX||||||XXXXXXXXXXXXXXXXXXXXX||||XXXXXXXXXXXXXXX||