----------------------------- ----------------- ------- ------------------------------------------------------------------------------------------------------------ -----------------------------------
----------------------------- -------------------------------------------------------------------------------------------------------- ---------------------------------------------------- ------------
-------------------------------------------------------------- ----------------------------------------------------------------------- ---------------------------------------------------------------- 
------------------------------------------------------------- --------- -------------------------------- -------- ----------- ----------------------------------------------- --------------------------
--------- ------------------------ --------------------------------------------------------------------------- ---------------------------------- ------------------------------------------------------
--------- -------------------- ------------------------------------------------------------- -----------------------------------------------------------------------------------------------------------
------------------- -------------- ------------------------------------------------------------------------------------------------- -------------------------------------------------------------------
----------------------------------------------------- ----------------------------------------------------------------------------------------- --------------------------------------------------------
------------------------- ------ ------ ------- --------------------- ----- ----------Tt-------------------------------------------------------------------- -------------------------------------------
--------------------------------- ----------------------------------------------------tt-----------------------------Tt---------- ----------------------------------------------------------------------
---------------------------------------------- ----------------------- ---------------tt-------------------------K---tt---------------------K------------------------------------- ------------ --------
------------------------------------- ------- ----------------- --------------------KKtt----------- -----------%%%% %tt%- -------- -------2C2--- ----------------K--------------------------------------
----------------------------------------- ------K--------U2SCS---K-----------------%%%%%%%%%%----------------- ||%%%%%%%%%%-----G-%---------------%%%%%%%%%%---- %%%%------%%%%%--------K---- --------- 
----------- ------------------------------------%%%%--%%%------%%%%%----%%%%%------||||||||||------------------|||||||||| |C2USUSS|---------------||||||||||-----||||------|||||--------%% %------------
-----------------------%%%%%%%%%%---------------| ||--|||------|||||----|||||------ |||||||||---------- -------||||||||||||-- ----|---------------||||||||||-----|| |------|||||--------||||------------
XX XXXXX XX X XX XXXXXX|||||||||| XXX XXXXX XXXX||||--|||XXXX X|||||----|||||X  XXX||||||||||XXXXXXX   X   XXXXX |||||| ||| XX  XXXX X  X XXXXXXXX||||||||||X XXX||||------|||||X X XXXX|||| XXXXXXXXX  