---------------------------------------------------------------------------------------------------------------------------------------------------       ----------------------------------------------
---------------------------------------------------------------------------------------------------------------------------------------------------       ----------------------------------------------
---------------------------------------------------------------------------------------------------------------------------------------------------       ----------------------------------------------
---------------------------------------------------------------------------------------------------------------------------------------------------       ----------------------------------------------
---------------------------------------------------------------------------------------------------------------------------------------------------       ----------------------------------------------
---------------------------------------------------------------------------------------------------------------------------------------------------       ----------------------------------------------
---------------------------------------------------------------------------------------------------------------------------------------------------       ----------------------------------------------
---------------------------------------------------------------------------------------------------------------------------------------------------       ----------------------------------------------
---------------------------------------------------------------------------------------------------------------------------------------------------       ----------------------------------------------
-----------------------------------------------------------------------------------------------------------------------------------------SCC2------       ----------------------------------------------
------------------------------------------------------------------------------------------------------------y-y------------------------------------       ----------------------------------------------
-----------------------------------------------------------------------------#--#--------------------------%%%%%%----------------------------------       ----------------------------------------------
------------------------------#---#---------------------------------#---#--%%%--%%%---------------%%%--%%%-||||||-------------------------k--------       ----------------------------------------------
-------------#--#----tt-----%%%---%%%%%%%--%%%%%%%--%%%-----------%%%---%%%|||--|||------%%%------|||--|||-kgy|||-----------%%%---%%%%%%%%%%%%-----       ----------------------------------------------
-----------%%%--%%%--tt-----|||---|||||||--|||||||--|||%%%%---%%%%|||---||||||--|||------|||%%--%%|||--|||%%%%%%%%%%%%%--%%%|||---||||||||||||%%%%%       %%%%%%%%%%%%%%%%%%%%%%%%%%%%%%%%%%%%%%%%%%%%%%
XXXXXXXXXXX|||--|||XXXXXXXXX|||---|||||||--|||||||--|||||||---|||||||---||||||--|||XX--XX|||||--|||||--||||||||||||||||--||||||---|||||||||||||||||       ||||||||||||||||||||||||||||||||||||||||||||||