--------------------------------------------------------------------------------------------------------------------------------------------------------------------------------------------------------
--------------------------------------------------------------------------------------------------------------------------------------------------------------------------------------------------------
--------------------------------------------------------------------------------------------------------------------------------------------------------------------------------------------------------
--------------------------------------------------------------------------------------------------------------------------------------------------------------------------------------------------------
--------------------------------------------------------------------------------------------------------------------------------------------------------------------------------------------------------
--------------------------------------------------------------------------------------------------------------------------------------------------------------------------------------------------------
--------------------------------------------------------------------------------------------------------------------------------------------------------------------------------------------------------
-----------------------------------------------------------------------------------------------------------------------------------------------2SS------------------------------------------------------
---------------------------------------------------------------------------------------------------------------------------------------------kggkggg--------------------------------g-g-----------------
--------------------------------------------------------------------------U--------------------------------------------%%%%%%%%------------r------------------------------------------------------------
----------------------------------------------------------------------------------22SSCS---------------g-g-----g-------||||||||----%%%%%%%%%--------%%%%%%%%%%%%%---------------------------------------
--------------------------------------------------g---------------------------kgggkkkggggg-----------------------------||||||||----|||||||||--------|||||||||||||-----%%%%%%%%%%%%%---------------------
-----------------------------%%%%%%-------------------------------------------------------------------%%%%%%%%%%%------||||||||----|||||||||%%%%%%%%|||||||||||||-----|||||||||||||---------------------
-----------------------------|%%%%%---g---g----g-------------------%%%%%%%%%%%------------%%%%%%%%%%%%|||||||||||----%%%%%%%%%%%%%%||||||||||||||||||||||||||||||-----|||||||||||||----%%%%%%%%%--------
------%%%%%------------------||||||--------------------------------|||||||||||------------|||||||||||||||||||||||----||||||||||||||||||||||||||||||||||||||||||||-----|||||||||||||----|||||||||--------
XXXXXX|||||XXXXXXXXXXXXXX---XXXXXXXXX-----XXXXXXXX-----XXXXXXXXXXXX|||||||||||XXXXXXXXXXXX|||||||||||||||||||||||----||||||||||||||||||||||||||||||||||||||||||||-----|||||||||||||----|||||||||XX    XX