--------------------------------------------------------------------------------------------------------------------------------------------------------------------------------------------------------
--------------------------------------------------------------------------------------------------------------------------------------------------------------------------------------------------------
--------------------------------------------------------------------------------------------------------------------------------------------------------------------------------------------------------
--------------------------------------------------------------------------------------------------------------------------------------------------------------------------------------------------------
--------------------------------------------------------------------------------------------------------------------------------------------------------------------------------------------------------
--------------------------------------------------------------------------------------------------------------------------------------------------------------------------------------------------------
--------------------------------------------------------------------------------------------------------------------------------------------------------------------------------------------------------
--------------------------------------------------------------------------------------------------------------------------------------------------------------------------------------------------------
-------------------------------------------------------------------------Tt---------------------------------------------------Tt------------------------------------------------------------------------
--------------------------------------Tt---------------------------------tt---------------------------------------------------tt------------------------------------------------------------------------
--------------------------------------tt---------------------------------tt------------K-G-Tt----G----------------------------tt------------------------------Tt----------------------------------------
--------------------------------------tt--------------%%%%%%%%%%%--------tt--G---------%%%-tt----%%%%---------------------%%%%%%%%F---------------------------tt----------------------------------------
---------K-----------------------%%%%%%%%%%%----------|||||||||||---%%%%%%%%%%---------|||-tt----||||---------------------||||||||%----------%%%%------2C-----tt---------------KK---G-------------------
-------%%%%------%%%-------------|||||||||||----------|||||||||||---||||||||||---------|%%%%%%%%-||||---------------------|||||||||----------||||----------K--tt-G------%%%%%%%%%%-%%%%------%%%----F---
-------||||------|||-------------|||||||||||----------|||||||||||---||||||||||---------|||||||||-||||---------------------|||||||||----------||||--------%%%%%%%%%%%%---||||||||||-||||------|||---- ---
XXXXXXX||||------|||XXXXXXXXXXXXX|||||||||||XXXXXXXXXXXXXXXXXXXXXXXX||||||||||XXXXXXXXXXXXXXXXXXXXXXXXXXXXXXXXXXXXXXXXXXXXXXXXXXXXXXXXXXXXXXX||||XXXXXXXX||||||||||||XXXXXXXXXXXXXX||||------|||XXXXXXXX