--------------------------------------------------------------------------------------------------------------------------------------------------------------------------------------------------------
------------------------------------------------------------------------------------------------------------------------------------------------ ------------------------------ ------------------------
--------------------------------------------------------------------------------------------------------------------------------------------------------------------------------------------------------
--------- ------------------------------------------------------------------------------------------------------------------------------------------------------------------------ ---------------------
--------------------------------------------------------------------------------------------------------------------------------------------------------------------------------------------------------
---------------------------------------------------------------------------------------- ---------------------------------------------------------------------------------------------------------------
--------------------------------------------------------------------------------------------------------------------------------------------------------------------------------------------------------
------------------------------------------------------------------------------------------------------------------------- ------------------------------------------- ----------------------------------
--------------------------   ------------------------------gg------------------------------- --------------------------------------------------------------------------gg-----g------------- - ---------
---------------------------- -----------------------------------------------------------------------------------------------------------------------------------------------------------%%    %---------
---------------------------------- --ggkgggkgkg---------------------------------------- --------------------------------------------------------gggkgggkggg----------- %       % %------|||||||---------
-----------------------------------r--||||||||----------------------------------------------- --------------------------     %----------------r--|||||||||--------- --||||||||||||----   %          % F 
-------------------------%  %% % %  --||||||||- %    %%   -----------------  % %-------- ------g------------------------|  %%%--- %        % % --|||||||||-  %%% %%  %||||||||||||----|||||||||||||||%||
-------------------------|||||||||||--||||||||-|||||||||||---    %%% ------|||||--g-------------------------------------||||||---||||||||||||||--|||||||||-|||||||||||||||||||||||----|||||||||||| |||||
------     --------------|||||||||||% % %   %  |||||||||||---||||||||------|||||----------------------------------------||||||---|||||||||||||| %       %% |||||||||||||||||| ||||----||||||||||||||||||
  X  X|||||              |||||||||||||||||||||||||||||||||---||||||||----        ----    X   ----X  X X   X      X               |||||||||||||||||||||||||||||||||||||||||||||||||----||||||||||||||||||