--------------------------------------------------------------------------------------------------------------------------------------------------------------------------------------------------------
--------------------------------------------------------------------------------------------------------------------------------------------------------------------------------------------------------
--------------------------------------------------------------------------------------------------------------------------------------------------------------------------------------------------------
--------------------------------------------------------------------------------------------------------------------------------------------------------------------------------------------------------
--------------------------------------------------------------------------------------------------------------------------------------------------------------------------------------------------------
--------------------------------------------------------------------------------------------------------------------------------------------------------------------------------------------------------
--------------------------------------------------------------------------------------------------------------------------------------------------------------------------------------------------------
-----------------------------------------------------------------------------------------------------------------------------------------------------------------------------------------------Tt-------
-----------------------------Tt----------------------------------------------------------------------------------------------------------------------------------------------------------------tt-------
-----------------------------tt--------------------------------------Tt--------------------------------------------------------------------------------------Tt--------------------------------tt-------
-----------------------------tt--------------------------------------tt--------------------------------------------------------------------------------------tt--------------------------------t--------
-----------------------------tt---K----------------------------------tt------------2C---------------------------------------------F----------%%%%%%%%%%------tt--K-------------------------%%%%%--%%%%%%
--------------------------%%%%%%%%%-------------------C2%%%-SCUCUSU--tt-------------------%%%%%---%%%%%---------G------------G----%-----%%%%%%%%%%|||||---%%%%%%%%-------------------------|||%%-%%%%F%%
------------K-------------|||||||||-----%%%%%-----------|||------%%%%%%%%%%%--------------|||||---|||||--%%%---%%%2---------%%%---|%%%%%|||||||||||||||---||||||||-------------------------|||||-|||| ||
---------%%%%------%%%----|||||||||-----|||||-----------|||------|||||||||||--------------|||||---|||||--|||---|||----------|||---|||||||||||||||||||||---||||||||-------------------------|%%%%%%%%%%||
XXXXXXXXX||||------|||XXXXXXXXXXXXXXXXXXXXXXXXXXXXXXXXXXXXXXXXXXXXXXXXXXXXXXXXXXXXXXXXXXXX|||||---|||||XX|||---|||XXXXXXXXXX|||---||||||||||||||||XXXXXXXX||||||||XXXXXXXXXXXXXXXXXXXXXXXXXX||||||||||XX