---------------------- ---------------------------------------------------------------------------- ------------------------------------------------------------ ---------------------------------------
--------------------------------------------------------------- -------------------------------------------- --------------------------------------- ---------------------------------------------------
--------------------------------------------------------------------------------------------------------------------------------------------------------------------------------------------------------
---------------------------------------- ------------------- ----------------------------        -------------------------------------------------------------------------------------------------------
 --------------------------------- -- ------------------------------------------------------------------------------------------------------------------------------------------------------------------
--------------------------------------------------------------------------------------------- -------------------------- -------------------------------------------------------------------------------
------------------------------------------------------------------------------------------------------- ------------------------------------------------------------------------------------------------
-------- ------------------------ --------------- ------------------------ -----------------------------------------------------------------------------------------------------------------------------
----------------------------Tt--------------------- ----------------------------------------------------------------------------------------------------------------------------------------------------
----------------------------tt-------------------------------------------------------------Tt-------------- -----------Tt-------------------------------------------------------------------------------
-- -------------------------tt--------------------------------------------Tt---------------tt---------------------- ---tt-------------------------------------------------------------------------------
-------------Tt-K-----------tt----------SCCUCU----------------------------ttTt----------- -tt--------------------------tt---------F---------------------------------------------------------------------
----------- %tt%%%%%%%---%%%%%%%%%----------------------------------------tttt-------------t-  ------------- ------%%%%%%%%%------%-------------------------------------------------------G-------------
------------|tt|||||||---|||||||||------------------K------------------%%%%%tt%%%------%%%%%%%%%%------------------|||||||||------|------------%%%%-----%%%--------------------%%%%%%%%%%%%- %%%%%%%%---
----------%%%%%%%%%|||---|||||||||----------------%%%--%%%%%-----------|%%%%%%%%%------||||||||||------------------|| ||||||------|------------||||-----|||--------------------||||||||||||--||||||||---
  XXXXX XX|||||||||XXXX  XXX X XX  XXXXXXXXX  XX  |||--|||||XXXXXX XXXXX|||||||||X XXXX XX X  X   X X XX XX XXX  X ||||||||| XX XXXX X XX XX X ||||-----|||X XXXX XXXXXXXXX  X XX  X XX  X XX||||||||XXX