|||||||||||||||||||||||||||||||||||||||||||||||||||Tt||||||||||Tt|||||||||||||Tt|||||||||||||||||||||||||||||||||||||||||||||||||||||||||||||||Tt|||||||||||||||||||||||||||||||||||||||||||||||||||||||
|||||||||||||||||||||||||||||||||||||||||||||||||||tt||||||||||tt|||||||||||||tt|||||||||||||||||||||||||||||||||||||||||||||||||||||||||||||||tt|||||||||||||||||||||||||||||||||||||||||||||||||||||||
|||||||||||||||||||||||||||||||||||||||||||||||||||tt||||||||||tt||||K||||||||tt||||||||||||||||||||||||||||K||||||||||||||||||||||||||||||||||tt|||||||||||||||||||||||||||||||||||||||||||||||||||||||
||||||||||||||||||||||||||||||||||||||||||||||||%%%%%%%%%%|||||t||||K%%%%|||||tt||||||||||||||||||||||||||||C2C2UUS|||||||||||||||F||||||||||||tt|||||||||||||||||||||||||||||||||||||||||||||||||||||||
|||||||||||||||||||||||||||||||||||%%%%%||%%%%%|||||||||||%%%%%%%%%%%%|||%%%%%%%%%%%%|||||||||||||||||||||||||||||||||||||||||||||%||||||||%%%%%%%%%%|||||||||||||||||||||||||||||||||||||||||||||||||||
||||||||||||||||||||||||||||||||2C2||||||||||||||||||||||||||||||||||||||||||||||||||C22SSSCC|||||||||||||||||||||||||||||||%%%%||||||%%%|||||||||||||||||||||||||||||||||||||K||||||%%%%%%%%%|||||||||||
||||||||||%%%%||||||%%%%%||||||||||||||||||||||||||||||||||||||||||||||||||||||||||||||||||||||||||||||||||||||||||||||||||||||||||||||||||||||||||||||||||%%%%%%%%%%%%||||||%%%%|||||||||||||||||||||||
XXXXXXXXXX|||||||||||||||XXXXXXXXXX||||||||||||XXXXXXXXXXXXXXXXXXXXXXXXXX||||||||||||XXXXXXXXXXXXXXXXXXXXXXXXXXXXXXXXXXXXXXX|||||||||||||XXXXXXXXXXXXXXXXXX||||||||||||XXXXXX||||XXXX|||||||||XXXXXXXXXX
