--------------------------------------------------------------------------------------------------------------------------------------------------------------------------------------------------------
--------------------------------------------------------------------------------------------------------------------------------------------------------------------------------------------------------
--------------------------------------------------------------------------------------------------------------------------------------------------------------------------------------------------------
--------------------------------------------------------------------------------------------------------------------------------------------------------------------------------------------------------
--------------------------------------------------------------------------------------------------------------------------------------------------------------------------------------------------------
--------------------------------------------------------------------------------------------------------------------------------------------------------------------------------------------------------
--------------------------------------------------------------------------------------------------------------------------------------------------------------------------------------------------------
--------------------------------------------------------------------------------------------------------------------------------------------------------------------------------------------------------
--------------------------------------------------------------------------------------------------------------------------------------------------------------------------------------------------------
--------------------------------------------------------------------------------------------------------------------------------------------------------------------------------------------------------
--------------------------------------------------------------------------------------------------------------------------------------------------------------------------------------------------------
----------------------------------------------------------------------------------------------------G----------------------------- -----------K------------------------------------UCS------------------
--------------------------------------G%%%%%%%%---------------------------------------------%%%%--%%%%----------------------------%---%%%%%%%%%%----------------------%%%------%%%%----------------   %%
--------%%%%---%%%%%-%%%%%%%%%----%%%%%||||||||----------------------------G----------------||||--||||--------CU2U2U2CC-----------|---||||||||||--K-------------U2C---|||------||||-%%%%%%%%%%%%-- |||||
--------||||---|||||-|||||||||----|||||||||||||-------%%%%%%%%%%----------%%%%%--%%%--------||||--||||----------------------------|---||||||||||%%%%%-----%%%%--------|||------||||-||||||||||||---|||||
XXXXXXXX||||---|||||X|||||||||XXXX|||||XXXXXXXXXXXXXXX||||||||||XXXXXXXXXX|||||--|||XXXXXXXX||||--||||XXXXXXXXXXXXXXXXXXXXXXXXXXXXXXXXXXXXXXXXXX|||||-----||||XXXXXXXX|||------||||XXXXXXXXXXXXXXX |||||