--------------------------------------------------------------------------------------------------------------------------------------------------------------------------------------------------------
--------------------------------------------------------------------------------------------------------------------------------------------------------------------------------------------------------
--------------------------------------------------------------------------------------------------------------------------------------------------------------------------------------------------------
--------------------------------------------------------------------------------------------------------------------------------------------------------------------------------------------------------
--------------------------------------------------------------------------------------------------------------------------------------------------------------------------------------------------------
--------------------------------------------------------------------------------------------------------------------------------------------------------------------------------------------------------
--------------------------------------------------------------------------------------------------------------------------------------------------------------------------------------------------------
--------------------------------------------------------------------------------------------------------------------------------------------------------------------------------------------------------
--------------------------------------------------------------------------------------------------------------------------------------------------------------------------------------------------------
------------------------------------------------------------------Tt------------------------------------------------------------------------------------------------------------------------------------
---------------K-----------------------------------------K--------tt------------------------------------------Tt---------------------------------------------------------K------------------------------
------%%%%%%%%%%%--------------------------------%%-%%%%%%%-------tt-------------------------GK---------------tt------------------F------------------------------%%%%%%%%%%%%-----C2--------------------
------|||||||||||--------------------------------||-|||||||-------tt---G--------------%%%%%--%%%%-------------tt-----------%%%----%-%%%%%%%%%--------------------||||||||||||---------------------2U2S--
------|||||||||||--------------------------------K|-|||||||---%%%%%%%%%%--------------|||||--||||----------%%%%%%%%%-------|K|----|-|||||||||--------------------||||||||||||-------------%%%%%%--------
------|||||||||||-------------------------------%%%%%%%%%%|---||||||||||--------------|||||--||||----------|||||||||-%%%%%%%%%----|-|||||||||--------------------||||||||||||-------------||||||------%%
 XXX XX XX XXXX X XXX XX   X XX X XXXXXXX XXXXXX|||||||||| XXXXXXXXXXX X XXXXX X X X X|||||--|||| X XXXXXXXXXXXXXXXX ||||||||| X  XX|||||||||XXXXXXXXXXXXXXXXXXXX XX X XXXXXXXXX  XX XXXXX||||||XXX X ||