----- --------------------------------- ----------------------------------------------------------------------------------------------------------------------------------------------------------------
---------------------------------------  ------------------------------------------------------------------------------------------------------------------------------------------------ --------------
--------------------------------------- ----------------------------------------------------------------------------------------------------------------------- ----------------------------------------
--------------------------------------- ---------------------------------------------------------------------------------------------------- --------------------------------------- -------------- ----
--------------------------------------- ------- -------------------------------------------------------- -----------------------------------------------------------------------------------------------
--------------------------------------- --------------------------------------------- ------------------------------------------------------------------------------------------------------------------
----------------------------------------------------------------------------------------------------------------------------------------------------------- --------------------------------------------
---------------------------------------------------------------------------------------------------------------------------------------------------------------------------------------------------- ---
------------------------------------------------------------------------------------------ -------------------------------------------------------------------------------------------------------------
---------------- ---------------------------------------------------------------------------------------------------------------------------------------------------------------------------------------
---------------G-------------------------------------Tt----------G--------------------------------------------------------------------------------------------------------------------------------------
----------SCU2SU-------K-K---------------------------tt-------%%%%---------C2U2CS-------G-----------------------------------------F------------ -------------------------------------%%%%%%%%%%---------
----------------------%%%%------------UCC2UGC--------tt-------||||---------------%%%%--%%%%-----------------------%%%%%%%%%%------%-------------------------S--------------%%%%%%----||||||||||--K -----
-------%%%%%%%%%%%----||||-------%%%%%%%%%%%2UUUU-K--t--------||||----%%%%-------||||--||||-----------------------||||||||||------|----------------------------------------||||||----||||||||||%%%%----%
-------||||||||||| ---||||------- ||||||||||-----%%%%%%%%%%-- ||||----||||-------||||--||||-----------------------||||||||||------|----------%%%%%-----%%%%%-%%%%%-----%%%%||||||----||||||||||||||----|
 XXXXXXXXXXXXXXXXXXXXX||||XXXXXXXXXXXXXXXXXXXXXXX||||||||||XXXXXXXXXXX||||XXXXXXX||||--||||XXXXXXXXXXXXXXXXXXXXXXXXXXXXXXXXXXXXXXXXXXXXXXXXXX|||||-----|||||X| |||-----||||||||||XXXXXXXXXXXXXX||||----|