--------------------------------------------------------------------------------------------------------------------------------------------------------------------------------------------------------
--------------------------------------------------------------------------------------------------------------------------------------------------------------------------------------------------------
--------------------------------------------------------------------------------------------------------------------------------------------------------------------------------------------------------
--------------------------------------------------------------------------------------------------------------------------------------------------------------------------------------------------------
--------------------------------------------------------------------------------------------------------------------------------------------------------------------------------------------------------
--------------------------------------------------------------------------------------------------------------------------------------------------------------------------------------------------------
--------------------------------------------------------------------------------------------------------------------------------------------------------------------------------------------------------
--------------------------------------------------------------------------------------------------------------------------------------------------------------------------------------------------------
--------------------------------------------------------------------------------------------------------------------------------------------------------------------------------------------------  ----
--------------------------------------------------------------------------------------------------------------------------------------------------------------------------------------------------  ----
-------------------------------------------------------------------------K--G---------------------------------------------------------------------------------------------------------------------  ----
-------------------------------------------------------------------------%%%%----------------------------------------------------- ---G-GG-%%%%%%----------------G--K---GG------------------------  ----
-------------------------------------------------------------------------||||--------------------------%%%%%%%%%%-----------------%-US2SSU-||||||-------------CC2S%%%%%%%%---------S2C2------%%%%%    %%
----------------G--------------------------------------------------------||||--------------------------||||||||||------%%%-----%%%%%-------||||||-----------------||||||||---%%%%%%%%%-------|||||||||||
--------------%%%--%%%%----------------------------%%%%%%%%%-------------||||--------------------------||||||||||------|||-----|||||-------||||||-----------------||||||||---|||||||||-------|||||||||||
XXXXXXXXXXXXXX|||--||||XXXXXXXXXXXXXXXXXXXXXXXXXXXX|||||||||XXXXXXXXXXXXXXXXXXXXXXXXXXXXXXXXXXXXXXXXXXX||||||||||XXXXXX|||-----|||||XXXXXXXXXXXXXXXXXXXXXXXXXXXXXX||||||||XXXXXXXXXXXXXXXXXXXXXXXX    XX