--------------------------------------------------------------------------------------------------------------------------------------------------------------------------------------------------------
--------------------------------------------------------------------------------------------------------------------------------------------------------------------------------------------------------
--------------------------------------------------------------------------------------------------------------------------------------------------------------------------------------------------------
--------------------------------------------------------------------------------------------------------------------------------------------------------------------------------------------------------
--------------------------------------------------------------------------------------------------------------------------------------------------------------------------------------------------------
--------------------------------------------------------------------------------------------------------------------------------------------------------------------------------------------------------
--------------------------------------------------------------------------------------------------------------------------------------------------------------------------------------------------------
-------------------------------------------------------------------------------------------------------------------------ggggggggg------------------------------------------------SSS22C2S--------------
-----------------------------------------------------------------------------------------------------------------------g--|||||||------------g-------g--g-----------------------------------------------
--------------------------------------------------------------------------------------------------%%%%%%---%%%%%%%%%%%%%--|||||||-%%%%%%%%%%-----------------g------g-----------g--g-----g--------------
--------------------------------------------------------------------------------------------------||||||---|||||||||||||--|||||||-||||||||||%%%%%%%%%%-----------------%%%%%%%%-------------------------
---------------------------------g---------------------------------gggkgkkgkgkk-------------------||||||---|||||||||||||%%%%%%%%%%||||||||||||||||||||----%%%%%%%%%%%%%||||||||%%%%%%%%%%%%%%-----------
-------------------------------------------g----g-------------------%%%%%%%%%%--------------------||||||---|||||||||||||||||||||||||||||||||||||||||||----|||||||||||||||||||||||||||||||||||-----------
-------------------------------%%%%%%%---------------------------r--||||||||||-%%%%%%%%%%%%%----%%%%%%%%%%%|||||||||||||||||||||||||||||||||||||||||||----|||||||||||||||||||||||||||||||||||%%%%%    %%
------%%%%%--------------------|||||||-----------------%%%%%%%%%%%--||||||||||-|||||||||||||----||||||||||||||||||||||||||||||||||||||||||||||||||||||----||||||||||||||||||||||||||||||||||||||||||| ||
XXXXXX|||||XXXXXXXXXXXXXX----XXXXXXXXXXXXX---XXXXXXXXXX|||||||||||XXXXXXXXXXXXX|||||||||||||----||||||||||||||||||||||||||||||||||||||||||||||||||||||----||||||||||||||||||||||||||||||||||||||||||||||