--------------------------------------------------------------------------------------------------------------------------------------------------------------------------------------------------------
--------------------------------------------------------------------------------------------------------------------------------------------------------------------------------------------------------
--------------------------------------------------------------------------------------------------------------------------------------------------------------------------------------------------------
--------------------------------------------------------------------------------------------------------------------------------------------------------------------------------------------------------
--------------------------------------------------------------------------------------------------------------------------------------------------------------------------------------------------------
--------------------------------------------------------------------------------------------------------------------------------------------------------------------------------------------------------
--------------------------------------------------------------------------------------------------------------------------------------------------------------------------------------------------------
--------------------------------------------------------------------------------------------------------------------------------------------------------------------------------------------------------
--------------------------------------------------------------------------------------------------------------------------------------------------------------------------------------------------------
--------------------------------------------------------------------------------------------------------------------------------------------------------------------------------------------------------
----------------------------------------------------------------------------------K--------------------------------------------------------------------Tt-----------------------------------------------
--------------------------------------------------------------------------------%%%%%%%%%%-------------------------------------K--F--------------------tt--%%%%- %%%-%%%%-------------------------------
----------------------------------------%%%%%-----%%%---------------------------||||||||%%%%%  %%%-------G-------------------2 C--%--------------------tt--|%%%%%%%%%%|||------G------------------------
-----------------------------% %%%------|||||-----|||---------------------------||||||||||||||||||------%%%% %%%%-----------------%%%%---%%%%----------tt-K|||||||||||SS% %%%%%%%%-------------UUUCU---%
--------- %% ------%%%%%-----|||||------|||||-----|||---------------------------||||||||||||||||||------|||||||||% %----%%%%%-----||||---||||-------%% %%%%%%%||||||||||||||||||||---------------------|
  X XXXXX||||------|||||X XXX||||| X XXX|||||-----|||XXXXXXXXXXXXXXX X  XXXXXXXXXXX XXXX||||||||||XXXXXX||||||||||||----|||||XXXXX||||---|||| XX XXX||||||||||XXX XXXXXX||||||||||XXXXXX X XXXXX  XXXXX|