--------------------------------------------------------------------------------------------------------------------------------------------------------------------------------------------------------
--------------------------------------------------------------------------------------------------------------------------------------------------------------------------------------------------------
--------------------------------------------------------------------------------------------------------------------------------------------------------------------------------------------------------
--------------------------------------------------------------------------------------------------------------------------------------------------------------------------------------------------------
--------------------------------------------------------------------------------------------------------------------------------------------------------------------------------------------------------
--------------------------------------------------------------------------------------------------------------------------------------------------------------------------------------------------------
--------------------------------------------------------------------------------------------------------------------------------------------------------------------------------------------------------
-------------------------------------------------------------------------------------------------------------------------------------------------------------------------------------Tt-----------------
-------------------------------------------------------------------------------------------------------------------------------------------------------------------------------------tt-----------------
--------------Tt---------Tt-------------------------------------------------------Tt-------------------------------------------------------------------------------------------------tt-----------------
--------------tt---------tt-------------------------------------------------------tt-------------------------------------------------------------------------------------------------tt-----------------
--------------tt---------tt-------------------------------------------------------tt-------G-------------------------------------- --------------------------G-------------------%%%%%%%%%---------K----
--------------tt---------tt-------------------------------K--------------------%%%%%%%%--%%%---%%%%%%%%%%%---------2U-------------%------------------------%%%-------K-----------|||||||||-----%%%  ----
-----------%%%%%%%%--%%%%%%%%%%%----------------------2CUUS--------------------||||||||--|||---|||||||||||------------------------|------------------------|||-----%%%%----------|||||||%%-----|||||----
-----------||||||||--|||||||||||-------------%%%%%%%%%-------------------------||||||||--|||---|||||||||||------------------------|--%%%---%%%-------------|||-----||||----------|||||||||-----|||||----
XXXXXXXXXXX||||||||XX|||||||||||XXXXXXXXXXXXX|||||||||XXXXXXXXXXXXXXXXXXXXXXXXXXXXXXXXXXX|||XXX|||||||||||XXXXXXXXXXXXXXXXXXXXXXXXXXX|||---|||XXXXXXXXXXXXXXXXXXXXX||||XXXXXXXXXXXXXXXXXXXXXXXX|||||----