--------------------------------------------------------------------------------------------------------------------------------------------------------------------------------------------------------
--------------------------------------------------------------------------------------------------------------------------------------------------------------------------------------------------------
--------------------------------------------------------------------------------------------------------------------------------------------------------------------------------------------------------
--------------------------------------------------------------------------------------------------------------------------------------------------------------------------------------------------------
--------------------------------------------------------------------------------------------------------------------------------------------------------------------------------------------------------
--------------------------------------------------------------------------------------------------------------------------------------------------------------------------------------------------------
--------------------------------------------------------------------------------------------------------------------------------------------------------------------------------------------------------
--------------------------------------------------------------------------------------------------------------------------------------------------------------------------------------------------------
----------------------------------------------------------------------Tt--------------------------------------------------------------------------------------------------------------------------------
----------------------------------------------------------------------tt--------------------------------------------------------------------------------------------------------------------------------
----------------------------------------------------------------------tt------------------------------------------G-------------------------------------------------------------------------------Tt----
------------------------%% %%%%%%-%%%%%%------------------------------t---KG----------------------------------USUC ---------------F-------K------------------------------------------UU2S2--------tt%%%%
----------------------G-|||||||||-||||||--------------------------%%%%%%%%%% --%%%%%%%%%%%---------------------------------------%%%--%%%%%------------K------------------------------------------tt|||K
------------%%%------%%%|||||||||-||||||-------% %%-----%%%%------|||||||||||--|||||||||||------%%%%-----%%%%--------------------|||--|||||-------%%%--%% %-----------------------------------%%%%%%%%%%
------------|||------||||||||||||-||||||-------||||-----||||------|||||||||||--|||||||||||------||||-----||||--------------------|||--|||||-------|||--||||-----------------------------------||||||||||
 XXXXXXXXXXX|||------||| XX XXXXXXXXX XXXXXXXXX||||-----||||XXXXXXXXX XXXXXXXXX|||||||||||XXXXXX||||-----|||| XXXXXXXXXXX XXXX XX|||--|||||XXX XXX|||--||||XXXXXX XX XXXXXXXXXXXXXXXXXXXXXXXXX||||||||||