--------------------------------------------------------------------------------------------------------------------------------------------------------------------------------------------------------
--------------------------------------------------------------------------------------------------------------------------------------------------------------------------------------------------------
--------------------------------------------------------------------------------------------------------------------------------------------------------------------------------------------------------
--------------------------------------------------------------------------------------------------------------------------------------------------------------------------------------------------------
--------------------------------------------------------------------------------------------------------------------------------------------------------------------------------------------------------
--------------------------------------------------------------------------------------------------------------------------------------------------------------------------------------------------------
--------------------------------------------------------------------------------------------------------------------------------------------------------------------------------------------------------
--------------------------------------------------------------------------------------------------------------------------------------------------------------------------------------------------------
----------------------------------------------------------Tt------------------------------------------------------------------------------Tt------------------------------------------------------------
--------------------------Tt------------------------------tt------------------------------------------------------------------------------tt------------------------------------------------------------
--------------------------tt------------------------------tt------------------------------------------------------------------------------tt-----------------GG-GK--------------------------------------
--------------------------tt---------------------------%%%%%%%%---K----------K----------------------------------------------------F----%%%%%%%%-------------%%%%%%--------------------------------------
--------%%%------------%%%%%%%%%%-----%%%%%------------||||||||-%%%%%-----%%%%%------------%%%%%------%%%-------------------------%----||||||||-------------||||||---------------------K----US----------
--------|||------------||||||||||%%%%-|||||------------||||||||-|||||-----|||||-------UUUUU|||||------|||-------------------------|----||||||||-------------||||||---CUUUCSU--%%%%%%%%%%---------F--%%%-
--------|||------------||||||||||||||-|||||------------||||||||-|||||-----|||||------------|||||------|||-------------------------|----||||||||-------------||||||------------||||||||||--------- --|||-
XXXXXXXXXXXXXXXXXXXXXXX||||||||||XXXXX|||||XXXXXXXXXXXXXXXXXXXXX|||||-----|||||XXXXXXXXXXXX|||||------|||XXXXXXXXXXXXXXXXXXXXXXXXXXXXXXXXXXXXXXXXXXXXXXXXXXXXXXXXXXXXXXXXXXXXXXXXXXXXXXXXXXXXXXXXXXXXXXX