--------------------------------------------------------------------------------------------------------------------------------------------------------------------------------------------------------
--------------------------------------------------------------------------------------------------------------------------------------------------------------------------------------------------------
--------------------------------------------------------------------------------------------------------------------------------------------------------------------------------------------------------
--------------------------------------------------------------------------------------------------------------------------------------------------------------------------------------------------------
-----------------------------------S2U-----------------k------------------------------------------------------------------------------------------------------------------------------------------------
-------------------------------------------------------%%%%%%%------------------------------------------------------------------------------------------------------------------------------------------
-------------------------------------------------------|||||||------------------------------------------------------------------------------------------------------------------------------------------
-------------------------------------------------------|||||||------------------------%%%%%%------------------------------------------------------------------------------------------------------------
-----------------------------------%%%%%%--------------|||||||------------------------||||||------------------------------------------------------------------------------------------------------------
-----------------------------------||||||------CSS-----|||||||---%%%%-------#---#-----||||||------------------------------------------------------------------------------------------------------------
-----------------------------------|ky|||--------------|||||||---||||------##---##----||||k|-------tt---Tt----------------------------------------------------------------------------------------------
---------------------------#--#----|%%%%|--------------|||||||---||||-----###---###---||||%%%%-----tt---tt----------------------------------------------------------------------------------------------
--------------------------##--##---||||||--------------|r|y||r--yk|||---%%%%%---%%%%%-||||||||-----tt---tt----------------%%%%%--%%%%%%%%--%%%%%%%%%%% %%%%%%%%%%%%%%%%%%%%%%%%%%%%%%%%%%%%%%%%%%%    %%
------------------------%%%%--%%%%-||||||----%%%%%%%%%%%%%%%%%%%%%%%%%%%|||||---|||||-||||||||y---%%%%%%%%%%%%%%%--%%%%---|||||--||||||||--|||||||||||%|||||||||||||||||||||||||||||||||||||||||||||||||
----------%%%---%%%%%%%%||||--||||-||||||----||||||||||||||||||||||||||||||||---|||||%%%%%%%%%%%%%|||||||||||||||--||||%%%|||||--||||||||--|||||||||||||||||||||||||||||||||||||||||||||||||||||||||||||
XXXXXXXXXX|||---||||||||||||--||||XXXXXXXXXXX||||||||||||||||||||||||||||||||---|||||||||||||||||||||||||||||||||--||||||||||||--||||||||--|||||||||||||||||||||||||||||||||||||||||||||||||||||||||||||