--------------------------------------------------------------------------------------------------------------------------------------------------------------------------------------------------------
--------------------------------------------------------------------------------------------------------------------------------------------------------------------------------------------------------
--------------------------------------------------------------------------------------------------------------------------------------------------------------------------------------------------------
--------------------------------------------------------------------------------------------------------------------------------------------------------------------------------------------------------
--------------------------------------------------------------------------------------------------------------------------------------------------------------------------------------------------------
--------------------------------------------------------------------------------------------------------------------------------------------------------------------------------------------------------
--------------------------------------------------------------------------------------------------------------------------------------------------------------------------------------------------------
--------------------------------------------------------------------------------------------------------------------------------------------------------------------------------------------------------
--------------------------------------------------------------------------------------------------------------------------------------------------------------------------------------------------------
------------------------------------------------------------------Tt------------------------------------------------------------------------------------------------------------------------------------
------------------------------------------------------------------tt------------------------------------------------------------------Tt----------------------------------------------------------------
---------------G------------------------------------------------G-tt--------------------------------------------------------------F---tt----------------------------------------------------------------
------%%%%%%%%%%--------------%%%%-----%%%%%------------------%%%%%%%%%%%-----------K--G--------------------%%%%%-----------G--K--%-G-tt--------------%%%%----%%%%--%%%%%-----CUUU------------K---------
------||||||||||--------------||||-----|||||-----------%%%%%%%|||||||||||----------%%%%%%%%%%--%%%%%%%%-----|||||---%%%%%---%%%%--|%%%tt--------------||||----||||--|||||-----------%%%------%%%-----F--
------||||||||||--------------||||-----|||||-----------||||||||||||||||||----------||||||||||--||||||||-----|||||---|||||---||||--|%%%%%%%%%%---------||||----||||--|||||-----------|||------|||----- --
XXXXXXXXXXXXXXXXXXXXXXXXXXXXXX||||-----|||||XXXXXXXXXXXXXXXXXX|||||||||||XXXXXXXXXX||||||||||XX||||||||XXXXXXXXXXXXX|||||---||||XXX||||||||||XXXXXXXXX||||----||||XX|||||XXXXXXXXXXX|||------|||XXXXXXXX