--------------------------------------------------------------------------------------------------------------------------------------------------------------------------------------------------------
--------------------------------------------------------------------------------------------------------------------------------------------------------------------------------------------------------
--------------------------------------------------------------------------------------------------------------------------------------------------------------------------------------------------------
--------------------------------------------------------------------------------------------------------------------------------------------------------------------------------------------------------
--------------------------------------------------------------------------------------------------------------------------------------------------------------------------------------------------------
-----------------------------------------------------------------------------------------------------------------------------------------------gggggrr--------------------------------------------------
--------------------------------------------------------------------------------------------------------------------------%%%%%%-------------r--|||||---------------------------------------------------
--------------------------------------------------------------------------------------------------------------------------||||||---%%%%%%%%%%%--|||||-%%%%%%%%%%%---------------------------------------
--------------------------------------------------------------------------------------------------------g----%%%%%%%-----%%%%%%|---|||||||||||--|||||-|||||||||||-r-----r----SUSCSSSS-------------------
------------------------------------------------------------------------------------2SSUCC-%%%%%%%%%%%%------|||||||-----|||||||---|||||||||||%%%%%%%%|||||||||||---------------------------------------
-------------------------------------------------------------------------------------------||||||||||||------|||||||----%%%%%%%%%%%||||||||||||||||||||||||||||||%%%%%%%%%%-----------------------------
---------------------------------------------------------------g-g------------SSUCS--------||||||||||||------|||||||----|||||||||||||||||||||||||||||||||||||||||||||||||||-----------------------------
-------------------------------------------------------------------------------------------||||||||||||----%%%%%%%%%%%%%|||||||||||||||||||||||||||||||||||||||||||||||||||%%%%%%%%%%%%-----------------
--------------------------g---------g-------------------------%%%%%%%%%%-------------------||||||||||||----||||||||||||||||||||||||||||||||||||||||||||||||||||||||||||||||||||||||||||-----------------
------%%%%%---------------------------------------------------||||||||||-------------------||||||||||||----||||||||||||||||||||||||||||||||||||||||||||||||||||||||||||||||||||||||||||----%%%%%%%    %%
XXXXXX|||||XXXXXXXXXXXXXX-----XXXXXXXXXXXXX-----XXXXXXXXXXXXXX||||||||||XXXXXXXXXXXXXXXXXXX||||||||||||----||||||||||||||||||||||||||||||||||||||||||||||||||||||||||||||||||||||||||||----|||||||||| ||