--------------------------------------------------------------------------------------------------------------------------------------------------------------------------------------------------------
--------------------------------------------------------------------------------------------------------------------------------------------------------------------------------------------------------
--------------------------------------------------------------------------------------------------------------------------------------------------------------------------------------------------------
--------------------------------------------------------------------------------------------------------------------------------------------------------------------------------------------------------
--------------------------------------------------------------------------------------------------------------------------------------------------------------------------------------------------------
--------------------------------------------------------------------------------------------------------------------------------------------------------------------------------------------------------
-----------------------------------------------------------------------------------------------------------------------------------------------------2UCSS2SS-------------------------------------------
---------------------------------------------------------------------------------------------------------------U----------------------------------------------------------------------------------------
--------------------------------------------------------------------------------------------------------------------------------------------------------------------------------------------------------
---------------------------------------------------------------------------------------------------------------------%%%%%%-----------------------------------------------------------------------------
-------------------------------------------------------------------------------------------------------------------ggggkkggrk---------%%%%%%%%%%%%%%%%%%%%%%%%%----------r------------------------------
--------------------------g--------------------------------------------------%%%%%--------------%%%%------%%%%%%%%%--||||||-----------|||||||||||||||||||||||||-r-k-------------------------------------
------------------------------%%%%%%-----------------------------------------|||||--------------||||------|||||||||--||||||--%%%%%%%%%|||||||||||||||||||||||||-------------------------%%%%%%%%%%    %%
-----------------------------%%%%|||----g--g---gt-----g----------------------|%%%|----------gg--g%%%%%%---|||||||||--||||||--||||||||||||||||||||||||||||||||||%%%%%%%%%%------%%%%%%---||||||||||||| ||
------%%%%%------------------|||||||-----------tt----------------------------|||||-%%%%%%%%-----|||||||---|||||||||%%%%%%%%%%||||||||||||||||||||||||||||||||||||||||||||------||||||---||||||||||||||||
XXXXXX|||||XXXXXXXXXXXXXX---XXXXXXXXXXX---XXXXXXXXXXX-----XXXXXXXXXXXXXX---XXXXXXXX||||||||----XXXXXXXXXXX|||||||||||||||||||||||||||||||||||||||||||||||||||||||||||||||----XXXXXXXXXXX||||||||||||||||