--------------------------------------------------------------------------------------------------------------------------------------------------------------------------------------------------------
--------------------------------------------------------------------------------------------------------------------------------------------------------------------------------------------------------
--------------------------------------------------------------------------------------------------------------------------------------------------------------------------------------------------------
--------------------------------------------------------------------------------------------------------------------------------------------------------------------------------------------------------
--------------------------------------------------------------------------------------------------------------------------------------------------------------------------------------------------------
--------------------------------------------------------------------------------------------------------------------------------------------------------------------------------------------------------
--------------------------------------------------------------------------------------------------------------------------------------------------------------------------------------------------------
--------------------------------------------------------------------------------------------------------------------------------------------Tt---------------------------------------------------T -----
--------------------------------------------------------------------------------------------------------------------------------------------tt---------------------------------------------------t -----
--------------------------------------------------------------------------------------------------------------------------------------------tt-------------------------------------------------Ttt -----
-------------------------------G------------------------------------------------------------------------------------------------------------tt--------------G----------------------------------ttt -----
------------------------------%%%%%SSS------------%%%%%%%%%%---------------------G------------------------%%%%%%%%%--------------- -----%%%%%%%%%-----------%%%-------------------------------%Tt%    %%
--------%%%%%------%%%%%-----G|G|||---------------||||||||||--------------------%%%%%---------------------|||||||||---------------%-----|||||||||-----------|||-------------------------------|tt|||||||
--------|||||------|||||-----%%%%%%%--------------|||||||||%%%----%%%%%%%%%%----|||||---------------------|||||||||---------------G-----|||||||||-----------|||-----------------------------%%%%%%    %%
--------|||||------|||||-----|||||||-%%%----------||||||||||||----||||||||||----|||||----%%%-----%%%%-----|||||||||----%%%%------%%%%---|||||||||-----------|||---------------------%%%%----||||||||||||
XXXXXXXX|||||------|||||XXXXX||||XXXX|||XXXXXXXXXXXXXXXXXXXXXXXXXX||||||||||XXXXXXXXXXXXX|||-----||||XXXXXXXXXXXXXXXXXX||||------||||XXXXXXXXXXXXXXXXXXXXXXXXXXXXXXXXXXXXXXXXXXXXXXX||||XXXXXXXXXX    XX