----------------------------------------------------------------------------------------------------------------------------        --------------------------------------------------------------------
----------------------------------------------------------------------------------------------------------------------------        --------------------------------------------------------------------
----------------------------------------------------------------------------------------------------------------------------        --------------------------------------------------------------------
----------------------------------------------------------------------------------------------------------------------------        --------------------------------------------------------------------
----------------------------------------------------------------------------------------------------------------------------        --------------------------------------------------------------------
----------------------------------------------------------------------------------------------------------------------------        --------------------------------------------------------------------
----------------------------------------------------------------------------------------------------------------------------        --------------------------------------------------------------------
----------------------------------------------------------------------------------------------------------------------------        --------------------------------------------------------------------
----------------------------------------------------------------------------------------------------------------------------        ----------------------Tt--------------------------------------------
--------------------------------Tt--------------------------------------------------------------------------------------Tt--        ----------------------tt--------------------------------------------
--------------------------------tt--------------------------------------------------------------------------------------tt--        ----------------------tt--------------------------------------------
--------------------------------K%-----------------------------------------------------------------------------K------K-tt--        ---------------------Ktt----------------------------------2CUSCUU---
---------------------%%%%%%%%%%%||--------------------------G--G--------------------------------------------22USSU--%%%%%%%%        -----------------%%%%%%%%%%%%-------------%%%%%%%%%-----------------
---------------------||||||||%%%||%%%%%---------C2C--------UCUCU-------------%%%%%---%%%----------G-----------------||||||||        -----------------||||||||||||-----%%%%%%%%|||||||||-----------------
---------------------||||||||||||||||||-------------------------%%%%---%%%%--|||||---|||%%%%----%%%-----------------||||||||        ---%%%-----------||||||||||||-----|||||||||||||||||-----------------
XXXXXXXXXXXXXXXXXXXXXXXXXXXXX||||||||||XXXXXXXXXXXXXXXXXXXXXXXXX||||---||||XX|||||---|||||||----|||XXXXXXXXXXXXXXXXX||||||||        XXX|||XXXXXXXXXXXXXXXXXXXXXXXXXXXXXXXXXXXX|||||||||XXXXXXXXXXXXXXXXX