----------------------------------------------------------------------------------------------------------------------------------        --------------------------------------------------------------
----------------------------------------------------------------------------------------------------------------------------------        --------------------------------------------------------------
----------------------------------------------------------------------------------------------------------------------------------        --------------------------------------------------------------
----------------------------------------------------------------------------------------------------------------------------------        --------------------------------------------------------------
----------------------------------------------------------------------------------------------------------------------------------        --------------------------------------------------------------
----------------------------------------------------------------------------------------------------------------------------------        --------------------------------------------------------------
----------------------------------------------------------------------------------------------------------------------------------        --------------------------------------------------------------
----------------------------------------------------------------------------------------------------------------------------------        --------------------------------------------------------------
----------------------------------------------------------------------------------------------------------------------------------        --------------------------------------------------------------
---------------------------------------------Tt------------------------------------------------------------------------------Tt---        --------------------------------------------------------------
---------------------------------------------tt------------------------------------------------------------------------------tt---        --------------------------------------------------------------
---------------------------------------------tt---------------------------------G---------------------K----------------------G%---        --------------K-------------------------%%%%--------G---------
--------%%%-%%%%%%%-----------------------%%%%%%%%%----------------------%%%%%--%%%%---------------2SCU-------------------%%%||---        ---%%%%-------2U------------------------||||----%%%%%------%%%
--------|||%|||||||-----%%%%%%%%-----%%%%-|||||||||----------------------|||||--||||-------------------------------------%%%%||%%%        ---||||-------%%%%%%%%%%%---------K-----||||----|||||------|||
--------|||||||||||-----|||||%%%%----||||-|||||||||----------------------|||||--||||---%%%%%---%%%%----------------------|||||||||        ---||||-------|||||||||||%%%%%----%%%---||||----|||||------|||
XXXXXXXX|||X|||||||XXXXXXXXXX||||XXXXXXXXX|||||||||XXXXXXXXXXXXXXXXXXXXXX|||||--||||XXX|||||---||||XXXXXXXXXXXXXXXXXXXXXX|||||||||        ---||||XXXXXXXXXXXXXXXXXX|||||----|||XXXXXXXXXXX|||||------|||