--------------------------------------------------------------------------------------------------------------------------------------------------------------------------------------------------------
--------------------------------------------------------------------------------------------------------------------------------------------------------------------------------------------------------
--------------------------------------------------------------------------------------------------------------------------------------------------------------------------------------------------------
--------------------------------------------------------------------------------------------------------------------------------------------------------------------------------------------------------
--------------------------------------------------------------------------------------------------------------------------------------------------------------------------------------------------------
--------------------------------------------------------------------------------------------------------------------------------------------------------------------------------------------------------
--------------------------------------------------------------------------------------------------------------------------------------------------------------------------------------------------------
--------------------------------------------------------------------------------------------------------------------------------------------------------------------------------------------------------
-------------------Tt-----------------------------------------------------------------------------------------------------------------------------------------------------------------------------------
-------------------tt-----------------------------------------------------------------------------------------------------------------------Tt-----Tt---------------------------------------------------
----------------Tt-tt-----------------------------------------------------------------------------------------------------------------------tt-----tt---------------------------------------------------
----------------tt-tt------------------------------------------------------%%%----------------------------------------------------F---------tt---CUCCSCS-G------------------------------K---------------
--------------%%%%%%%%%%%--------------------------------------------------|||----------------------------------------------------%-%%%%%%%K%%--%%%%%G%%%%-------------------------2UUUCCC--------------
------------%%%%%%%%%||||----------------------------------%%%%%%%%%%%%%---|||----------------------------------------------------|-|||%%%%%%%%%%||%%%%%||---------------------------------------------%
------------|||||||||||||----------------------------------|||||||||||||---|||------------%%%%%---%%%%%---------------%%%%---%%%%-|-||||||||||||||||||||||---------------------------------------------|
  XXX XXXXXXXXXX X XXXXXXXXXXXXXXXXXXXXXXXX X XXX XXXXXX XXXX XXXXXXXXXX XX XX XXXXXXXXXXX|||||---|||||XXX XXX XX XXXX||||---||||XXXXXXXX XXX XX X |||||XXXXX XXX  XXXXX XXXXX XXXXXXXXXXXXXXXX XXX XXX|