--------------------------------------------------------------------------------------------------------------------------------------------------------------------------------------------------------
--------------------------------------------------------------------------------------------------------------------------------------------------------------------------------------------------------
--------------------------------------------------------------------------------------------------------------------------------------------------------------------------------------------------------
--------------------------------------------------------------------------------------------------------------------------------------------------------------------------------------------------------
--------------------------------------------------------------------------------------------------------------------------------------------------------------------------------------------------------
--------------------------------------------------------------------------------------------------------------------------------------------------------------------------------------------------------
--------------------------------------------------------------------------------------------------------------------------------------------------------------------------------------------------------
--------------------------------------------------------------------------------------------------------------------------------------------------------------------------------------------------------
-------------------------------U------------------------------------------------------------------------------------------------------------------------------------------------------------------------
---------------------------------------2S2S-----------------gg-------------------------------------------------------%%%%%%-----------------------------------------------------------------------------
---------------------------------------------------------------------------------------------------------------g---g-||||||----------------------------g----g-----g-------------------------------------
-----------------------------------ggkkggggkg---------------------------------------------ggkkggg--------------------||||||------------------------------------------SSSC2SCS------------%%%%%%%%%    %%
-------------------------%%%%%%%%%%-----------------------------%%%%%%%-----------------r--|||||---------------------||||||---------------------------%%%%%%%%%%%%%----------------------|||||||||||| ||
-------------------------||||||||||----------%%%%%%%%%%%%%%-----|||||||----%%%%%%%%%%%%%%--|||||-%%%%%%%%%%%%%-----%%%%%%%%%%-g--g-----------%%%%%%%%%|||||||||||||--------------gk------|||||||||||||||
------%%%%%--------------||||||||||----------||||||||||||||-----|||||||----||||||||||||||--|||||-|||||||||||||-----||||||||||----------------||||||||||||||||||||||----------------------|||||||||||||||
XXXXXX|||||XXXXXXXXXXXXXX||||||||||XXXXXXXXXX||||||||||||||---XXXXXXXXXXXXX||||||||||||||XXXXXXXX|||||||||||||-----||||||||||----XXXXXXXXXXXX||||||||||||||||||||||XXXXXXXXXXXXXXXXXXXXXX|||||||||||||||