--------------------------------------------------------------------------------------------------------------------------------------------------------------------------------------------------------
--------------------------------------------------------------------------------------------------------------------------------------------------------------------------------------------------------
--------------------------------------------------------------------------------------------------------------------------------------------------------------------------------------------------------
--------------------------------------------------------------------------------------------------------------------------------------------------------------------------------------------------------
------------------------------------------------------------------------------------2-------------------------------------------------------------------------------------------------------------------
--------------------------------------------------------------------------------------------------------------------------------------------------------------------------------------------------------
--------------------------------------------------------------------------------------------------------------------------------------------------------------------------------------------------------
------------------------------------------------------SC2CUCSCC-%%%%%%%%%%%%%---------------------------------------------------------------------------------------------------------------------------
----------------------------------------------------------------|||||||||||||-----%%%%%-----------------------------------------------------------------------------------------------------------------
----------------------------------------------22SUC2------------|||||||||||||-----|||||-----------------------------------------------------------------------------------------------------------------
----------------------------------------------------------------|||||||||||||-----|||||-----------------------------------------------------------------------------------------------------------------
----------------------------------------------------------------|||||||||||||---%%%%%%%%------------------------gkkgkgkggkkg---------------------------------------------SSSSS2---gg--------------------
-------------------------------%%%%-----------------------------|||||||||||||---||||||||----------------------------------------------------------------------------------------------------------------
------------------------------%%%%%%--%%%%%%%%%%%%%%------------|||||||||||||---||||||||----gg-------g--------r-------------%%%%%%%%%%%%%%-------------g--------g----------------%%%%%%%%%%%%%%%%%    %%
------%%%%%-------------------||||||--||||||||||||||%%%%%%%%%%%%|||||||||||||---||||||||--------------%%%%%%%%%-------------||||||||||||||---------------------------------------|||||||||||||||||||| ||
XXXXXX|||||XXXXXXXXXXXXXX---XXXXXXXXXX|||||||||||||||||||||||||||||||||||||||---||||||||---XXXXXXXXXXX|||||||||XXXXXXXXXXXXX||||||||||||||---XXXXXXXXXXXXXX----XXXXXXXXXXXXXXXXXX|||||||||||||||||||||||