--------------------------------------------------------------------------------------------------------------------------------------------------------------------------------------------------------
--------------------------------------------------------------------------------------------------------------------------------------------------------------------------------------------------------
--------------------------------------------------------------------------------------------------------------------------------------------------------------------------------------------------------
--------------------------------------------------------------------------------------------------------------------------------------------------------------------------------------------------------
--------------------------------------------------------------------------------------------------------------------------------------------------------------------------------------------------------
--------------------------------------------------------------------------------------------------------------------------------------------------------------------------------------------------------
--------------------------------------------------------------------------------------------------------------------------------------------------------------------------------------------------------
--------------------------------------------------------------------------------------------------------------------------------------------------------------------------------------------------------
--------------------------------------------------------------------------------Tt----------------------------------------------------------------------------------------------------------------------
--------------------------------------------------------------------------------tt----------------------------------------Tt----------------------------------------------------------------------------
--------------------------------------------------------------------------------tt----------------------------------------tt----------------------------------------------------------------------------
---------------------------------------------------%%%%%%%%----------------%%%%%%%%%%-------------------------------%%%%%%tt------ ----SC2U--------------------------G----------------------------------
------------------------G--------------------------||||||||----------------||||||||||------------------%%%-----%%%%-|||%%%%%%%%%--%--------------------G---%%%%%%%%%%%-------------------------------G--
--------------------%%%%%---%%%%%------------------||||||||----------------||||||%%%%%%%%%-------------|||-----||||-||||||||||||--|----------------%%%%%%--|||||||||||%%-%%%---%%%%%-------------%    %%
--------------------|||||---|||||---%%%%---%%%-----||||||||----------------||||||||||||||%%%%%%%%%%----|||-----||||-||||||||||||--|----------------||||||--|||||||||||||-|||---|||||-------------|||||||
XXXXXXXXXXXXXXXXXXXX|||||---|||||XXX||||---|||XXXXXXXXXXXXXXXXXXXXXXXXXXXXXXXXXXXXXXXXXXX||||||||||XXXX|||-----||||XXXXXXXXXXXXXXXXXXXXXXXXXXXXXXXXXXXXXXXX|||||||||||XXX|||---|||||XXXXXXXXXXXXXX    XX