--------------------------------------------------------------------------------------------------------------------------------------------------------------------------------------------------------
--------------------------------------------------------------------------------------------------------------------------------------------------------------------------------------------------------
--------------------------------------------------------------------------------------------------------------------------------------------------------------------------------------------------------
--------------------------------------------------------------------------------------------------------------------------------------------------------------------------------------------------------
--------------------------------------------------------------------------------------------------------------------------------------------------------------------------------------------------------
--------------------------------------------------------------------------------------------------------------------------------------------------------------------------------------------------------
--------------------------------------------------------------------------------------------------------------------------------------------------------------------------------------------------------
--------------------------------------------------------------------------------------------------------------------------------------------------------------------------------------------------------
----------------------------------------------------------Tt--------------------------------------------------------------------------------------------------------------------------------------------
----------------------------------------------------------tt--------------------------------------------------------------------------------------------------------------------------------------------
----------------------------------------------------------tt--------------------------------------------------------------------------------------------------------------------------------------------
-------------------------------------------------------%%%%%%%%%------------------------------------------------------------------F----------------------%%%%%%%%---------------------------------C2----
--------------------------------------U2U-------%%%%%%-|||||||||--%%%%%%----------------------------------------------------------%----------------------||||||||---------------------%%%%%%%%%%%%------
------------------------------K-----------------||||||-|||||||||--||||||---------%%%%%%%%%%%--------------------------------------|----------------------||||||||---------------------||||||||||||F---%%
----------------------------%%%%%%%%%-----------||||||-|||||||||--||||||---------|||||||||||--------------------------------------|-------%%%----%%%%%---||||||||---------------------|||||||||||| ---||
XXXXXXXXXXXXXXXXXXXXXXXXXXXX|||||||||XXXXXXXXXXXXXXXXXXXXXXXXXXXXXXXXXXXXXXXXXXXXXXXXXXXXXXXXXXXXXXXXXXXXXXXXXXXXXXXXXXXXXXXXXXXXXXXXXXXXX|||----|||||XXXXXXXXXXXXXXXXXXXXXXXXXXXXXXXX||||||||||||XXXXXX