--------------------------------------------------------------------------------------------------------------------------------------------------------------------------------------------------------
--------------------------------------------------------------------------------------------------------------------------------------------------------------------------------------------------------
--------------------------------------------------------------------------------------------------------------------------------------------------------------------------------------------------------
--------------------------------------------------------------------------------------------------------------------------------------------------------------------------------------------------------
--------------------------------------------------------------------------------------------------------------------------------------------------------------------------------------------------------
--------------------------------------------------------------------------------------------------------------------------------------------------------------------------------------------------------
--------------------------------------------------------------------------------------------------------------------------------------------------------------------------------------------------------
--------------------------------------------------------------------------------------------------------------------------------------------------------------------------------------------------------
--------------------------------------------------------------------------------------------------------------------------------------------------------------------------------------------------------
-------------------------------------------------------Tt--------------------------------------------------------------------Tt-------------------------------------------------------------------------
-------------------------------------------------------ttG---------------------------------------G---------------------------tt---------------------------------------------------Tt--------------------
-------------------------------------------------------tt%%%%%%%%-------------------------------K%%%%%-----------------------tt--- -----------------------------------------------tt--------------------
----------------------------------%%%%%%%%%%---------K-tt||||||||------------------------%%%%%%%%%%|||---%%%%%%%%%--K--------tt---%-----------%%%---------------------------------tt-G-------K---G--  CU
---------------------------------%%%||||||||------%%%%%%%%%%%%|||------------------------|||||||||||||---|||%%%%%|SUU----%%%%%%%%%%----%%%%---|||-----------------------------%%%%%%%%%%%-%%%%%%%% -----
---------------------------------|||||||||||------|||||||||||||||------------------------|||||||||||||---|||||||||-------||||||||||----||||---|||----%%%%--%%%%---------------|||||||||||-|||||||||-----
XXXXXXXXXXXXXXXXXXXXXXXXXXXXXXXXXXXXXXXXXXXXXXXXXX||||||||||||XXXXXXXXXXXXXXXXXXXXXXXXXXXXXXXXXXXXXXXXXXXXXXXXXXXXXXXXXXX||||||||||XXXXXXXXXXX|||XXXX||||--||||XXXXXXXXXXXXXXX|||||||||||XXXXXXXXX    XX