-------------------------------------------------------------------------------------------------------------------------------     --------------------------------------------------------------------
-------------------------------------------------------------------------------------------------------------------------------     --------------------------------------------------------------------
-------------------------------------------------------------------------------------------------------------------------------     --------------------------------------------------------------------
-------------------------------------------------------------------------------------------------------------------------------     --------------------------------------------------------------------
-------------------------------------------------------------------------------------------------------------------------------     --------------------------------------------------------------------
-------------------------------------------------------------------------------------------------------------------------------     --------------------------------------------------------------------
-------------------------------------------------------------------------------------------------------------------------------     --------------------------------------------------------------------
-------------------------------------------------------------------------------------------------------------------------------     --------------------------------------------------------------------
-------------------------------------------------------------------------------------------------------------------------------     --------------------------------------------------------------------
-------------------------------------------------------------------------------------------------------------------------------     --------------------------------------------------------------------
-------------------------------------------------------------------------------------------------------------------------------     --------------------------------------------------------------------
------------------------------------------------------------------%%%----------------------------------------------------------     -----------------SS2U---Tt-------------------------K----------------
------------------------------------------------------------------|||----------------GK-----------------------K----------------     -------%%%%--%%%%-------tt----------------%%%%%%%%%%%-------------US
------------------------------------------------------------------|||---K----------SUSC-----------------------SUSSU--CUSUSUU---     -------||||--||||-------tt----------------||K||||||||---------------
------------------------------------------------------------------|||-%%%%%----%%%%------------------------%%%%----------------     -------||||--||||----%%%%%%%%%------------%%%%|||||||------------%%%
XXXXXXXXXXXXXXXXXXXXXXXXXXXXXXXXXXXXXXXXXXXXXXXXXXXXXXXXXXXXXXXXXXXXXX|||||----||||XXXXXXXXXXXXXXXXXXXXXXXX||||XXXXXXXXXXXXXXXX     XXXXXXX||||--||||XXXX|||||||||XXXXXXXXXXXX||||XXXXXXXXXXXXXXXXXXX|||