--------------------------------------------------------------------------------------------------------------------------------------------------------------------------------------------------------
--------------------------------------------------------------------------------------------------------------------------------------------------------------------------------------------------------
--------------------------------------------------------------------------------------------------------------------------------------------------------------------------------------------------------
--------------------------------------------------------------------------------------------------------------------------------------------------------------------------------------------------------
--------------------------------------------------------------------------------------------------------------------------------------------------------------------------------------------------------
--------------------------------------------------------------------------------------------------------------------------------------------------------------------------------------------------------
--------------------------------------------------------------------------------------------------------------------------------------------------------------------------------------------------------
--------------------------------------------------------------------------------------------------------------------------------------------------------------------------------------------------------
-------------------------------------CSS2SCSCC--------------g-------------------------------------------------------------------------------------------------------------------gg----r-----------------
-----------------------------------kgggggggggkgg--------------------------------------------------------------------------------------------------------------------------------------------------------
---------------------------------r-------------------------------------U----------------------------g---------------------------------------------------------------------------------------------------
-------------------------%%%%%%%%%--------------%%%%%%%%%%%----------------ggggkgggkkgg------------------------------------%%%%%%--------------------------------------%%%%%%%%------%%-----------------
-------------------------|||||||||--------------|||||||||||----------------------------------------------------------------||||||--------------------------%%%%%%%%----||||||||------|%%%%%-------------
-------------------------|||||||||%%%%%%%%%%%%%%|||||||||||----------------------------%%%%%%%%%%%%%------------------g----|g||||---gg---------------------||||||||----||||||||------||||||--%%%%%    %%
------%%%%%--------------||||||||||||||||||||||||||||||||||---%%%%%%%%%%%%%------------|||||||||||||----%%%%%%%%%%%%%------||||||--------------------------||||||||----||||||||------||||||--|||||||| ||
XXXXXX|||||XXXXXXXXXXXXXX||||||||||||||||||||||||||||||||||---|||||||||||||XXXXXXXXXXXX|||||||||||||----|||||||||||||----XXXXXXXXXXX-----XXXXXXXXXXXXX---XXXXXXXXXXXXXX||||||||-----XXXXXXXXX|||||||||||