--------------------------------------------------------------------------------------------------------------------------------------------------------------------------------------------------------
--------------------------------------------------------------------------------------------------------------------------------------------------------------------------------------------------------
--------------------------------------------------------------------------------------------------------------------------------------------------------------------------------------------------------
--------------------------------------------------------------------------------------------------------------------------------------------------------------------------------------------------------
--------------------------------------------------------------------------------------------------------------------------------------------------------------------------------------------------------
--------------------------------------------------------------------------------------------------------------------------------------------------------------------------------------------------------
--------------------------------------------------------------------------------------------------------------------------------------------------------------------------------------------------------
--------------------------------------------------------------------------------------------------------------------------------------------------------------------------------------------------------
----------------------------------------------------------------------------------------------------------------k-----k----------------r----------------------------------------------------------------
----------------------------------------------------------------------------------------C22S2SUSC--%%%% %     %-----------------------------------------------------------------------------------------
----------r----------------------------------------------------------------------------------------||||||||||||% %%%%% %%%  --SS2SS---% %%% %   %-------------------------------------------------------
--------------------------------------------------------------------CSCUC---------S2SU-------------|||||||||||||||||||||||||----------|||||||||||-------------------------k-----r-----------------------
------------------------------% %------------------------------------------------------------------|||||||||||||||||||||||||----------|||||||||||%%% %% %%----------------------------------------------
------------------------------|||----------------k-------------------------------------------------|||||||||||||||||||||||||----------||||||||||||||||||||----------------------------------------------
------ %%%%-------------------|||---- %%% %% % %----   % %%%% %% ----------------------------------||||||||||||||||||||||||| %% %%% %%||||||||||||||||||||----% % %% %%%%----%%%% %  -------------------
 X  XX||||| XXXXX XX  X  -----|||----|||||||||||----|||||||||||||XXX  X XX    X X  XXXXXX X    X XX|||||||||||||||||||||||||||||||||||||||||||||||||||||||----|||||||||||----||||||||---X XXXXX   XF    