------------------------------------------------------------------------------------------------------------------------------------------------         -----------------------------------------------
------------------------------------------------------------------------------------------------------------------------------------------------         -----------------------------------------------
------------------------------------------------------------------------------------------------------------------------------------------------         -----------------------------------------------
------------------------------------------------------------------------------------------------------------------------------------------------         -----------------------------------------------
------------------------------------------------------------------------------------------------------------------------------------------------         -----------------------------------------------
------------------------------------------------------------------------------------------------------------------------------------------------         -----------------------------------------------
------------------------------------------------------------------------------UCC---------------------------------------------------------------         -----------------------------------------------
------------------------------------------------------------------------------------------------------------------------------------------------         -----------------------------------------------
-----------------------------------------------------------------------------%------------------------------------------------------------------         -----------------------------------------------
-----------------------------------------------------------------------------|--r---------------------------------------------------------------         -----------------------------------------------
---------------------------------------------------------------------------%%%%%%%------------------------------#---#---------------------------         -----------------------------------------------
--------------------------------------------tt-----------------------------||r|r|k------y-----------#--#-------##---##--------------------------         -----------------------------------------------
-----------------------%%%%--%%%%-----------tt---------------------------%%%%%%%%%%%%%%%%%---------##--##-----###---###-------------------------         -----------------------------------------------
-----------------------||||--||||-----------tt--------------#---#--------|||||||||||||||||--------###--###--%%%%%---%%%%%-----------------------         -----------------------------------------------
-----------------------||||--||||---------%%%%%%%%%%%--%%%%%%---%%%------|||||||||||||||||------%%%%%--%%%%%|||||---|||||--------%%%%%---%%-----         -----------------------------------------------
XXXXXXXXXXXXXXXX--XXXXX||||--||||XXX---XXX|||||||||||--||||||---|||XX--XX|||||||||||||||||XX--XX|||||--||||||||||---|||||XXX--XXX|||||---||XXXXX         XXXXXXXXXXXXXXXXXXXXXXXXXXXXXXXXXXXXXXXXXXXXXXX