----------------------------------------------------------------------------------------------------------------------------         -------------------------------------------------------------------
----------------------------------------------------------------------------------------------------------------------------         -------------------------------------------------------------------
----------------------------------------------------------------------------------------------------------------------------         -------------------------------------------------------------------
----------------------------------------------------------------------------------------------------------------------------         -------------------------------------------------------------------
----------------------------------------------------------------------------------------------------------------------------         -------------------------------------------------------------------
----------------------------------------------------------------------------------------------------------------------------         -------------------------------------------------------------------
----------------------------------------------------------------------------------------------------------------------------         -------------------------------------------------------------------
----------------------------------------------------------------------------------------------------------------------------         -------------------------------------------------------------------
----------------------------------------------------------------------------------------------------------------------------         -------------------------------------------------------------------
----------------------------------------------------------------------------------------------------------------------------         ----------------------------------------Tt-------------------------
---------------------------------------------------------------------------------------------------------Tt-----------------         ---G----Tt---------------------G--------tt-------------------------
---------------------------------------------------------CUU------------G-G----------------------------%%tt%%%%%------------         %%%%----tt---------------------%%%------tt-------------------------
-------------K--------------------------K--------K--------------%%%-----%%%%%--------------------------||tt|||||--%%%%--%%%%         ||||----tt---------------------|||------tt--------------------%%%--
----------%%%%%----%%%---%%%%%%---------%%%%--%%%%%-------------|||-----|||||--------------------------|Gtt%%|||--||||--||||         ||||----tt---------------------|||-%%%%%%%%%%-----------------|||--
----------|||||----|||-%%%|||||---------||||--|||||-------------|||-----|||||-----------------------%%%%%%%%%%%|--||||--||||         %%%|-%%%%%%%%%-----------------|||-||||||||||-----------------|||--
XXXXXXXXXX|||||----|||X|||XXXXXXXXXXXXXX||||--|||||XXXXXXXXXXXXX|||-----|||||XXXXXXXXXXXXXXXXXXXXXXX|||||||||||XXX||||--||||         |||XX|||||||||XXXXXXXXXXXXXXXXXXXXXXXXXXXXXXXXXXXXXXXXXXXXXXXX|||--