--------------------------------------------------------------------------------------------------------------------------------------------------------------------------------------------------------
--------------------------------------------------------------------------------------------------------------------------------------------------------------------------------------------------------
--------------------------------------------------------------------------------------------------------------------------------------------------------------------------------------------------------
--------------------------------------------------------------------------------------------------------------------------------------------------------------------------------------------------------
--------------------------------------------------------------------------------------------------------------------------------------------------------------------------------------------------------
--------------------------------------------------------------------------------------------------------------------------------------------------------------------------------------------------------
--------------------------------------------------------------------------------------------------------------------------------------------------------------------------------------------------------
--------------------------------------------------------------------------------------------------------------------------------------------------------------------------------------------------------
-----------------------------------------------------------------------------------------------------------------------Tt-------------------------------------------------------------------------------
-----------------------------------------------------------------------------------------------------------------------tt-------------------------------------------------------------------------------
-----------------------------------------------------------------------------------------------------------------------tt-------------------------------------------------------------------------------
----------------------------------------------------------------------------------------------------------------------Gt----------F----------------------------------------------------------K----------
---------------------------%%%%%%%%%%%--------%%%%%%%%%%%%%-----%%%----------------------------------GG-K---------%%%%%%%%%%%%----%----------------------%%%%%%%%%%-------------------%%%----%%%--------
---------------------------|||||||||||--------|||||||||||||-----|||---------------------------------%%%%%---------||||||||||||----|----------------------||||||||||-------------------|||----|||------F-
---------------------------|||||||||||--------|||||||||||||-----|||---------------------------------|||||---------||||||||||||----|----------------------||||||||||-------------------|||----|||------ -
XXXXXXXXXXXXXXXXXXXXXXXXXXX|||||||||||XXXXXXXXXXXXXXXXXX|||-----|||XXXXXXXXXXXXXXXXXXXXXXXXXXXXXXXXX|||||XXXXXXXXX||||||||||||XXXXXXXXXXXXXXXXXXXXXXXXXXX||||||||||XXXXXXXXXXXXXXXXXXX|||----|||XXXXXXXX