--------------------------------------------------------------------------------------------------------------------------------------------------------------------------------------------------------
--------------------------------------------------------------------------------------------------------------------------------------------------------------------------------------------------------
--------------------------------------------------------------------------------------------------------------------------------------------------------------------------------------------------------
--------------------------------------------------------------------------------------------------------------------------------------------------------------------------------------------------------
--------------------------------------------------------------------------------------------------------------------------------------------------------------------------------------------------------
--------------------------------------------------------------------------------------------------------------------------------------------------------------------------------------------------------
--------------------------------------------------------------------------------------------------------------------------------------------------------------------------------------------------------
-------------------------------------------------------------------------------------------------------Tt-----------------------------------------------------------------------------------------------
-------------------------------------------------------------------------------------------------------tt-----------------------------------------------------------------------------------------------
-------------------------------------------------------------------------------------------------------tt-----------------------------------------------------------------------------------------------
-----------------------------------------------------------------------------------------------------K-tt-----------------------------------------------------------------------------------------------
----------------------------------------------------------------------------------------------------%%%%%%%%----------------------F-222---------------------G-G-----------------------------------------
--------------------------KK------K----------------G------------------------------K----------%%%%%%%%|||||||------------UC2C2-----%---------------%%%%------%%%%%--------------------%%%%%%%%%%---------
--------------------------%%%---%%%%%---CUU%%%%---%%%%%------------------%%%----%%%%--------%%%%||||||||||||----------------------|------------G--||||------|||||--------------------||||||||||----F----
--------%%%-----%%%%%-----|||---|||||------||||---|||||------------------|||----||||--------||||||||||||||||----------------------|----%%%%%%%%%%-||||------|||||--------------------||||||||||---- ----
XXXXXXXX|||-----|||||XXXXX|||XXX|||||XXXXXX||||---|||||XXXXXXXXXXXXXXXXXX|||----||||XXXXXXXXXXXXXXXXXXXXXXXXXXXXXXXXXXXXXXXXXXXXXXXXXXX||||||||||X||||------|||||XXXXXXXXXXXXXXXXXXXX||||||||||XXXXXXXXX