-------------------------------------------------------------------------------- ---------------------------------------------- ------------------------------------------------------------------------
-------------------------------------------------------------- ----------------- ---------------------------------------------------------------------- ------------------------------------------------
--- -------------------------------------------------------------------------------- ------------------------------------------------------------------------------------------------------------------ 
-------------------------------------------------- --------------------- ------------------------------------------------------------- ---------------- ------------- ----------------------------------
-------------------------------------------- --- ----------------------- -------------------------------------------------------------- ---------------------- -----------------------------------------
--------------- ----------------------------------------- ----------------------------------------------------------------------------------------------------------------------------------------------
---------------------------------- ----------------------------------------------------------------------SSC--------------------------------------------------------------------------------------------
 ---------------------------------------------------------- ------------------------------------------------------------------- ---------U2C222CSS2SC-%%  %%% %% % ------- ------%%% %%%----------------
-------------------------------------------------------------U----------------------------------tt-----g--k---r---------------------------------- ----|||||||||||||---r--  %%%---|||||||----------------
--------- --------------------------------------------------------------------------------------tt---------------------------------SUCS---------------|||||||||||||------||||| --|||||||----------------
--------------------------------- --------------------------------- %  %% %% --------------%%%% %%%% %%    % %%-----%% %%%%%%----- -------------------|||||||||||||------|||||-%%% % %%% %%%%% %% %%%F  
-------------------------------%%%% -- ----------------------- --kgggkgkkgggggg- ----------||||||||||||||||||||-----|||||||||-------------------------|||||||||||||---- %% %%  ||||||||||||||||||||||%||
-------------------------------|||||-------------------%%%%%%%  %--|||||||| |------- ------|||||||||||||||||| |-----|||||||||-------------------------|||||||||||||----|||||||||||||||||||||||||||||||||
--------------------------gg---||g||------- -----------||||||||||--||||||||||--%%%%%%%% % %||||||||||||||||||||-----|||||||||% %%%%  %% --------------|||||||||||||----|||||||||||||||||||||||||||||||||
------ % % ------ -------------|||||-------------------||||||||||--||||||||||--|||||||||||||||||| |||||||||||||-----||||||||||||||||||||--------------|||||||||||||----|||||||||||||||| |||||||||| |||||
 XXXXX|||||XXXXXXXXXXXXXX----XXXXXXXXX-----XXXXXXXXX---||||||||||XXXXXXXXXXXXXX|||||||||||||||||||||||||||| |||-- --||||||||||||||||||||XXXXXXXXXXXXXX|||||||||||||----|||||||||||||||||||||||||||||| ||