--------------------------------------------------------------------------------------------------------------------------------------------------------------------------------------------------------
--------------------------------------------------------------------------------------------------------------------------------------------------------------------------------------------------------
--------------------------------------------------------------------------------------------------------------------------------------------------------------------------------------------------------
--------------------------------------------------------------------------------------------------------------------------------------------------------------------------------------------------------
--------------------------------------------------------------------------------------------------------------------------------------------------------------------------------------------------------
--------------------------------------------------------------------------------------------------------------------------------------------------------------------------------------------------------
-----------------------------------------------------------------------------------------------------------------------------USCSSSSS2-%%%%%%%%%%%%%%---------------------------------------------------
---------------------------------------------------------------------------------------------------------------------------------------||||||||||||||---------------------------------------------------
-------------------------------------------------------------------U--------------------------------------------------CSSUC------------||||||||||||||-r-------------------------------------------------
--------------------------------------------------------------------------CC-----------------------------------------------------------||||||||||||||---------------------------------------------------
---------------------------------------------------------------------------------------------------------------------------------------||||||||||||||%%%%%%%%%%%-----%%%%%%-----------------------------
-----------------------------------------------------------------------gkggggkg----------------------------SSC-------------------------|||||||||||||||||||||||||-----||||||-----------------------------
-------------------------------------------------------------%%%%%%%%%%------------------------gk--k------------%%%%%%%%%%%%%%%%%%%%%%%|||||||||||||||||||||||||-----||||||----------------%%%%%%%    %%
------------------------------g-------g-------g--------------||||||||||--------%%%%%%%%%%-----------------------||||||||||||||||||||||||||||||||||||||||||||||||---%%%%%%%%%%------k----r--|||||||||| ||
------%%%%%--------------------------------------------------||||||||||--------||||||||||-----%%%%%%%%%%--------||||||||||||||||||||||||||||||||||||||||||||||||---||||||||||--------------|||||||||||||
XXXXXX|||||XXXXXXXXXXXXXX----XXXXXXXXXXX-----XXXXXXXXXXXX----||||||||||XXXXXXXX||||||||||-----||||||||||XXXXXXXX||||||||||||||||||||||||||||||||||||||||||||||||---||||||||||-----XXXXXXXXX|||||||||||||