--------------------------------------------------------------------------------------------------------------------------------------------------------------------------------------------------------
--------------------------------------------------------------------------------------------------------------------------------------------------------------------------------------------------------
--------------------------------------------------------------------------------------------------------------------------------------------------------------------------------------------------------
--------------------------------------------------------------------------------------------------------------------------------------------------------------------------------------------------------
--------------------------------------------------------------------------------------------------------------------------------------------------------------------------------------------------------
--------------------------------------------------------------------------------------------------------------------------------------------------------------------------------------------------------
--------------------------------------------------------------------------------------------------------------------------------------------------------------------------------------------------------
----------------------------------------------------------------------------Tt--------------------------------------------------------------------------------------------------------------------------
--------------------------------------------------Tt-------------------------t--------------------------------------------------------------------------------------------------------------------------
--------------------------------------------------tt-------------------------t--------------------------------------------------------------------------------------------------------------------------
--------------------------------------------------tt---------------Tt--------t--------------------------------------------------------------------------------------------------------------------------
------------------------------------------------K-tt--K------------tt--%%%%%-%%%%K------------------------------------------Tt----F------------------G-----G--------KK-----------------G--------------%%
----------------------------------------------%%%%%%%%%------------tt--|%%%%%%%%%%%------------------%%%%%%-----------------tt----%------------------%%%%%-%%%-----%%%%-------%%%%%--%%%--------------||
----------------------------------------------|||||||||-------%%%%%%%%%%%%|||||||||------------------||||||%%%------K-------tt----|------------------|||||-|||-----||||-------|||||--|||--------F-%%%-||
----------------------------------------------|||||||||-------|||||||||||||||||||||------------------||||||||%%%%%%%%----%%%%%%%%%%------------------|||||-|||-----||||-------|||||--|||-------- -|||-||
XXXXXXXXXXXXXXXXXXXXXXXXXXXXXXXXXXXXXXXXXXXXXXXXXXXXXXXXXXXXXXXXXXXXXXXXXXXXXXXXXXXXXXXXXXXXXXXXXXXXX||||||XX||||||||XXXX||||||||||XXXXXXXXXXXXXXXXXXXXXXXX|||-----||||XXXXXXX|||||--|||XXXXXXXXXX|||XXX