--------------------------------------------------------------------------------------------------------------------------------------------------------------------------------------------------------
--------------------------------------------------------------------------------------------------------------------------------------------------------------------------------------------------------
--------------------------------------------------------------------------------------------------------------------------------------------------------------------------------------------------------
--------------------------------------------------------------------------------------------------------------------------------------------------------------------------------------------------------
--------------------------------------------------------------------------------------------------------------------------------------------------------------------------------------------------------
--------------------------------------------------------------------------------------------------------------------------------------------------------------------------------------------------------
--------------------------------------------------------------------------------------------------------------------------------------------------------------------------------------------------------
--------------------------------------------------------------------------------------------------------------------------------------------------------------------------------------------------------
-------------------------------------------------------------------------------g------------------------------------------------------------------------------------------------------------------------
------------------------------------------------------------------------------------------------------------------------------------------------222SSCSS----------------------tt--------S22SCC----------
---------------------------------------------------------gggkkkgg-----------------------------------------------------------------------------gkgkggggggggg-------------------tt------------------------
-------------------------------------------------------r--||||||----------------------------------------------------------------------------r--------------------------%%%%%%%%%%%%%%-g-----------------
------------------------------------------%%%%%%%%%%%%%%--||||||-%%%%%%%%%%%%%---------------------tt---------------g-g--------%%%%%%%%%%%%%%--------------%%%%%%%%%%%%||||||||||||||-------------------
------------------------------------------||||||||||||||--||||||-|||||||||||||-------%%%%%---g-g---ttg-------------------------||||||||||||||--------------||||||||||||||||||||||||||%%%%%%%%%%%--------
------%%%%%-------------------------------||||||||||||||%%%%%%%%%|||||||||||||-------|||||---------tt--------------%%%%%%%%%%%%||||||||||||||%%%%%%%%%%%%%%|||||||||||||||||||||||||||||||||||||--------
XXXXXX|||||XXXXXXXXXXXXXX---XXXXXXXXXXXXXX||||||||||||||||||||||||||||||||||||-----XXXXXXXXX---XXXXXXXX-----XXX----|||||||||||||||||||||||||||||||||||||||||||||||||||||||||||||||||||||||||||||XX    XX