--------------------------------------------------------------------------------------------------------------------------------------------------------------------------------------------------------
--------------------------------------------------------------------------------------------------------------------------------------------------------------------------------------------------------
--------------------------------------------------------------------------------------------------------------------------------------------------------------------------------------------------------
--------------------------------------------------------------------------------------------------------------------------------------------------------------------------------------------------------
--------------------------------------------------------------------------------------------------------------------------------------------------------------------------------------------------------
--------------------------------------------------------------------------------------------------------------------------------------------------------------------------------------------------------
--------------------------------------------------------------------------------------------------------------------------------------------------------------------------------------------------------
--------------------------------------------------------------------------------------------------------------------------------------------------------------------------------------------------------
-------------------------------------------------------------------------Tt-----------------------------------------------------------------------------------------------------------------------------
-------------------------------------------------------------------------tt----------------------------------------------------------------------------------------------Tt-----------------------------
-----------Tt----------------------------------------------------------G-tt-G---------------------------------------------------------------------------------Tt---------tt-----------------------------
-----------tt----------------------------------------Tt---------------%%%%%%%%----------------K-----------------------------------F---------------------------tt---------tt----------------------G------
-----------tt-------------------K--------------------tt---------------||||||||----------------%%%--%%%%%--------------------------%----G-------G---------%%%G-tt------%%%%%%%%------%%%%%--%%%%%%%%%2---
------%%%%%%%%%%%%-------------%%%%-%%%%%------------tt--K---%%%%%%%%-||||||||----------------|||--|||||-------------------K------|----%%%-----%%%%%-----|||%%%%%%%%--||||||||------|||||--|||||F|||----
------||||||||||||-------------||||-|||||--------%%%%%%%%%---||||||||-||||||||----------------|||--|||||------------------%%%%%%--|----|||-----|||||-----|||||||||||--|||||||%%%%%%-|||||--||||| |||----
XXXXXXXXXXXXXXXXXXXXXXXXXXXXXXXXXXXX|||||XXXXXXXX|||||||||XXX||||||||XXXXXXXXXXXXXXXXXXXXXXXXX|||--|||||XXXXXXXXXXXXXXXXXX||||||XXXXXXX|||-----|||||XXXXX|||XXXXXXXXXXXXXXXXX||||||X|||||XXXXXXXXXXXXXXX