-------------------------------------------------------------------------------------------------------------------------------       ------------------------------------------------------------------
-------------------------------------------------------------------------------------------------------------------------------       ------------------------------------------------------------------
-------------------------------------------------------------------------------------------------------------------------------       ------------------------------------------------------------------
-------------------------------------------------------------------------------------------------------------------------------       ------------------------------------------------------------------
-------------------------------------------------------------------------------------------------------------------------------       ------------------------------------------------------------------
-------------------------------------------------------------------------------------------------------------------------------       ------------------------------------------------------------------
-------------------------------------------------------------------------------------------------------------------------------       ------------------------------------------------------------------
-------------------------------------------------------------------------------------------------------------------------------       ------------------------------------------------------------------
-------------------------------------------------------------Tt----------------------------------------------------------------       ------------------------------------------------------------------
-------------------------------------------------------------tt----------------------------------------------------------------       ------------------------------------------------------------------
---------------------------------Tt--------------------------tt----------------------------------------------------------------       ------------------------------------------------------------------
---------------------------------tt%%%%%%%%%-----------%%%%%-tt----------------------------------------------------------------       -------------------Tt--------------22------------------------Tt---
---------------------------------tt|||||||||-----------|%%%%%%%%%%%%-----------------------%%%%%%%%%%--------------------------       --------%%%%%%%%%--tt----%%%%--------------------------------tt---
------------------------------%%%%%%%%%%||||-----------|||||||||||||-----------------------||||||||||-----------------%%%%%----       --%%%%%%%%%%%||||--tt----||||--------------------------------tt---
--------------------%%%%------||||||||||||||-%%%%------|||||||||||||-----------------------||||||||||-%%%%%--%%%------|||||----       --|||||||||||||%%%%%%%%%%%|||-%%%%-----%%%--%%%%%---------%%%%%%%%
XXXXXXXXXXXXXXXXXXXX||||XXXXXX||||||||||XXXXX||||XXXXXXXXXXXXXXXXXXXXXXXXXXXXXXXXXXXXXXXXXX||||||||||X|||||--|||XXXXXXXXXXXXXXX       XXXXXXXXXXXXXXX|||||||||||XXXX||||XXXXX|||--|||||XXXXXXXXX||||||||