--------------------------------------------------------------------------------------------------------------------------------------------------------------------------------------------------------
--------------------------------------------------------------------------------------------------------------------------------------------------------------------------------------------------------
--------------------------------------------------------------------------------------------------------------------------------------------------------------------------------------------------------
--------------------------------------------------------------------------------------------------------------------------------------------------------------------------------------------------------
--------------------------------------------------------------------------------------------------------------------------------------------------------------------------------------------------------
--------------------------------------------------------------------------------------------------------------------------------------------------------------------------------------------------------
--------------------------------------------------------------------------------------------------------------------------------------------------------------------------------------------------------
--------------------------------------------------------------------------------------------------------------------------------------------------------------------------------------------------------
--------------------------------------------------------------------------------------------------------------------------------------------------------------------------------------------------------
----------------------------------------------------------Tt--------------------------------------------------------------------------------------------------------------------------------------------
--------------------------Tt------------------------------tt---------------------------------------------------------------------------------------------------------------------Tt---------------------
----------%%%%%%K---------tt-------USUSS2-----------K-----tt------%%%%%%%%%%%%--------------------------------%%%%%%%%%-----------F----C----------------------------------------%tt%%%%%%%--------------
---------%%%%%%%%---------tt-------------%%%%----%%%%--%%%%%%%%---||||||||||||--------------------------------|||||||||-----------%-----------------------%%%------------%%%%%%%%tt||||||%%%%%----------
---------||||||||---------tt-------------||||----||||--||||||||---||||||||||||---------%%%%------%%%%---------|||||||||-------%%%-|%%%%---%%%%%%%%%%%%2SSU|||------------||||||||tt|||||||||||--F-------
---------||||||||------%%%%%%%%%%%%%-----||||----||||--||||||||---||||||||||||---------||||------||||---------|||||||||-------|||-|||||---%%%%%%||||||----|||------------|||%%%%%%%%%%||||||||-- -------
XXXXXXXXXXXXXXXXXXXXXXX|||||||||||||XXXXX||||----||||XX||||||||XXXXXXXXXXXXXXXXXXXXXXXX||||------||||XXXXXXXXXXXXXXXXXXXXXXXXX|||-|||||XXX||||||XXXXXXXXXXXXXXXXXXXXXXXXXXXX||||||||||XXXXXXXXXXXXXXXXXX