------------------------------------  ------------------------------------------------------------- --------------------------------------------------------- --------- ------- ------------------------
---------- --------------------- ------ -- ----------------------------------------- ---------- - ------------------------------------------------ -----------------------------------------------------
------  ------------------ ---------------------- - --------------------------------------------------- ------------------------------------------------------------ ---------------------- ---- -------
-------- ------------ ------------ -------- ------------------------------ --------------------- -----------------------  - ------------------------------------------------------- --------- -------- -
----- ----------------------------- -------------------        --------------- ------------ -- --------------------------------------------------------------------------- -----------------------------
------------- -------------------------------------- --------------- ------------------------------ ---- --- ------------------------------------------------- -------------------- --------------------
-------------------- ---------------------------------------- - ----------- ------------------------------ ------- ----------- ---------------------------------------- --------------------------------
---------------------------------------------------------------------------------- -------       --------------------------------------------------------------- - t------------------------------------
--------------------------------------------------- ------------------ t------------ ----------------------------------------------------------- t--- ------------tt------------------------------------
 --------------------------------------- ---------------- ------ -----tt----------- ------- ------ ------------ ------------- -------------------t----------------tt--------------- --------- ----------
------------------------- ----------- --------------------------------tt------------------------------------------ ------------------------------t- -- -----------tt------ ------- ---------------------
------------- ------------------------- ------------------------------tt------------%%%%----------USCSSU--------- ----------------F-------- -%%%-%%%%% --------%%%%%%%%%-------------------- -----%-%%%%
---- ---------------------------  ----------------------- -------%%% %%%%%%%%-------||||-------------------- ---------------- ----%----------|||-|||||%%%------|||||| ||-------------------CC2C--- -||||
------------- -----------%%%%%% %%%%------------%% %%%%%%%%------||||||||||||---%%%%%%||---------------- ------------------------ |----------%%%%%%%%%|| ------|||||||||-- ----------------------  -||||
-------------------------|||||||||||---------- -|||||||||||------||||||||||||- -||||||||---------- --------- ------  -------------|- -- -----||||||||||| ------|||||||||%%%%%%%%%%%------------%%%%%%%% 
  XXXXXXX XXXXXXXXXXXXX X|||||||||||XXXXXXX XXXX|||||||||||XXXXXXXXXXXXXXXXXXXXXX XXXXXXXXXXXXXXXXXXXXXXXXX XXXXXXXXXXXXXXXXXXX XXXXXXXXXXXXXXXXXXX XXXXXXXXXXXXXXXXXXXX|||||||||||XXXXXXXXXXXX|||||||||