--------------------------------------------------------------------------------------------------------------------------------------------------------------------------------------------------------
--------------------------------------------------------------------------------------------------------------------------------------------------------------------------------------------------------
--------------------------------------------------------------------------------------------------------------------------------------------------------------------------------------------------------
--------------------------------------------------------------------------------------------------------------------------------------------------------------------------------------------------------
-------------------------------------------------------------------------------------------------------------------------------------------------------------CCS2SUSSSCS--%%%%%%%%%%--------------------
--------------------------------------------------------------------------------------------------------------------------------------------------------------------------||||||||||--------------------
-------------------------------------------------------------------------------------------------------------CSC2CSSSCS----------------22SC2----------USCSSSS-------------||||||||||--------------------
--------------------------------2C--------------------------------------------------------------------------kgkgggggggkgr-------------------------------------------------||||||||||--------------------
----------------------------------------------------------------------------------------------------------r---------------------------------------------------------------||||||||||----r-r-------------
----------------------------------------------------------------------------------g------g--g%%%%%%%%%%%%%%--------------%%%%%%%%%%%%-------------------------------------||||||||||--------------------
-----------------------------------------------------------------------%%%%%%%---------------||||||||||||||--------------||||||||||||%%%%%%%%%%%%%%%%%%%%%%%--------------||||||||||%%%%%%%%%%%%%%    %%
------------------------------%%%%%%---------%%%%%%--------------------|%%%%%|---%%%%%%%%%%%%||||||||||||||%%%%%%%%%%%%%%|||||||||||||||||||||||||||||||||||--------------||||||||||||||||||||||||||| ||
------------------------------||||||---------||||||---%%%%%%%%%%%------|||||||---|||||||||||||||||||||||||||||||||||||||||||||||||||||||||||||||||||||||||||--------------||||||||||||||||||||||||||||||
------------------------------||||||---gg----||||||---|||||||||||----%%%%%%%%%%%%|||||||||||||||||||||||||||||||||||||||||||||||||||||||||||||||||||||||||||--------------||||||||||||||||||||||||||||||
------%%%%%-------------------||||||---------||||||---|||||||||||----|||||||||||||||||||||||||||||||||||||||||||||||||||||||||||||||||||||||||||||||||||||||%%%%%%%%%%%%%%||||||||||||||||||||||||||||||
XXXXXX|||||XXXXXXXXXXXXXX---XXXXXXXXXX-----XXXXXXXXXXX|||||||||||----|||||||||||||||||||||||||||||||||||||||||||||||||||||||||||||||||||||||||||||||||||||||||||||||||||||||||||||||||||||||||||||||||||