--------------------------------------------------------------------------------------------------------------------------------------------------------------------------------------------------------
--------------------------------------------------------------------------------------------------------------------------------------------------------------------------------------------------------
--------------------------------------------------------------------------------------------------------------------------------------------------------------------------------------------------------
--------------------------------------------------------------------------------------------------------------------------------------------------------------------------------------------------------
--------------------------------------------------------------------------------------------------------------------------------------------------------------------------------------------------------
--------------------------------------------------------------------------------------------------------------------------------------------------------------------------------------------------------
--------------------------------------------------------------------------------------------------------------------------------------------------------------------------------------------------------
---------------------------------------------------------------------------------------------------------------------------------------------------------------------------------------------------Tt---
---------------------------------------------------------------------------------------------------------------------------------------------------------------------------------------------------tt---
---------------------------------------------------------------------------------------------------------------------------------------------------------------------------------------------------t ---
----------------------------------------------------------------------------------------------------G--G------------------------------------------------------------------------------------------Gt --G
----------------------------------------------------------------------------------------------------%%%% %------------------------F------------------------------------------------------------%%%%%%% %
----------- %%------%%%---------------------------------------------------K-------------------------||||||------------------------%------------------------------------------------------------|||||||||
-----------|||------|||-----------------%%% -----%%%%---------------%%%%%%  %%----------------------||||||------------------------|-----------------------%% %---------------------------------|||||||||
-----------|||------|||-----------------||||-----||||---------------||||||||||----------------------||||||------------------------|-----------------------||||---------------------------------|||||||||
 XX X  XXX |||------|||XXXX X XX X  XXX ||||-----|||| X XX  X X XXX ||||||||||  XX X XXX XXXXXXXX  XXXXXX  X XXXXX XXXXXXXX  XX X  XXXXXXX XXXXXXX  XXXX X||||X XXXX XX X X X X XXXX X XXXXX X     X XXX