--------------------------------------------------------------------------------------------------------------------------------------------------------------------------------------------------------
--------------------------------------------------------------------------------------------------------------------------------------------------------------------------------------------------------
--------------------------------------------------------------------------------------------------------------------------------------------------------------------------------------------------------
--------------------------------------------------------------------------------------------------------------------------------------------------------------------------------------------------------
--------------------------------------------------------------------------------------------------------------------------------------------------------------------------------------------------------
--------------------------------------------------------------------------------------------------------------------------------------------------------------------------------------------------------
--------------------------------------------------------------------------------------------------------------------------------------------------------------------------------------------------------
--------------------------------------------------------------------------------------------------------------------------------------------------------------------------------------------------------
--------------------------------------------------------------------------------------------------------------------------------------------------------------------------------------------------------
---------------------------------------------------------------------Tt---------------------------------------------------------------------------------------------------------------------------------
---------------------------------------------------------------------tt---------------------------------------------------------------------------Tt---------------------------Tt-----------------------
--------------------------------G------------------------------------tt----G------------------------------------------------------F---------------tt---------------------------tt-----------------------
-------------------------------%%%%SCCS---------%%%----------------%%tt%%%%%%------------------KK----------------------SCS%%%%%%%%%K--------------tt--------------------------Gtt-----------------------
----------------------G--------||||-------------|||---------------%%%%%%%%%||---------------%%%%%%%%%%--------------------|||||||||%%%%-------%%%%%%%%%-------------------%%%%%%%%%%%%----------SS2S--F-
-----------%%%%%----%%%%-------||||-----%%%%%%%%%%%-%%%%%%%%%%%---|||||||||||---------------||||||||||-------------%%%%%%-|||||||||||||-------|||||||||-------------------||||||||||||---------------- -
XXXXXXXXXXX|||||----||||XXXXXXXXXXXXXXXX|||||||||||X|||||||||||XXX|||||||||XXXXXXXXXXXXXXXXX||||||||||XXXXXXXXXXXXX||||||XXXXX|||||XXXXXXXXXXX|||||||||XXXXXXXXXXXXXXXXXXXXXXXXXXXXXXXXXXXXXXXXXXXXXXXXX