---------------------------------------------------------------------------------------------------------------------------------       ----------------------------------------------------------------
---------------------------------------------------------------------------------------------------------------------------------       ----------------------------------------------------------------
---------------------------------------------------------------------------------------------------------------------------------       ----------------------------------------------------------------
---------------------------------------------------------------------------------------------------------------------------------       ----------------------------------------------------------------
---------------------------------------------------------------------------------------------------------------------------------       ----------------------------------------------------------------
---------------------------------------------------------------------------------------------------------------------------------       ----------------------------------------------------------------
---------------------------------------------------------------------------------------------------------------------------------       ----------------------------------------------------------------
---------------------------------------------------------------------------------------------------------------------------------       ------------------------------Tt--------------------------------
---------------------------------------------------------------------------------------------------------------------------------       ------------------------------tt--------------------------------
---------------------------------------------------------------------------------------------------------------------------------       ------------------------------tt--------------------------------
-------------Tt----------------------------------------------------------------Tt------------------------------------------------       ------------------------------tt-G------------------------------
-------------tt-----------------------------------------------------------UUS--tt-------------------------------------G----------       -------------------------%%%%%%%%%%%----------------------------
-------------tt--------------------------------------------------G-------------tt------------------------------------%%%%-----%%%       ------%%%%------------%%%|||||||%%%|--------------------------%%
-------------tt--K------------%%%%%-----%%%%--------------G----%%%%--%%%%%--%%%%%%%%---------%%%%------%%%%----------||||-----|||       ------||||-----%%%%%%%%%||%%%%%%||||--------------------------||
---------%%%%%%%%%%-----------|||||-----||||------%%%%%%%%%%---||||--|||||--||||||||---------||||------||||----------||||-----|||       ------||||-----|||||||||||||||||||||----------%%%%%%%%%%%-----||
XXXXXXXXX||||||||||XXXXXXXXXXX|||||-----||||XXXXXX||||||||||XXX||||--|||||XXXXXXXXXXXXXXXXXXX||||------||||XXXXXXXXXX||||-----|||       XXXXXX||||XXXXX|||||||||XXXXXXXXXXXXXXXXXXXXXX|||||||||||XXXXXXX