------------------------------------------- --------------------------------------------- -------------------- -----------------------------------------------------------------------------------------
------------- ---------------------------------- ---------------------------------------------------------------------------------------------------------------------------------------- --------------
---------------------------------------------------------------------------- -------------------------------------------------------------------------- ------------------------------------------------
----------------------------------- ---------------------------------------------------- ------------------------------------------------------------------------------- -------------------------------
------------------------------------------------------------ ---------------------------------------------------------------------------------------------------------- --- ----------------------------
--------------------------------------------------------------------- ------------------------------------- ----------------------------------------------------------------- --------------------------
------------------------------------------------------------------------------------------------------------------------------- ----------------- -------- ---------------------------------------------
--------------------------------------------------------------------------------------------------------------- -------------------------------------------------- -------------------------------------
-------------------- --------Tt-------------------------------- ----------------------------------------------- ------------ ------------------------------------------------------------- -------------
------------- ---------------tt------------------------------------ --------------------------------------------------------------- ------------------Tt------------Tt----------------------------------
-----------------------------tt----------------------------Tt-------Tt-------------------------------------Tt----------------------- -----------------tt------------tt----------------------------------
-- ------------------G--%% %%%%%%%%%2SS2-------------------tt-------tt-----%%%------------------------- ---tt--------------------- ----GK---GG--------tt------------tt----------------------------------
-------------%%%%%%%%%%%%|||||||||| ----------------------Gtt-----2SS2SS---||| ----------------------------tt--------- -----------%--%%%%%%%%%%%------tt------------tt-G--%%%--%%%-- -------------------
-------------|||||||||||||||||||||||--------------------%%%%%%%%-%%%%%%%%%-|||--------K-----%%%%%%%%%%--G-Gtt----------2UCCCU-----|--|||||||||||-%%%%%%%%%%----%%%%%%%%%%%|||--|||------------------- --
-------------%%%%%||||||||||||||||||-------%%%% --------|| |||||-|||||||||-|||-%%%%---%%%%--||||||||||-%%%%%%%%%------------------|--|||||||||||-||||||||||--- ||||||||||||||--|||----------------------
XXXXXXXXXXXXX|||||XXXXXXXXXXXXXXXXXXXXXXXXX|||||XXXXXXXX||||||||XXXXXXXXXXXXXXX||||---||||XX||||||||||X|||||||||XXXXXXXXXXXXXXXXXXXXX|||||||||||XXXXXXXXXXXXXXXXXX XXXXXXX|||--|||XXXXXXXXXXXXXXXXXXXXXX