---------------------------------------------------------------------------------------------------------------------------------------------       ----------------------------------------------------
---------------------------------------------------------------------------------------------------------------------------------------------       ----------------------------------------------------
---------------------------------------------------------------------------------------------------------------------------------------------       ----------------------------------------------------
---------------------------------------------------------------------------------------------------------------------------------------------       ----------------------------------------------------
---------------------------------------------------------------------------------------------------------------------------------------------       ----------------------------------------------------
---------------------------------------------------------------------------------------------------------------------------------------------       ----------------------------------------------------
---------------------------------------------------------------------------------------------------------------------------------------------       ----------------------------------------------------
---------------------------------------------------------------------------------------------------------------------------------------------       ----------------------------------------------------
--------------------------------------------------------------------------------------------------------y------------------------------------       ----------------------------------------------------
-----------------------------#--#---------------------------------------------------------------------%%%%%----------------------------------       ----------------------------------------------------
----------------------------##--##--------------------------------------------------------------------|||||----------------------tt----------       ----------------------------------------------------
---------------------------###--###-------------------------------------------------------------------|||||-r--g----#--#---------tt----------       ----------------------------------------------------
-------------------------%%%%%--%%%%%---------%%---%%------------%%%%---%%%%-------------------------%%%%%%%%%%%%%%%%--%%%----%%%%%%%%%%-----       ----------------------------------------------------
--------------%%%%---%%%%|||||--|||||---------||---||%%%%%--%%%%%||||---||||%%%%%---%%%%%%%%%%--%%%%%||||||||||||||||--|||%%%%||||||||||%%%%%       %%%%%%%%%%%%%%%%%%%%%%%%%%%%%%%%%%%%%%%%%%%%%%%%%%%%
--------------||||---|||||||||--|||||---------||---|||||||--|||||||||---|||||||||---||||||||||--|||||||||||||||||||||--||||||||||||||||||||||       ||||||||||||||||||||||||||||||||||||||||||||||||||||
XXXXXXXXXXXXXX||||---|||||||||--|||||XXX---XXX||---|||||||--|||||||||---|||||||||---||||||||||--|||||||||||||||||||||--||||||||||||||||||||||       ||||||||||||||||||||||||||||||||||||||||||||||||||||