--------------------------------------------------------------------------------------------------------------------------------------------------------------------------------------------------------
--------------------------------------------------------------------------------------------------------------------------------------------------------------------------------------------------------
--------------------------------------------------------------------------------------------------------------------------------------------------------------------------------------------------------
--------------------------------------------------------------------------------------------------------------------------------------------------------------------------------------------------------
--------------------------------------------------------------------------------------------------------------------------------------------------------------------------------------------------------
--------------------------------------------------------------------------------------------------------------------------------------------------------------------------------------------------------
--------------------------------------------------------------------------------------------------------------------------------------------------------------------------------------------------------
--------------------------------------------------------------------------------------------------------------------------------------------------------------------------------------------------------
-------------------------------------SSSCSCS2-------------g---------------------------------------------------------------------------------------------------------------------------------------------
------------------------------------kggggggggkk-----------------------------------------------------------------------------------------------U---------------------------------------------------------
----------------------------------r-----------------------------------------------------------------------------------------------------------------------------------------g----r----------------------
-------------------------%%%%%%%%%%------------%%%%%%%%%%-----g-g-----------------------------------------------------------g--g-----g------------ggkgggggkggg--------------------------%%%%%%%%%%    %%
-------------------------||||||||||------------||||||||||------------------%%%%%--------------------------------------------------------------------||||||||---------------%%%%%%%%%%%%%||||||||||||| ||
-------------------------||||||||||%%%%%%%%%%%%||||||||||---%%%%%%%%%%%----|%%%%%%%-----------------g---g------------------%%%%%%%%%%%%---%%%%%%%%--||||||||--%%%%%%%%%%%%%|||||||||||||||||||||||||||||
------%%%%%--------------||||||||||||||||||||||||||||||||---|||||||||||----||||||||---------%%%----------------------------||||||||||||---||||||||--||||||||--||||||||||||||||||||||||||||||||||||||||||
XXXXXX|||||XXXXXXXXXXXXXX||||||||||||||||||||||||||||||||---|||||||||||---XXXXXXXXXXXXX-----|||----XXXXXXXXX-----XXXXXXXXXX||||||||||||---||||||||XXXXXXXXXXXX||||||||||||||||||||||||||||||||||||||||||