--------------------------------------------------------------------------------------------------------------------------------------------------------------------------------------------------------
--------------------------------------------------------------------------------------------------------------------------------------------------------------------------------------------------------
--------------------------------------------------------------------------------------------------------------------------------------------------------------------------------------------------------
--------------------------------------------------------------------------------------------------------------------------------------------------------------------------------------------------------
--------------------------------------------------------------------------------------------------------------------------------------------------------------------------------------------------------
--------------------------------------------------------------------------------------------------------------------------------------------------------------------------------------------------------
--------------------------------------------------------------------------------------------------------------------------------------------------------------------------------------------------------
----------------------------------------------------------------------------------------------------------Tt--------------------------------------------------------------------------------------------
----------------------------Tt----------------------------------------------------------------------------tt--------------------------------------------------------------------------------------------
------------Tt--------------tt-----------Tt-----------------------------Tt--------------------------------tt-----------------------------------------------------------------------------Tt-------------
------------tt--------------tt-----------tt-----------------------------tt---------------Tt---------------tt-----------------------------K--------------------------------Tt-------------tt-------------
---------G-Gtt-K------------tt--G-----G--tt-----------------------------tt---------------tt-----------%%%%%%%%%%%----------------- ------%%%%%------G%%%%%%%%%%%----------tt-------------tt-------------
--------%%%%%%%%%%%------%%%%%%%%%--%%%%%%%%%%----U222UC-------------%%%%%%%%------------tt-----------|||||||||||-----------------%------|||||--CU2UC|||||||||||----------tt----------G--tt---K---------
--------|||||||||||------||||||%%%%-||||||||||-----------------------||||||||-------%%%%%%%%%%--------|||||||||||-----------------|--%%%%%%%%|-------|||||||||||------%%%%%%%%%------%%%%%%%%%%%%% ----%
--------|||||||||||------||||||||||-||||||||||-----------------------||||||||-------||||||||||--------|||||||||||-----------------|--|||||||||-------|||||||||||------|||||||||------||||||||||||||----|
XXXXXXXX|||||||||||XXXXXXXXXXXX||||X||||||||||XXXXXXXXXXXXXXXXXXXXXXXXXXXXXXXXXXXXXX||||||||||XXXXXXXXXXXXXXXXXXXXXXXXXXXXXXXXXXXXXXX||||||||XXXXXXXXXXXXXXXXXXXXXXXXX|||||||||XXXXXXXXXXXXXXXX||||----|