------- --- --------------------------------------------------------------------------- --------- ---------------------------------------------------------------------------------- -------------------
--------------- -------------------------------------------------------- ------------------------------------------------------ --------------------------- --- ---------------- -----------------------
--------------- -------------------------------------------- -------------------------------------------------------------------------------------------------------------------------------------------
----------------------------------------- ----------------------------------------------------- ------------------------------------------------------------ -------------------------------------------
----------------------------------------- ----- ------------------------------------------------------------------------------- --------------------- -------------------------------------------- -----
--------------------------------------------------------------------------------------------------------------------------------------------------------------------- ----------------------- ----------
------------------------------------------------------------------------------------------------------------- --------------------------------------------------------------------------------- --------
--------------- ----------------------------------- ----- ------------------------U--- ------ ------------------------------ ----------------------------------------------------------------------- ---
---- -----------------------------------------------------gg------------------------------S-------------g------------g---------g------------------------------------------------------------------------
----------------------------------gkkgkgggg--------------------------------------------------------------------------------------------------------------------------- ---------------------------------
----- --------------------------r -|||||||--------------------------------------- ---- gkgkkgg---- ------------------------- ---------------------------------------------------------------------------
-------------------------%%%%%%%%--|||||||-%%%%%%%%%%%%%%------%%%%%%---%%%%%%%%%%%%%%----------------------------------------------------------- ---- ------------C2CSSSSS-----------------------------
-------------------------||||||||--|||||||-||||||| ||||||------||||||---||||||||||||||--------%%%%%%%%%-------- -------------------- --------------------------------------------- ---------------------
-------------------------||||||||%%%%%%%%%%||| ||||||||||------|%%%%%%--||||||||||||||--------|||||||||-----%%%%%%%%--------------------g--------g-------g--g------------------------g------------------
------%%%%%------------ -||||||||||||||||||||||||||||||||------|||||||--||||||||||||||%%%%%%%%|||||||||-----||||||||------------------- ----------- ----------------------------------------------------
  XX  |||||XXXXX  XX  X X||||||||||||||||||| ||||||||||||----XXXXXXXX X |||||||||||||||||||||||||||||||-----||||||||---    X  X XX  ---XXXXXXX XX XX --- X XX  XXX XXXX XX X ----- XXXXXX XXX  XX XF    