--------------------------------------------------------------------------------------------------------------------------------------------------------------------------------------------------------
--------------------------------------------------------------------------------------------------------------------------------------------------------------------------------------------------------
--------------------------------------------------------------------------------------------------------------------------------------------------------------------------------------------------------
--------------------------------------------------------------------------------------------------------------------------------------------------------------------------------------------------------
--------------------------------------------------------------------------------------------------------------------------------------------------------------------------------------------------------
--------------------------------------------------------------------------------------------------------------------------------------------------------------------------------------------------------
--------------------------------------------------------------------------------------------------------------------------------------------------------------------------------------------------------
-----------------------------------------------------------------------------------------------------------------------------------------U--------------------------------------------------------------
-----------------------------------------------------------------------------------------------------------------------------------------------------------------------g--------------------------------
-----------------------------------------------------------------------------------------------------------------------------------------------%%%%%%%%%------------------------------------------------
----------------------------------ggkggkgggggg-----------------------------------------------------------g-----------------------------------kgggkgkggggkg-----------%%%%%%%%%%%------------------------
--------------------------------r--||||||||||--------------------------------------------------------------------------------CSUC---%%%%%%%%%--|||||||||-------------|||||||||||------------------------
-------------------------%%%%%%%%--||||||||||-%%%%%%%%%%%%%-----%%%%%%%%%-----------------------g--g-----------%%%%%%%--------------|||||||||--|||||||||--%%%%%%%%%%%|||||||||||------%%%%%%------------
-------------------------||||||||--||||||||||-|||||||||||||-----|||||||||------------%%%%%%%%%%----------------|||||||--------------|||||||||--|||||||||--||||||||||||||||||||||------||||||------------
------%%%%%--------------||||||||%%%%%%%%%%%%%|||||||||||||-----|||||||||-----%%%----||||||||||%%%%%%%%%%------|||||||--------------|||||||||%%%%%%%%%%%%%||||||||||||||||||||||----%%%%%%%%%%----------
XXXXXX|||||XXXXXXXXXXXXXX||||||||||||||||||||||||||||||||||-----|||||||||-----|||----||||||||||||||||||||----XXXXXXXXXXXXXXXXXXXXXXX||||||||||||||||||||||||||||||||||||||||||||----||||||||||XXXX    XX