--------------------------------------------------------------------------------------------------------------------------------------------------------------------------------------------------------
--------------------------------------------------------------------------------------------------------------------------------------------------------------------------------------------------------
--------------------------------------------------------------------------------------------------------------------------------------------------------------------------------------------------------
--------------------------------------------------------------------------------------------------------------------------------------------------------------------------------------------------------
--------------------------------------------------------------------------------------------------------------------------------------------------------------------------------------------------------
--------------------------------------------------------------------------------------------------------------------------------------------------------------------------------------------------------
--------------------------------------------------------------------------------------------------------------------------------------------------------------------------------------------------------
--------------------------------------------------------------------------------------------------------------------------------------------------------------------------------------------------------
-------------------------------------------------------------S   CUCC2--% %  %%%%%%%--------------------------------kgkggggkr--------------------------------------r------------------------------------
------------------------------------------------------------------------||||||||||||------------------------------r--|||||||----------------------------------------------------------------------------
------------------------------------------------------S2UC2-------------||||||||||||------------------%%%%%%%%%%%%%--|||||||-  %%% %  % % %%%%% % %---------------------%%%%%%--------------------------
------------------------------------------------------------------------||||||||||||-----  %%%%%%%%%%%|||||||||||||--|||||||-||||||||||||||||||||||---------------------||||||-----CSC2 SSS --- % %%%F%%
------------------------------------------------------------------------||||||||||||-----|||||||||||||||||||||||||| %%%%%%%%%||||||||||||||||||||||---------------------|%%% %-----------------|||||| ||
-------------------------------------%%%% %%%%%-------------------------||||||||||||-----||||||||||||||||||||||||||||||||||||||||||||||||||||||||||---------------------||||||-----------------|||||||||
------%%%%%-------------------%%%----||||||||||%%%%% %%%%%%-------------||||||||||||-----||||||||||||||||||||||||||||||||||||||||||||||||||||||||||----%%%%%% % %%%---    %%%%% %--------------|||||||||
 XX XX|||||XXXXX XXXXXXXX-----|||----||||||||||||||||||||||XXXXXXXXXX XX||||||||||||-----||||||||||||||||||||||||||||||||||||||||||||||||||||||||||----||||||||||||---|||||||||||XXXXXXX XXX   |||||||||