--------------------------------------------------------------------------------------------------------------------------------------------------------------------------------------------------------
--------------------------------------------------------------------------------------------------------------------------------------------------------------------------------------------------------
--------------------------------------------------------------------------------------------------------------------------------------------------------------------------------------------------------
--------------------------------------------------------------------------------------------------------------------------------------------------------------------------------------------------------
--------------------------------------------------------------------------------------------------------------------------------------------------------------------------------------------------------
--------------------------------------------------------------------------------------------------------------------------------------------------------------------------------------------------------
--------------------------------------------------------------------------------------------------------------------------------------------------------------------------------------------------------
--------------------------------------------------------------------------------------------------------------------------------------------------------------------------------------------------------
---------------------------------------------------------------------------------------Tt-----------------------------------------------------------Tt--------------------------------------------------
---------------------------------------------------------------------------------------tt-----------------------------------------------------------tt--------------------------------------------------
------------------------------------------------------------------------Tt-------------tt-------------------------------------------------------Tt--tt--------------------------------------------------
-------G------------------------------------G--------K-----------G------tt-------------tt----------------------------------------- -------------tt--tt----------------------------USU2---T--------------
------%%%%%%%%%%----------------------------%%%-----%%%%%------G%%%%%%%%%t---G----%%%%%%%%%%%%-------------------%%%----%%%%%-----%-----------K-tt%%%%%%%%-------------------------------tt-------------
------||||||||||---------%%%%--%%%-------%%%|||-----|||||--SSSCS||||%%%%%%%%%%%---||||||||||||-------------------|||----|||||-----|---------%%%%%%%%%|||||-------------------------------tt-%%%%%%    S-
------||||||||||---------||||--|||-------||||||-----|||||-------|||%%%|||||||||---||||||||||||-------------------|||----|||||-----|---------||||||||||||||-----%%%%%%%%---------------%%%%%%%%%||||||---
XXXXXX||||||||||XXXXXXXXX||||--|||XXXXXXX||||||-----|||||XXXXXXXXXX|||XXXXXXXXXXXX||||||||||||XXXXXXXXXXXXXXXXXXX|||----|||||XXXXXXXXXXXXXXXXXXXXXXXXXXXXXXXXXX||||||||XXXXXXXXXXXXXXX|||||||||XXX    XX