------- -- --------------------------------------------------------------------------------------------------------------------------------------------------------------------- -----------------------
----------------------------------------------------------------------- -------------------------- ---------------------------- ------------------------------------------------------------------------
-------------------------------------------------------------------------------------------------------------------------------------------------------------------- -----------------------------------
----------------------------------------------- -------------------------------------------------------------------------------------------------------------------------- -----------------------------
-------------------------------------------------------------- ----------------------------------------- -------------------------------------------------------------------------- --------------------
-------------------------------------------------------------------------------------------------- -----------------------------------------------------------------------------------------------------
----------------------------------------------------------------------------------------------- -------------------------------------- ----------------------- -----------------------------------------
------------------------------------------------------------------------------------------------------------------------------------------------------------------------ -------------------------------
--------------------------------------------------------------------------------------------------- -----------------------------------------g----------------------------------------------------------
------------------------------------------------------------------------------------------------------------ -------------------------------------------------------------------------------------------
---------------------------------U------ ---------------g----g----g-------------------------------------------------------------------------%%%%%%%%--------------------------------USS2CC--------------
-------------------------------------gkkkkkkk-----------------g----g-------------------------%%%%%%%-------------------gggggggggg-----------|| |||||-----------------------------------------%%%%%%%%  %
---------------------------------------%%%%--------------------------------------------------|||||||-----------------g--||||||||------------||||||||-----------------------------------------||||||||%||
--------------------- -----------------|||| -%%%%%%%%%%-----%%%%%%%%------- -----------------|||||||----%%%%%%%%%%%%%%--||||||||-%%%%%%%%%%%||||||||-----------------------------------------|||||||||| 
------%%%%%---------- ---%%%%%%%%%%%%--||||--||||||||||-----||||||||----%%%%%%%%%%%%%%------XXXX||||----||||||||||||||--|||| |||-|||||||||||||||||||---%%%%%%%%%%%%%%-----%%%%%%%%%%%%%%%%%%%|||||||||||
XXXXXX|||||XXXXXXXXXXXXXX||||||||||||XXXXXXXX |||||||||-----|| |||||----||||||||||||||-----XXXXXXXXXXXXX||||||||||||||XXXXXXXXXXX|||||||||||||||||||---||||||||||||||-----||||||||||||||||||||||||||||||