--------------------------------------------------------------------------------------------------------------------------------------------------------------------------------------------------------
--------------------------------------------------------------------------------------------------------------------------------------------------------------------------------------------------------
--------------------------------------------------------------------------------------------------------------------------------------------------------------------------------------------------------
--------------------------------------------------------------------------------------------------------------------------------------------------------------------------------------------------------
--------------------------------------------------------------------------------------------------------------------------------------------------------------------------------------------------------
--------------------------------------------------------------------------------------------------------------------------------------------------------------------------------------------------------
--------------------------------------------------------------------------------------------------------------------------------------------------------------------------------------------------------
--------------------------------------------------------------------------------------------------------------------------------------------------------------------------------------------------------
-------------------------------------------------------------Tt--------------------------------------------------------------------------------------Tt-------------------------------------------------
------------------------------------------------------------- t-----------------------------------------------------Tt-------------------------------tt-------------------------------------------------
----------------------------------------------T -------------tt-----------------------------------------------------tt-------------------------------tt-------------------------------------------------
-------------------------------Tt-------------tt---------G--Kt ------------------------------------------------- KCUUt---------%%%F%%%  -------------tt-------------------------------------------------
-------------------------------tt----%%%%-----t --------%%% %%%%% %%-----------% %%%%%% %--------------------G--%%%%%%%%%% ----|||%|||||UU CUC----  %%%%%%-----K------------------------------------%%%%
-------------------------------t ----||||-K---tt-K------||||||||||||-----------||||||||||-------------%%%--%%%%%|||||||||||----|||||||||----------||||||||----S %%%-----%%%%%-----------------------||||
----------------------------% %%% %%%%||| %%% %%% %  ---||||||||||||-----------||||||||||-------------|||--||||||||||||||||----|||||||||----------||||||||------|||-----|||||-----------------------||||
 X   X XX      XXXXX  XXX X ||||||||||XXX||||||||||||XXXX  XX XX   XXXX  XXXXX ||||||||||X  X   XX XXX|||--|||||X X  XXXXX X X X X   X   XXXX  XXX     X XXX  XX|||-----|||||   XXX X XX XX      XXXXX  