--------------------------------------------------------------------------------------------------------------------------------------------------------------------------------------------------------
--------------------------------------------------------------------------------------------------------------------------------------------------------------------------------------------------------
--------------------------------------------------------------------------------------------------------------------------------------------------------------------------------------------------------
--------------------------------------------------------------------------------------------------------------------------------------------------------------------------------------------------------
--------------------------------------------------------------------------------------------------------------------------------------------------------------------------------------------------------
--------------------------------------------------------------------------------------------------------------------------------------------------------------------------------------------------------
--------------------------------------------------------------------------------------------------------------------------------------------------------------------------------------------------------
--------------------------------------------------------------------------------------------------------------------------------------------------------------------------------------------------------
-------------------------------------------Tt-----------------------------------------------------------------------------------------------------------------------------------------------------------
-------------------------------------------tt-----------------------------------------------------------------------------------------------------------------------------------------------------------
-------G--------------------------------K-Gtt---------------------------------------------------------------------------------------Tt------------------------------------------------------------------
-------%%%-----%-%--------------------%%%%%%%%%%-------------------------------------------------G-------------------------------- -tt------------------------------------------------------------------
-------|||---%%%%%%%%%%---------------||||||||||--------------------------------GK--------G----%%%%%%%%%--------------------------%-tt----------------------------------K----222US----------------------
-------|||%%%||||||||||---------------||||||||||------------------------------%%%%%-----%%%----|||||||||--------------------------|-tt-G--------SCU------------%%%%%%%%%%--%%%%%%%%%%----G--------------
-------||||||||||||||||---------------||||||||||------------------------------|||||-----|||----|||||||||-----------------------%%%%%%%%%%----------------------||||||||||--|||||||%%%%%%%%%-------------
XXXXXXXXXXXXX||||||||||XXXXXXXXXXXXXXXXXXXXXXXXXXXXXXXXXXXXXXXXXXXXXXXXXXXXXXX|||||-----|||XXXX|||||||||XXXXXXXXXXXXXXXXXXXXXXX||||||||||XXXXXXXXXXXXXXXXXXXXXXXXXXXXXXXXXXXXXXXXX|||||||||XXXXXXX    XX