----------------------------------------------------------------------------------------------- --------------------------------------------------------------------------------------------------------
-------------- ------------------------------------------------------------------------------ ----------------------------------------------------------------------------------------------------------
------------------------------------------------------------------------------------------------------ -------------------------------------------------------------------------------------------------
----------------------------------------------------------------- --------------------------------------------------------------------------------------------------------------------------------------
---------------------------------- -------------------------------- ------------------------------------------------------------- ----------------------------------------------------------------------
----------------------------------------------------------------------------- --------------------------------------------------------------------------------------------------------------------------
-------------------- --------------------------------------------------------------------------------------------------------------------------------------------------------------------------------- -
----------------------------------------------------------------------------- ---------%%%--------------------------------------------------------------------------------------------------------------
---------------------------------------------------------------------------------------|||--------------------------------------------------------------------------------------------------------------
---------------------------------------------------------------------------------------|||--------------------------------------------------------------------------------------------------------------
-------------------------------- ------------------ -------------------------------%%%%%%|--------------------------------------------------------------------------------------------------------------
----------------------------------------------------------------      -#-----------|||||||------------------------------------------------------------------------ -------------------------------------
--------------------------------------------%%%%--%%-------- ----%%%---%%%--------g|y|||||----------------%%%%%---%%%%%------------%%-- %%%%%%%%% %%%%%%%%%%%%%%%%%%%%%%%%%%%%%%%%%%%%%%%%%%%%%%%%%%%%%%
--------------#--#-----#---#----------------||||--||%%%%%---%%%%%|||---|||%%%%%%%%%%%%%%%%%%%-------- ----|||||---|||||------------||--||||||||||%||||||||||||||||||||||||||||||||||||||||||||||||||||||
------------%%%--%%%--##---# --- -----------||||--|||||||---||||||||---||||||||||||||||||||||%%%%%---%%%%%|||||---|||||------------||--||||||||||||||||||||||||||||||||||||||||||||||||| |||||||||||||||
XXXXXXXXXXXX|||--|||XXXX---XXXXXXXXX---X XXX||||--|||||||---||||||||---|||||||||||||||||||||||||||---||||||||||---| |||XXXXX--XXXXX|| -|||||||||||||||||||||||||||||| |||||||||||||||||||| |||||||||||||