--------------------------------------------------------------------------------------------------------------------------------------------------------------------------------------------------------
--------------------------------------------------------------------------------------------------------------------------------------------------------------------------------------------------------
--------------------------------------------------------------------------------------------------------------------------------------------------------------------------------------------------------
--------------------------------------------------------------------------------------------------------------------------------------------------------------------------------------------------------
--------------------------------------------------------------------------------------------------------------------------------------------------------------------------------------------------------
--------------------------------------------------------------------------------------------------------------------------------------------------------------------------------------------------------
--------------------------------------------------------------------------------------------------------------------------------------------------------------------------------------------------------
--------------------------------------------------------------------------------------------------------------------------------------------------------------------------------------------------------
--------------------------------------------------------------------------------------------------------------------------------------------------------------------------------------------------------
------------------------------------------------------------------------------------------------------------------------------------------------------------g-------------------------------------------
-------------------------------------------------------g--g-----------g-------------------------2SC-------------------%%%%%%%%--------------------------------------------------------------------------
------------------------------------gkkgggkg--------------------------------------------------kgggkggg----------------||||||||--------------------------------------------------------------------------
----------------------------------r--||||||-------------------------------------------------r-------------------------||||||||-------------------------------------------------------------%%%%%%%    %%
-------------------------%%%%%%%%%%--||||||-%%%%%%%%%%-----%%%%%%%%%%------------%%%%%%%%%%%%---------%%%%%%%%%%%-----||||||||------g-----------------tt-----------------------------------|||||||||| ||
------%%%%%--------------||||||||||--||||||-||||||||||-----||||||||||----%%%%%%%%||||||||||||---------|||||||||||---%%%%%%%%%%%%%%--------------------tt-----------------------------------|||||||||||||
XXXXXX|||||XXXXXXXXXXXXXX||||||||||XXXXXXXXX||||||||||-----||||||||||----||||||||||||||||||||XXXXXXXXX|||||||||||---||||||||||||||-----XXXXXXXXXXXXXXXXXXXX----XXXXXXXXXXXXXXXXXXXXXXXXXXXX|||||||||||||