--------------------------------------------------------------------------------------------------------------------------------------------------------------------------------------------------------
--------------------------------------------------------------------------------------------------------------------------------------------------------------------------------------------------------
--------------------------------------------------------------------------------------------------------------------------------------------------------------------------------------------------------
--------------------------------------------------------------------------------------------------------------------------------------------------------------------------------------------------------
--------------------------------------------------------------------------------------------------------------------------------------------------------------------------------------------------------
--------------------------------------------------------------------------------------------------------------------------------------------------------------------------------------------------------
--------------------------------------------------------------------------------------------------------------------------------------------------------------------------------------------------------
--------------------------------------------------------------------------------------------------------------------------------------------------------------------------------------------------------
--------------Tt----------------------------------------------------------------------------------------------------------------------------------------------------------------------------------------
--------------tt----------------------------------------------------------------------------------------------------------------------------------------------------------------------------------------
--------------tt----------------------G-----------------------------------------------------------------------------------------------------------------------------------------------------G-----------
--------------tt----------------------S2SCU2--------------------------------------------------------------------------------------F--------------------------------------------------------2SCSCC-----%%
-----------%%%%%%%%---------------G----------------%%%%%%---------------G---------------K-----------------------------------------%-------------------------------------------------------------------||
-----------||||||||------------%%%%----------------||||||-------%%%-----%%%%%----------%%%%----%%%%%------------------------------|--------------------------CU-UC-----UUCS2S----------------------F--||
-----------||||||||------%%%%%%%%||----------------||||||-------|||-----|||||----------||||----|||||------------------------------|--%%%%----%%%--------------------------------------------------- --||
XXXXXXXXXXXXXXXXXXXXXXXXX||||||||XXXXXXXXXXXXXXXXXX||||||XXXXXXX|||-----|||||XXXXXXXXXX||||----|||||XXXXXXXXXXXXXXXXXXXXXXXXXXXXXXXXX||||----|||XXXXXXXXXXXXXXXXXXXXXXXXXXXXXXXXXXXXXXXXXXXXXXXXXXXXXXXX