--------------------------------------------------------------------------------------------------------------------------------------------------------------------------------------------------------
--------------------------------------------------------------------------------------------------------------------------------------------------------------------------------------------------------
--------------------------------------------------------------------------------------------------------------------------------------------------------------------------------------------------------
--------------------------------------------------------------------------------------------------------------------------------------------------------------------------------------------------------
--------------------------------------------------------------------------------------------------------------------------------------------------------------------------------------------------------
--------------------------------------------------------------------------------------------------------------------------------------------------------------------------------------------------------
--------------------------------------------------------------------------------------------------------------------------------------------------------------------------------------------------------
--------------------------------------------------------------------------------------------------------------------------------------------------------------------------------------------------------
--------------------------------------------------------------------------------------------------------------------------------------------------------------------------------------------------------
--------------------------------------------------------------------------------------------------------------------------------------------------------------------------------------------------------
--------------------------------------------------------------------------------------------------------------------------------------------------------------------------------------------------------
-------------------------%%%%%-U2SUC-----------------------------%%%%-----------------------------Tt---------------------------%%%F%%%%%%%---------------------------------------------------%%%--------
--------------K----------|||||-----------------------------------||%%%%%%%%%----------------------tt---K-----------------------|||%|||||||------------------------------------------------%%%%||--------
------%%%--%%%%----------|||||----------%%%%%%-------------------|||||||||||--%%%----%%%%---------tt--%%%%%%%%%%---------------||||%%%|%%%-------------------K-------------%%%%%%%%%%-----||||||F-------
------|||--||||----------|||||----------||||||-------------------|||||||||||--|||----||||----%%%%%%%%%%%||||||||---------------|||||||%%%%%%%%%%%-----------%%%%%------%%%-||||||||||-----|||||| -------
XXXXXX|||--||||XXXXXXXXXXXXXXXXXXXXXXXXXXXXXXXXXXXXXXXXXXXXXXXXXXXX|||||||||XX|||----||||XXXX|||||||||||XXXXXXXXXXXXXXXXXXXXXXXXXXXXXX|||||||||||XXXXXXXXXXX|||||------|||X||||||||||XXXXXXXXXXXXXXXXXXX