--------------------------------------------------------------------------------------------------------------------------------------------------------------------------------------------------------
--------------------------------------------------------------------------------------------------------------------------------------------------------------------------------------------------------
--------------------------------------------------------------------------------------------------------------------------------------------------------------------------------------------------------
--------------------------------------------------------------------------------------------------------------------------------------------------------------------------------------------------------
--------------------------------------------------------------------------------------------------------------------------------------------------------------------------------------------------------
--------------------------------------------------------------------------------------------------------------------------------------------------------------------------------------------------------
--------------------------------------------------------------------------------------------------------------------------------------------------------------------------------------------------------
--------------------------------------------------------------------------------------------------------------------------------------------------------------------------------------------------------
--------------------------------------------------------------------------CCS SCC CUC2- %%%%%% %%%%%%-g----------------------U--------------------------------------------------------------------------
---------------------------------------------------------------------------------------||||||||||||||-------------------------------C2C2SS--------------------------------------------------------------
--------------------------------------------------------------------SCU2 S-------------||||||||||||||%%%%%%%%%%%%%--------------------------------------------------------------------------------------
---------------------------------------------------------------------------------------|||||||||||||||||||||||||||---------------kggkgggkkggr-----------------r-------------------k------ %%%% %% % %F%%
-------------------------------%% %%%%----------% %%%%% -------------------------------|||||||||||||||||||||||||||----- %%%%%%%%%--------------------------------------------------------||||||||||||%||
--------------------------g----|||||||-----g----||||||||-------------------------------|||||||||||||||||||||||||||-----||||||||||------------%%%%% % %%%%----%%%% %%%%-----------% %%% %%|||||||||||||||
------%% %%--------------------|XXX|||----------||||||||----%%%% %%% %%% --------------|||||||||||||||||||||||||||-----||||||||||------------||||||||||||----|||||||||-----------|||||||||||||||||||||||
 XXX  |||||XXXXXX XXXXXX ----XXX  XXXXXXXX----XX XXXXXXXXXXX|||||||||||||XX XXXXXXXX XX|||||||||||||||||||||||||||-----||||||||||XXX XXXXXXXX||||||||||||----||||||||| X XXXXXXXX|||||||||||||||||||||||