--------------------------------------------------------------------------------------------------------------------------------------------------------------------------------------------------------
--------------------------------------------------------------------------------------------------------------------------------------------------------------------------------------------------------
--------------------------------------------------------------------------------------------------------------------------------------------------------------------------------------------------------
--------------------------------------------------------------------------------------------------------------------------------------------------------------------------------------------------------
--------------------------------------------------------------------------------------------------------------------------------------------------------------------------------------------------------
--------------------------------------------------------------------------------------------------------------------------------------------------------------------------------------------------------
--------------------------------------------------------------------------------------------------------------------------------------------------------------------------------------------------------
--------------------------------------------------------------------------------------------------------------------------------------------------------------------------------------------------------
----------------------------%%%-------------------------------------------------------------------------------------------------------------------------------------------------------------------------
----------------------------|||-------------------------------------------------------------------------------------------------------------------------------------------------------------------------
----------------------------|||------------SCS-------------tt----------#--#-------------CUCC------------------------------------------------%%%---------------------------------------------------------
----------------------------rY|---------------------------- t--- t----##--##----------------------------------------------------------------|||---------------------------------------------------------
----------------%%%%%%%%%%%%% %%%------k--%----------------tt---tt--%%%%--%%%%%%--%%--------%-----#--#------------------------ %-- %--------|||---r-%%%%%%%%F %%%%%%%%%%% %%%%%%%%%%%%%%%%%%%% %%%%% %%%
----------%%--%%|||||||||||||||||%%%%%%%%-|---Y-%%%--%%%%%% %%%%% %%||||--||||||--||---k--k-|----##--##-----------------------||--||%%%%% %%%%  %%%%||||||||%|||||||||||||||||||||||||||||||||||||||||||
----------||--||||||||||||||||||||||||||| %%%%%%|||--|||||||||||||||||||--||||||--||%%%%%%%%%%--# #-- ##----------------------||--||||||||||||||||||||||||||||||||||||||||||||||||||||||||||||||||||||||
 XXXXXX XX||--|||||||||||||||||||||||||||||||||||||--|||||||||||||||||||--||||||--||||||||||||XXX  --XXXX XXXXX--- XXXXXX---XX||--||||||||||||||||||||||||||||||||||||||||||||||||||||||||||||||||||||||