------------------------------------------------------------------------------------------------------------------------------------------------------------------------------ --------------- ---------
----------------------------------- -------------------------------- ------------ --------------------------------------------------------------------------------------------- ----------- --------- --
--- --------------------------------- ------------------------------------------------------------------------------------------------------------------------------------------------------------------
-------------------------------------------------  ------------------------------ ------ -- ------------------------------------------------------------------------------------------------------------
----------------------------------------------------------------------------------------------------------------------- ----- ----- --------------- ----------------------------------------------------
---------------------------------------------------------------- ---------------------------------- ----------------------------------------------------------------------------------------------------
---------- ------------------ --------- --------------- - --------------------------------------- ------------------------------------------------------------------ -------- --------------------------
------------------------ ------------------------------------------------------------------------------------------------- -----------------------------------------------------------------------------
---------- -------------- ----------- ------------ -------------- -------------------- ------------------------       ----------------------------------------------------------------------------------
---------------------------------------------------------------------------- ----------- -------------------------------------------------------------- ------------------------------------------------
---------------------------------------------------------------- -----------------------------------  --------------------- ---------------------------------- -------------------------------------- --
---------------------------------------gggggggkggk------- --------------------------- - ----------------ggkkgggg-------------------------------------------------- -------------------------------------
--------------------------- ------------%%% %%%%%------------------------ -------------------------------- %%%----------------------% %%%---------------------------------------------------------------
-------- -------- ----- -------------r-- ||||||||-    % %%%     ----g-----g--------g------g---------------||||--%%%   %% % %%%-----% % % ----------------g----g----------g---kk-------------------------
------% %%%--------------%%%%%%% % %% --|||||||||- |||||||||||||---------------------------%%%% % %  %  --||||--||||||||||||||-----||||||---------------------------------------------------------------
 X XXX|||||  X  XXXXXX XX|||||||||||||XX  XXX XX  ||||||||||||||---XX XXX  XX ----X  XXXXX |||||||||||||XXX XXXX||||||||||||||---XX X  X    --- XXX X   - - XX  X  X XXXX X X X XXX X--- XXX XX X   XF  