--------------------------------------------------------------------------------------------------------------------------------------------------------------------------------------------------------
--------------------------------------------------------------------------------------------------------------------------------------------------------------------------------------------------------
--------------------------------------------------------------------------------------------------------------------------------------------------------------------------------------------------------
--------------------------------------------------------------------------------------------------------------------------------------------------------------------------------------------------------
--------------------------------------------------------------------------------------------------------------------------------------------------------------------------------------------------------
--------------------------------------------------------------------------------------------------------------------------------------------------------------------------------------------------------
--------------------------------------------------------------------------------------------------------------------------------------------------------------------------------------------------------
------------------  ------------------------------------------------------------------------------------------------------------------------------------------------------------------------------------
------------------ t------------------------------------------------------------------------------------------------------------------------------------------------------------------------------------
------------------tt------------------------------------------------------------------------------------------------------------------------------------------------------------------------------------
------------------t ------------K--------------------------------Tt-------------------------------------------------------------------------------------------------------------------------------------
--------------%% %%%%%%----U2CS2UU-------------------------------tt---------------------------------------------------------------F---------------------------%%%%% %%% ----------------------%%% %%%%%%
--------------|||||||||------------------------------------------tt--------------------------------G------------------------------%---------------------------||||||||||--%%%%%--------------K||||||||||
-----------SSSS222|||||------------------------------------------tt-G--------------%%%%%%K%KG-----%%%%--%%%%----------------------|-------G-------------------||||||||||--|||||---%%%%%%%%%%% ||||||||||
--------------|||||||||--------------------------------------%%%%%%%%%%------------|||||%%%%%%----||||--||||----------------------|------ %%%%----% %---------||||||||||--|||||---||||||||||||||||||||||
 XXXXXXX XXXX XXXXXXXXXXXXX XXXX  XXXX XX XXXXXXXXXXXXXXXXX X||||||||||XXXXXXXXXXX  XX  ||||||XXXX||||--||||XXXXXXXXX XXXXXXX XXXXXX X XX|||||----|||XXXXXXXXXXXX  XXXXXXXXXXXXX XXXXXXXX XXXXXXXXXXXXXX