-------------------------------------------- ----------------------------- -- ------------------ ------------------------- ------- ---------------------------------------------------------------------
------------------------------------------------------------------------------------------------- --------------------------------------------- --------------------------------------------------------
--------------------------------------------------------------------------------------- -------------------------------------------------------------------------------------------------- -------------
-------------------- ----------------------------------------------------------------------------------------------- ----------------------------------------------------------------------------- -----
----------------------- - ------------------------------------------------------------------------------------------------------------------------------------ ------------- ---------------------------
----------------------------------------------------------------------------------------------- ------------------------------------------------------- --- --------------------------------------------
-------------------------------------------------------------------------------------------------------------------------- -----------------------------------------------------------------------------
------------------------------------------------------------------------------------------------------------- ---- -------------------------------------------- ----------------------------------------
--------- -----------------------------------------------------------Tt---------------------------------------------------------------------------------------------------------- ------------------ ---
-------------Tt--------------------------- ------------ Tt-------- --tt---------------- --------------------------------------------------------------- -------- ---------------------------------------
-------------tt-------------------------------- --------tt-----------tt--------------- ------------------------------------------------------------------ -- ----------------------- ------------- -----
-------------tt---------------------------K------------ tt----------- t-----------------------------------------------------------F-------C 2 2S------------------------------ ---------U2S--UU2S-------
---------%%%%%%%%%--------------%%%%%----% %%%-------%%%%%%%%%%2%% %%%%%%%%------------- -----------%%%%--G--%%%%% ---------------G--------------------------------- ---------CGSU------K---- -- -------
---------|||||||||--------------|||||----|||||-------||||||||||-|||||||||||- ----------------2CS %%%||||--%%%| ||||%%% ------ %%%2CSS---------------- -- % ---%%%%%-----------%%%%%%% %%%-----------%%  
---------|||||||||-----%%%--- % |||||----|||||---- --||||||||||-|||||||| ||---------%%%---%%%---||||||||--|||||||| ||||------| ||-----------------------|||---|||||-----------|||||||||||-----------||||
  XXXXXXXXXXXXXX XXXX X|||---||||||||----||||| XXX XX||||||||||X|||||||||||XXXXXXX X|||---|||XXXX XXXXXXX   X||||||||||------||||XXXX  XXXX XX XXXXXX X |||---|||||X XXX XX  XX XXX    X X XXXX  XXX||||