--------------------------------  ---------------------------------------------------------------------------------------------- -----------------------------------------------------------------------
------------------------------- ---------------------------------- -- --------- ---------------------------------------------------------- ------------------------------------- --------------------- -
---------------------------------------------------------------------------------------------------------------------------------------------------- -------------------------------------------------- 
----------------------------------------------------------------------------------------------------------------------------------------------------- ------------- ------------------------------------
------------------------------------------- ------------------------------------------------------------------- ----------------------------- ----------------------------- ----------------- ----------
--------------------------------------------------------------------------------------------------------------------------------------------------------------------------------------------------- ----
------------------------------------- --------------------------------------------------------------------------------------------------- --------------------------------------------------------- ----
 ------------------------------------------------------------------------------------------------------- ---------------------------------------------------------------------------------------------- 
----------------------------------------------------------g---------------------------------------------------------------------------------------------------------------------------------------------
-----------------------------------CCU2SSSCS %%%%%%%%%%%%------------------------------U----------------- ----g---------g------------------------------------------- -------------- --------------------
---------------------- ------------------- --||||||||||||------------------------------------------------------------------------------------- ---------------------------------------------------------
------------------------------USS------------||||||||||||--------------------------- ------kggggkggg------------------------SSS2CSSS----2C2SS SSC --g---k--------r--------------------------------------
------------------- -------------------------| ||||||||||-----%%%%%%%%%%%%-------------------|||||-------------------------- ---------------------------------------------------------------------------
---------------------------------------------||||||||||||-----||||||||||||---%%%%%%%%%%%%%%--|||||--%%%%%%%%%------------------------- --------------------------------%%%%%------k-r--------k ---------
------%%%%%----------------------------------||||||||||||-----||||||||||||---||||||| ||||||--|||||--|||||||| ----------------------------------------------------------|||||---- ------------ ----------
 X X X|||||XX    XXX XX X   X XX XX XXX XXXX ||||||||||||-----||||||||||||---|||||||||||||| X XXXXXX|||||||||---X X  XXXX  XX  XXXXX XX    XXXX   X----X X XX  X----- XX XXX ----XXXXXXXX   X X X X  FX 