--------------------------------------------------------------------------------------------------------------------------------------------------------------------------------------------------------
--------------------------------------------------------------------------------------------------------------------------------------------------------------------------------------------------------
--------------------------------------------------------------------------------------------------------------------------------------------------------------------------------------------------------
--------------------------------------------------------------------------------------------------------------------------------------------------------------------------------------------------------
--------------------------------------------------------------------------------------------------------------------------------------------------------------------------------------------------------
--------------------------------------------------------------------------------------------------------------------------------------------------------------------------------------------------------
--------------------------------------------------------------------------------------------------------------------------------------------------------------------------------------------------------
----------------------------------------------------------------------------------------------------------------------------------------------------------------------------------------------------- t-
-------------------------------------------------------------------Tt-------------------------------------------------------------------------------------------------------------------------------- t-
-------------------------------------------------------------------tt-------------------------------------------------------------------------------------------------------------------------------- t-
-------------------------------------------------------------------tt--------------------------------------------------------------------------------------------------------------------Tt---------- t-
-------------------------------------------------------------------tt----------------------------------------------------US------- -------------------------------G----------------------tt------%    %%
---------------------------------------------------------------%%%%%%%%%----------------------%%%%%%----------%%%---%%%-----------%--------G---------------------%%%%%%%%K%%-----------K-tt------|||||||
------------------G----------------S2CU2U2---------------------|||||||||--------------%%%--%%%||||||----------|||---|||--------%%%%%-----%%%%%------G------------||||||%%%%%%%%%%%%%%%%%-tt------|||| %%
------------------%%%%%--%%%%%----------------%%%%--%%%%%------|||||||||--------------|||--|||||||||----------|||---|||--------|||||-----|||||-----%%%%%--%%%%%--|||||||||||||||||||||%%%%%%%%---|||||||
XXXXXXXXXXXXXXXXXX|||||--|||||XXXXXXXXXXXXXXXX||||--|||||XXXXXX|||||||||XXXXXXXXXXXXXX|||--|||XXXXXXXXXXXXXXXX|||---|||XXXXXXXX|||||-----|||||XXXXX|||||--|||||XXXXXXXXXXXXXXXXXXXXXXX||||||||XXXX   |||