--------------------------------------------------------------------------------------------------------------------------------------------------------------------------------------------------------
--------------------------------------------------------------------------------------------------------------------------------------------------------------------------------------------------------
--------------------------------------------------------------------------------------------------------------------------------------------------------------------------------------------------------
--------------------------------------------------------------------------------------------------------------------------------------------------------------------------------------------------------
--------------------------------------------------------------------------------------------------------------------------------------------------------------------------------------------------------
--------------------------------------------------------------------------------------------------------------------------------------------------------------------------------------------------------
--------------------------------------------------------------------------------------------------------------------------------------------------------------------------------------------------------
--------------------------------------------------------------------------------------------------------------------------------------------------------------------------------------------------------
------------------------------------------------------------g-------------------------------------------------------------------------------------------------------------------------------------------
----------------------------------------------------------------------------------------------------------------------g-------------------------------------------------gg------------------------------
----------------------------------U------------------------------------------------------------------------------------------------------------------------------------------------%%%%%%%%%%%%%%-------
--------------------------------------ggkggkgk-----------------%%%%%%--------------ggggggkkkgg-------------%%%%%%%---------%%%%%-----------------%%%%%%%%%%---2SUSSSS---%%%%%%%%%%%||||||||||||||-------
----------------------------------------%%%%-------------------||||||------------r--|||||||||--------------|||||||---------|||||-----------------||||||||||-------------|||||||||||||||||||||||||%    %%
----------------------------------------||||--%%%%%%%%%%%%-----|%%%%|--%%%%%%%%%%%--|||||||||-%%%%%%%%-----|||||||--------%%%%%%%---g-------tt---||||||||||-------------||||||||||||||||||||||||||||| ||
------%%%%%-----------------%%%%%%%%%%--||||--||||||||||||-----||||||--|||||||||||--|||||||||-||||||||-----|||||||--------|||||||-----------tt---||||||||||-------------||||||||||||||||||||||||||||||||
XXXXXX|||||XXXXXXXXXXXXXX---||||||||||XXXXXXXX||||||||||||---XXXXXXXXXX|||||||||||XXXXXXXXXXXX||||||||---XXXXXXXXXXXX---XXXXXXXXXXXX---XXXXXXXXXX||||||||||XXXXXXXXXXXXX||||||||||||||||||||||||||||||||