-----------------------------------------------------------------------------------------------------------------------------------------------     ----------------------------------------------------
-----------------------------------------------------------------------------------------------------------------------------------------------     ----------------------------------------------------
-----------------------------------------------------------------------------------------------------------------------------------------------     ----------------------------------------------------
-----------------------------------------------------------------------------------------------------------------------------------------------     ----------------------------------------------------
-----------------------------------------------------------------------------------------------------------------------------------------------     ----------------------------------------------------
-----------------------------------------------------------------------------------------------------------------------------------------------     ----------------------------------------------------
-----------------------------------------------------------------------------------------------------------------------------------------------     ----------------------------------------------------
---------------------------------------------------------------------------------------%%%-----------------------------------------------------     ----------------------------------------------------
---------------------------------------------------------------------------------------|||-----------------------------------------------------     ----------------------------------------------------
---------------------------------------------------------------------------------------|||-----------------------------------------------------     ----------------------------------------------------
-----------------------------------------------------------------------------------%%%%%%|-----------------------------------------------------     ----------------------------------------------------
-------------------------------------------------------------------#---#-----------|||||||-----------------------------------------------------     ----------------------------------------------------
--------------------------------------------%%%%--%%-------------%%%---%%%--------g|y|||||----------------%%%%%---%%%%%------------%%--%%%%%%%%     %%%%%%%%%%%%%%%%%%%%%%%%%%%%%%%%%%%%%%%%%%%%%%%%%%%%
--------------#--#-----#---#----------------||||--||%%%%%---%%%%%|||---|||%%%%%%%%%%%%%%%%%%%-------------|||||---|||||------------||--||||||||     ||||||||||||||||||||||||||||||||||||||||||||||||||||
------------%%%--%%%--##---##---------------||||--|||||||---||||||||---||||||||||||||||||||||%%%%%---%%%%%|||||---|||||------------||--||||||||     ||||||||||||||||||||||||||||||||||||||||||||||||||||
XXXXXXXXXXXX|||--|||XXXX---XXXXXXXXX---XXXXX||||--|||||||---||||||||---|||||||||||||||||||||||||||---||||||||||---|||||XXXXX--XXXXX||--||||||||     ||||||||||||||||||||||||||||||||||||||||||||||||||||