-----------------------------------------------------------------------------------------------------------------------------       --------------------------------------------------------------------
-----------------------------------------------------------------------------------------------------------------------------       --------------------------------------------------------------------
-----------------------------------------------------------------------------------------------------------------------------       --------------------------------------------------------------------
-----------------------------------------------------------------------------------------------------------------------------       --------------------------------------------------------------------
-----------------------------------------------------------------------------------------------------------------------------       --------------------------------------------------------------------
-----------------------------------------------------------------------------------------------------------------------------       --------------------------------------------------------------------
-----------------------------------------------------------------------------------------------------------------------------       --------------------------------------------------------------------
-----------------------------------------------------------------------------------------------------------------------------       --------------------------------------------------------------------
-----------------------------------------------------------------------------------------------------------------------------       --------------------------------------------------------------------
-----------------------------Tt----------------------------------------------------------------------------------------------       --------------------------------------------------------------------
-----------------------------tt----------------------------------Tt----------------------------------------------G-----------       --------------------------------------------------------------------
-----------------------------tt--------Tt------------------------tt-------------------------G-2-----------------%%-%---------       ----------------------------------G---------------------------------
-------------------------%%%%%%%%%%----tt--------------------G---tt-G--------------%%%%%%%%%%%------------------||-|---------       -------------------G-------------%%%%----%%%%-----------------------
-------------------------||||||||||%%%%tt-------------------%%%%%%%%%%%%-----------|||||||||||--------%%%%%%%%%%%|-|-------%%       ---------------%%%%%%------------||||----||||-----------------------
-------%%%%%%%%%%--------|||||||||||%%%%%%%%%---------------||||||||||||-----------|||||||||||--------|||||||||%%%%%%%%----||       ---------------||||||------------||||----||||-----------------------
XXXXXXX||||||||||XXXXXXXX||||||||||X|||||||||XXXXXXXXXXXXXXX||||||||||||XXXXXXXXXXX|||||||||||XXXXXXXXXXXXXXXXX||||||||XXXXXX       XXXXXXXXXXXXXXXXXXXXXXXXXXXXXXXXX||||----||||XXXXXXXXXXXXXXXXXXXXXXX