--------------------------------------------------------------------------------------------------------------------------------------------------------------------------------------------------------
--------------------------------------------------------------------------------------------------------------------------------------------------------------------------------------------------------
--------------------------------------------------------------------------------------------------------------------------------------------------------------------------------------------------------
--------------------------------------------------------------------------------------------------------------------------------------------------------------------------------------------------------
--------------------------------------------------------------------------------------------------------------------------------------------------------------------------------------------------------
--------------------------------------------------------------------------------------------------------------------------------------------------------------------------------------------------------
--------------------------------------------------------------------------------------------------------------------------------------------------------------------------------------------------------
--------------------------------------------------------------------------------------------------------------------------------------------------------------------------------------------------------
--------------------------------------------------------------------------------------------------------------------------------------------------------------------------------------------------------
--------------------------------------------------------------------------------------------------------------------------------------------------------------------------------------------------------
----------------------------------------------------------------------------------------------------------------------------------2C--------------------------------------------------------------------
--------------------------g---------------------%%%%%%-----------------------------------------%%%%%%%------UCCSSSC-------------kggkkkk-----------------------------2CSCCCSSC---------k-----------------
------------------------------------------------||||||---------------gg----g-------------------|||||||------------------------r-------------------------------------------------------------------------
------------------------------------tt----------||||||---gg------------------------------------|||||||---------------%%%%%%%%%%--------%%%%%%%%%%%%----------------------------%%%%%%%%%%%--------------
------%%%%%-------------------------tt----------||||||--------------%%%%%%%%-----%%%%%%%%%%%%--|||||||---------------||||||||||--------||||||||||||----------------------------|||||||||||--------------
XXXXXX|||||XXXXXXXXXXXXXX-----XXXXXXXXXXXXX---XXXXXXXXXX----XXXXXXXX||||||||-----||||||||||||XXXXXXXXXXXXXXXXXXXXXXXX||||||||||XXXXXXXX||||||||||||----XXXXXXXXXXXXXXXXXXXXXXXX|||||||||||XXXXXXXX    XX