--------------------------------------------------------------------------------------------------------------------------------------------------------------------------------------------------------
--------------------------------------------------------------------------------------------------------------------------------------------------------------------------------------------------------
------------------------------------------------------------------------------------------------------------------------------------------------------------------------SS------------------------------
--------------------------------------------------------------------------------------------------------------------------------------------------------------------------------------------------------
--------------------------------------------------------------------------------------------------------------------------------------------------------------------------------------------------------
--------------------------------------------------------------------------------------------------------------------------------------------------------------------------------------------------------
----------------------------------------------------------------------------------------------------------------------------------------------------------------------%%%%%-----------------------------
------------------------------------------------------------------------------------U--------------------------------------------------------------------------------%%%%%|-----------------------------
------------------------------------------------------------------------------------------------------------------------------------------------------------------g--||||||-----------------------------
--------------------------------------gggggggk--------------------------------------------%%%%%%%%---------------------g-------------------CSSSSU--%%%%%%%%%%%-------||||||-----------------------------
------------------------------------r--||||||-------------------g-----------------------kkgggkggggkg-----------------------------------------------|||||||||||-----%%%%%%%%%%%%%%%%%%%%-----------------
-------------------------%%%%%%%%%%%%--||||||-%%%%%%%%%%%%----------------%%%%%%%%%%%%%%--||||||||-------------------%%%%%---------USSSCSC---------|||||||||||-----||||||||||||||||||||----%%%%%%%    %%
-------------------------||||||||||||--||||||-||||||||||||-----%%%%%%%%%%%||||||||||||||--||||||||--%%%%%%%%%%-------|||||-------------------------|||||||||||-----||||||||||||||||||||-r--|||||||||| ||
-------------------------||||||||||||%%%%%%%%%||||||||||||-----|||||||||||||||||||||||||--||||||||--||||||||||-----%%%%%%%%%-----------------------|||||||||||-----||||||||||||||||||||----|||||||||||||
------%%%%%--------------|||||||||||||||||||||||||||||||||-----|||||||||||||||||||||||||%%%%%%%%%%%%||||||||||-----|||||||||-----------------------|||||||||||-----||||||||||||||||||||----|||||||||||||
XXXXXX|||||XXXXXXXXXXXXXX|||||||||||||||||||||||||||||||||-----|||||||||||||||||||||||||||||||||||||||||||||||-----|||||||||XXXXXXXXXXXXXXXXXXXXXXX|||||||||||-----||||||||||||||||||||----|||||||||||||