--------------------------------------------------------------------------------------------------------------------------------------------------------------------------------------------------------
--------------------------------------------------------------------------------------------------------------------------------------------------------------------------------------------------------
--------------------------------------------------------------------------------------------------------------------------------------------------------------------------------------------------------
--------------------------------------------------------------------------------------------------------------------------------------------------------------------------------------------------------
--------------------------------------------------------------------------------------------------------------------------------------------------------------------------------------------------------
--------------------------------------------------------------------------------------------------------------------------------------------------------------------------------------------------------
--------------------------------------------------------------------------------------------------------------------------------------------------------------------------------------------------------
----------------------------------------------------------------------------------------------------------------------------------------------------------------Tt--------------------------------------
----------------------------------------------------------------------------------------------------------------------------------------------------------------tt--------------------------------------
-----------------------------------------Tt---------------------------------------------------------------------------------------------------------------------tt-------------------Tt-----------------
-----------------------------------------tt---------------------------------------------------------------------------------------------------------------------tt-------------------tt-----------------
----------------K------------------------tt-22C---------------------------------------------G------------------------------------- --------------------------%%%%%%%%----------------tt--G--------------
--------------%%%%--%%%------------------tt------------------------------------------%%%%%%%%%%-------------G----------G----------%----------G---%%%%--%%%---||||||||-------------%%%%%%%%%%------------
--------------||||--|||SCC-----------%%%%%%%%%%%------------------U22--------K-G-----||||||||||-------------%%%%-----%%%%%CC------|---------%%%%%||||--|||---||||||||-------------||||||||||------------
--------------||||--|||--------------|||||||||||--------%%%---%%%----------%%%%%%%%%%%|||||||||-%%%---------||||-----|||||--------|---------|||||||||--|||---||||||||-------------||||||||||------------
XXXXXXXXXXXXXX||||--|||XXXXXXXXXXXXXXXXXXXXXXXXXXXXXXXXX|||---|||XXXXXXXXXX|||||||||||XXXXXXXXXX|||XXXXXXXXX||||-----|||||XXXXXXXXXXXXXXXXXXXXXXX||||--|||XXXXXXXXXXXXXXXXXXXXXXXXXXXXXXXXXXXXXXXX    XX