--------------------------------------------------------------------------------------------------------------------------------------------------------------------------------------------------------
--------------------------------------------------------------------------------------------------------------------------------------------------------------------------------------------------------
--------------------------------------------------------------------------------------------------------------------------------------------------------------------------------------------------------
--------------------------------------------------------------------------------------------------------------------------------------------------------------------------------------------------------
--------------------------------------------------------------------------------------------------------------------------------------------------------------------------------------------------------
--------------------------------------------------------------------------------------------------------------------------------------------------------------------------------------------------------
-----------------------------------------------------------------------------------------------------------------SCCUCSSSS-%%%%%%%%%%%%---------------------------------------C2SS2CC-------------------
---------------------------------------------------------------------------------------------------------------------------||||||||||||-----------------------------------------------------------------
-----------------------------------------------------------------------------------------------------------CCSU------------||||||||||||-----------------------------------------------------------------
----------------------------------------------------k----------------------------------------------------------------------||||||||||||-----------------------------------------------------------------
----------r-r-r-r----------------------------------------------------------------------------------------------------------||||||||||||-----%%%%%%%%%%%%%%----%%%%%%%%%%%%%%%%%%%%%%%%%%%%%%%%%%%%    %%
------------------------------------------------------------------------%%%%%%%-----------------SSS------------------------||||||||||||-----||||||||||||||----||||||||||||||||||||||||||||||||||||||| ||
------------------------------------------------------------------------|||||||-----------------------%%%%%%%%%%-----------||||||||||||-----||||||||||||||----||||||||||||||||||||||||||||||||||||||||||
-------------------------------------------------------%%%%%%%-----r----|||||||----r------------------||||||||||%%%%%%%%%%%||||||||||||-----||||||||||||||----||||||||||||||||||||||||||||||||||||||||||
------%%%%%-------------------%%%----%%%%%%%%%%%-------|||||||----------|||||||-----------------------|||||||||||||||||||||||||||||||||-----||||||||||||||----||||||||||||||||||||||||||||||||||||||||||
XXXXXX|||||XXXXXXXXXXXXXX-----|||----|||||||||||-----XXXXXXXXXXXXX----XXXXXXXXXXXXXXXXXXXXXXXXXXXXXXXX|||||||||||||||||||||||||||||||||-----||||||||||||||----||||||||||||||||||||||||||||||||||||||||||