--------------------------------------------------------------------------------------------------------------------------------------------------------------------------------------------------------
--------------------------------------------------------------------------------------------------------------------------------------------------------------------------------------------------------
--------------------------------------------------------------------------------------------------------------------------------------------------------------------------------------------------------
--------------------------------------------------------------------------------------------------------------------------------------------------------------------------------------------------------
--------------------------------------------------------------------------------------------------------------------------------------------------------------------------------------------------------
--------------------------------------------------------------------------------------------------------------------------------------------------------------------------------------------------------
--------------------------------------------------------------------------------------------------------------------------------------------------------------------------------------------------------
---------------------------------------------Tt---------------------------------------------------------------------------------------------------------------------------------------------------------
---------------------------------------------tt---------------------------------------------------------------------------------------------------------------------------------------------------------
---------------------------------Tt----------tt---------------------------------------------------------------------------------------------------------------------------------------------------------
---------------------------------tt----------tt---------------------------------------------------------------------------------------------------------------------------------------------------------
---------------------------------tt%G----%%%%%%%%%%----------------------------------------USSUC-----------------K------------G---F---------------------------------------------------------------------
-----------------------------%%%%%%%%%---|||||||%%%%%%%%%-----------------------------------------------G----G---%%%---------%%%%%%%%%%-----------------------------------------------------------------
-----------------------------|||||||||---||||||||||||||||---G---------G------------------------------%%%%%-UU2U2U|||---------||||||||||-------------K----------------------------------------------F----
-----------------------------|||||||||---||||||||||||||||--%%%%------%%%%%---------------------------|||||-------|||---------||||||||||------%%%%---%%%------------------------------------%%%%---- ----
XXXXXXXXXXXXXXXXXXXXXXXXXXXXX|||||||||XXXXXXXXXXXXXXXXXXXXX||||------|||||XXXXXXXXXXXXXXXXXXXXXXXXXXX|||||XXXXXXXXXXXXXXXXXXX||||||||||XXXXXX||||---|||XXXXXXXXXXXXXXXXXXXXXXXXXXXXXXXXXXXX||||XXXXXXXXX