----------------------------------------------------------------------------------------------------------------------------------      ----------------------------------------------------------------
----------------------------------------------------------------------------------------------------------------------------------      ----------------------------------------------------------------
----------------------------------------------------------------------------------------------------------------------------------      ----------------------------------------------------------------
----------------------------------------------------------------------------------------------------------------------------------      ----------------------------------------------------------------
----------------------------------------------------------------------------------------------------------------------------------      ----------------------------------------------------------------
----------------------------------------------------------------------------------------------------------------------------------      ----------------------------------------------------------------
----------------------------------------------------------------------------------------------------------------------------------      ----------------------------------------------------------------
----------------------------------------------------------------------------------------------------------------------------------      ----------------------------------------------------------------
----------------------------------------------------------------------------------------------------------------------------------      ----------------------------------------------------------------
---------------------------------------------------------------------------------------------------------------------------Tt-----      ----------------------------------------------------------------
---------------------------------------------------------------------------------------------------------------------------tt-----      ----------------------------------------------------------------
--------------------K----------------------------------------------G----------G------------------%%%%%---------------------tt-----      ----------%%%%Tt%%%%----K---------------------------------------
------------%%%-%%%%%%%----------------------------------%%%--%%%%%%%--------%%%%----------------|||||---------------------tt-----      ----------||||tt||||----UC2U22----%%%%%K---------C%%%%%%%%%%----
------------K||-|||||||------------------------------%%%-|||--|||||||--------||||--%%%%%------%%%|||||--------K--------%%%%%%%%%--      ----------|%%%%%%%%|--------------|||||%%%%%--%%%-||||||||||----
-----------%%%%%%%%%%%|----------------%%%%%%%%%%----|||-|||--|||||||--------||||--|||||------||||||||----%%%%%--------|||||||||--      ----------||||||||||--------------||||||||||--|||-||||||||||----
XXXXXXXXXXX|||||||||||XXXXXXXXXXXXXXXXX||||||||||XXXX|||X|||--|||XXXXXXXXXXXX||||XX|||||------|||XXXXXXXXX|||||XXXXXXXX|||||||||XX      XXXXXXXXXXXXXXXXXXXXXXXXXXXXXXXXXXXXXXX|||||--|||X||||||||||XXXX