--------------------------------------------------------------------------------------------------------------------------------------------------------------------------------------------------------
--------------------------------------------------------------------------------------------------------------------------------------------------------------------------------------------------------
--------------------------------------------------------------------------------------------------------------------------------------------------------------------------------------------------------
--------------------------------------------------------------------------------------------------------------------------------------------------------------------------------------------------------
--------------------------------------------------------------------------------------------------------------------------------------------------------------------------------------------------------
--------------------------------------------------------------------------------------------------------------------------------------------------------------------------------------------------------
--------------------------------------------------------------------------------------------------------------------------------------------------------------------------------------------------------
--------------------------------------------------------------------------------------------------------------------------------------------------------------------------------------------------------
---------------------------------------------------------------------------------------------------------------------k----------------------------------------------------------------------------------
------------------------------------------------------------------------------------------------SSCCUSCSS-%%%%%%%%%%-------------------------------------------------------------------r-------k--k-----
---------------------------------------------------------gg----g------------------------------------------||||||||||----%%%%%%%%%%%%--------------------------------------------------------------------
------------------------------------------------------------------------------------------SSUCCC----------||||||||||----||||||||||||-------------------------------------%%%%%%%%%%%%%------------------
----------------------------------------------------------------------------%%%%%-------------------------||||||||||----||||||||||||-----k-------r-----------------------|||||||||||||------------------
-------------------------g------%%%%%%%%-----gg--------g--------------g-----||||k-------------------------||||||||||----||||||||||||-------------------------------------|||||||||||||-------------F----
------%%%%%---------------------||||||||------------------------------------|XXXX-------------------------||||||||||----||||||||||||----%%%%%%%%%%%%%%-------------------|||||||||||||------------- ----
XXXXXX|||||XXXXXXXXXXXXXX-----XXXXXXXXXXXXXX---XXXXXXXXX-----XXXXXXXX-----XXXXXXXXXXXXXXXXXXXXXXXXXXXXXXXX||||||||||----||||||||||||----||||||||||||||-----XXXXXXXXXXXXXX|||||||||||||-----XXXXXXXXXXFXX