--------------------------------------------------------------------------------------------------------------------------------------------------------------------------------------------------------
--------------------------------------------------------------------------------------------------------------------------------------------------------------------------------------------------------
--------------------------------------------------------------------------------------------------------------------------------------------------------------------------------------------------------
--------------------------------------------------------------------------------------------------------------------------------------------------------------------------------------------------------
--------------------------------------------------------------------------------------------------------------------------------------------------------------------------------------------------------
--------------------------------------------------------------------------------------------------------------------------------------------------------------------------------------------------------
--------------------------------------------------------------------------------------------------------------------------------------------------------------------------------------------------------
---------------------------------------------------------------------------Tt---------------------------------------------------------------------------------------------------------------------------
---------------------------------------------------------------------------tt-----------------------------------Tt--------------------------------------------------------------------------------------
------------------------------------------------------------Tt-------------tt-----------------------------------tt----------------------Tt--------------------------------------------------------------
------------------------------------------------------------tt-------------tt-----------------------------------tt----------------------tt----------------------------------------------Tt--------------
------------------------------------------------------------tt----------%%%%%%%%%---SCSS2------Tt---------------tt----------------F-----tt----------------------------------------------tt--------------
---------------------------------------------------------%%%%%%%%%%%----|||||||||------------%%tt%%%%%%%-----%%%%%%%%-USU-%%%%%%%%%%%---tt-------%%%--%%%%%---------------------------G-tt----G---------
------%%%-----%%%%%-------------------------------------%%%%%%%%%%||----|||||||||-----------K||tt|||||||-----||||||||-----|||||||||||%%%%%%%%%---|||--|||||-----------------UCUS-----%%%%%%%%%%----F----
------|||-----|||||-----%%%%------%%%%%-----------------||||||||||||----|||||||||---------%%%%%%%%%%%%||-----||||||||-----||||||||||||||||||||---|||--|||||--------%%%%--%%%---------||||||||||---- ----
XXXXXX|||-----|||||XXXXX||||------|||||XXXXXXXXXXXXXXXXXXXXXXXXXXXXXXXXXXXXXXXXXXXXXXXXXXX||||||||||||XXXXXXXXXXXXXXXXXXXX||||||||||||||||||||XXX|||--|||||XXXXXXXX||||--|||XXXXXXXXXXXXXXXXXXXXXXXXXXXX