--------------------------------------------------------------------------------------------------------------------------------------------------------------------------------------------------------
--------------------------------------------------------------------------------------------------------------------------------------------------------------------------------------------------------
--------------------------------------------------------------------------------------------------------------------------------------------------------------------------------------------------------
--------------------------------------------------------------------------------------------------------------------------------------------------------------------------------------------------------
--------------------------------------------------------------------------------------------------------------------------------------------------------------------------------------------------------
--------------------------------------------------------------------------------------------------------------------------------------------------------------------------------------------------------
--------------------------------------------------------------------------------------------------------------------------------------------------------------------------------------------------------
--------------------------------------------------------------------------------------------------------------------------------------------------------------------------------------------------------
--------------------------------------------------------------------------------------------------------------------------------------------------------------------------------------------------------
-----------------------------------------------------U--------------------------------------------------------------------------------------------g-----------------------------------------------------
-----------------------------------------------------------------------------------------------------------------------------------------------------------------gk-r-----------------------------------
---------------------------------------------------------ggkggggkggkgkk--------------------------------------------------------------------------%%%%%%%%%%%%-------------------------------------    %%
-----------------------------------------------------------||||||||||--------------------------------------------------------------------%%%%%%--||||||||||||---%%%%%%%%%%%%%%--------------tt----||| ||
-------------------------------g-------------%%%%%%%%%%%%--||||||||||--%%%%%%%%%%%%-------------------------------------%%%--------------||||||--||||||||||||---||||||||||||||--------------tt----||||||
------%%%%%----------------------------------||||||||||||--||||||||||--||||||||||||-------------------------------------|||------------%%%%%%%%%%||||||||||||---||||||||||||||--------------tt----||||||
XXXXXX|||||XXXXXXXXXXXXXX-----XXXXXXXXXXXX---||||||||||||XXXXXXXXXXXXXX||||||||||||----XXXXXXXXXXXXXX----XXXXXXXXXX-----|||----XXXXXXXX||||||||||||||||||||||---||||||||||||||XXXXXXXXXXXXXXXXXXXX||||||