----------------------------------------------------------------- --------------------------------------------------------------------------------------------------------------------------------------
------------------------------------------------------------------------------------------------------------------------------ -------------- ----------------------------------------------------------
------------------- ----------------------------------------------------------------- ----------------------------------------------------------------------------------- ------------------------------
--------------------------------------------------------------------------------------------------------------------------------------------------------------------------------------------------------
------------------------------------------------------------------------------------------------------------------------------------------------------------------------------------------- - ----------
-------------------------------------------------------------------------------------------------------------------------------------------g---------------------- ------------------------------- -----
----------------------------------------------------------------------------------------------------------------------------------------%%%%%%----------------------------------------------------------
------------------------------------------------------------- --------------------------------------------------------------------------||||||----------------------- ----------------------------------
---------------------------------------------------- -------------------------y---------------------------------------------------------||||g|----------------------------------------------------------
--------------------------------------------------------------------------%%%%%---------------------------------------------------------||%%%%%%%-------------------------------------------------------
--------------------------------------------------------------------------|||||------------------------- -------------------------------|||||||||-------------------------------------------------------
------------------------------------------------------------ -------------|%%%%%%---------------------------------------------G---------|||||||||-------------------------------------------------------
--------------------------------------------------%%--%%--#--#--%%---%%---|||||||-------------------------------------------%%%%%%------k|||||||k-------------------------------------------------------
------------------------%%--%%--------------------||--||%%%--%%%||---||---|||||||------%%%--%%%------%%%%-------------------||||||---%%%%%%%%%%%%%%%%%%%--------------------------- --------------------
-- ----------------- ---||--||--------------- ----||--|||||--|||||---||---|||||||------|||--|||------||||------------#---#--||||||---|||||||||||||||||||---------------------- -------------------------
 X X X  XXX X X  X X-- X||--|| X--- X  XXX---XXXXX||--|||||--|||||---|| XXXX   XXX XXX |||--|||XX--XX||||XXX --XX  XXX---X X||||||XX |||||||||||||||||||XXXX   XFX X XX X  X XX   XX X    X XX    XXX   