---------------------------------------------------------------------------------------------------------------------------------        ---------------------------------------------------------------
---------------------------------------------------------------------------------------------------------------------------------        ---------------------------------------------------------------
---------------------------------------------------------------------------------------------------------------------------------        ---------------------------------------------------------------
---------------------------------------------------------------------------------------------------------------------------------        ---------------------------------------------------------------
---------------------------------------------------------------------------------------------------------------------------------        ---------------------------------------------------------------
---------------------------------------------------------------------------------------------------------------------------------        ---------------------------------------------------------------
---------------------------------------------------------------------------------------------------------------------------------        ---------------------------------------------------------------
---------------------------------------------------------------------------------------------------------------------------------        ---------------------------------------------------------------
---------------------------------------------------------------------------------------------------------------------------------        ---------------------------------------------------------------
-----------------------------------------------------------------------------------------Tt--------------------------------------        -----------------------Tt--------------------------------------
---------K------------------------------------------------------------------Tt-----------tt------------------------------G-------        -----------------------tt--------------------------------------
--------%%%%-------------------------------K--------------------------------tt-----------tt---------------------------22CU-------        ---------------------G-tt--------------------------------------
--------||||-------------------------%%%%--%%%%%----------------------------tt------%%%%%%%%%%%--%%%----%%%%%--------------------        ------%%%%%%--------%%%%%%%%--------G-----------%%%%%%SUS2UK%%%
--------||||-------G---------%%%--%%%||||--|||||---%%%------%%%%------------tt------|||||||||||--|||----|||||-------------------%        ------||||||--------||||||||----%%%%%%%%%%%-----||||||%%%%%%|||
--------||||-%%%%%%%%%-------|||--|||||||--|||||---|||------||||--------%%%%%%%%%%--|||||||||||--|||----|||||-------------------|        %%%%%%%|||||--------||||||||----|||||||||||-----|||||||||||||||
XXXXXXXXXXXXX|||||||||XXXXXXX|||--|||||||--|||||XXX|||------||||XXXXXXXX||||||||||XX|||||||||||XX|||----|||||XXXXXXXXXXXXXXXXXXX|        |||||||XXXXXXXXXXXXXXXXXXXXXXXXX|||||||||||XXXXX||||||XXXXXX|||