-------------------------------------------------------------- ---------- ----------------------------------- ---------------------------------------------- -------------------------------------------
----------------------------------- --------------------------------- -- -------------------------------------------------------------------------------------------------------------------- ----------
------------------------------ -------------------------------------------------------------------------------------------------------------------------------------------------------------------------
------------------------------------------------------------- -------------------------------------------------------------- ---------------------------------------------------------------------------
------------------ -------------------------------------------------------------------------------------------- ------------------------------------------------------------------- --------------------
------------------------------------------------------------ ---------------------------- --------------------------------------------------------------------------------------------------------------
-------------------- -------------------------------------------------------------------------------------------------------------------------------------------------------- --------------------------
------------------------------------------------------------ -------------------------------------------------------------------------------------------------------------------------------------------
------------------------------------------------------------------------------------ ----------- -------------------------------------------------------------------------------------------------------
------------------------------------------------------------- ------------------- ---- -----------------------------------------------------------------------------------------------------------------
------------------------------------- ------------------------- -----------------------------------------------------------------------------------------------r---------- ----- ------- ---------------
------------------------------%%%%%%--------------------------------------- %%%% -- ---------------------------------------------kggggkgkk------------------------------------------- ------------------
------------------------------||||||-------- %%%%%-------------------------||||||--------% %-- -----Tt---------------------------- ---------------------------%%%%%%%%------- --------------------------
---------------------------- -||||||---gg-g-|%%%% -------%%%%%  %----------||||||--------|||--------tt----g--------------------r----------%  %% %%----%%%%%  %||||||||--------------------- %%%% %%  F% 
------%%% %-------------------||||||  ------||||||-------||||||||----------||||||--------|||----%%% % %% -------------%%  %%%  %----------||||||||----||||||||||||||||---------%  %%%%% %%%|||||||||| ||
 XXX  |||||XX XXX  X X  X---XX X XX   ----  X XX X  ---X XX  XX X  XX----X XXXXXXX X-----|||----|||||||||-----  XX    ||||||| || X   X XXX||||||||----||||||||||||||||   XXX   |||||||||||||||||| ||||||