--------------------------------------------------------------------------------------------------------------------------------------------------------------------------------------------------------
--------------------------------------------------------------------------------------------------------------------------------------------------------------------------------------------------------
--------------------------------------------------------------------------------------------------------------------------------------------------------------------------------------------------------
--------------------------------------------------------------------------------------------------------------------------------------------------------------------------------------------------------
--------------------------------------------------------------------------------------------------------------------------------------------------------------------------------------------------------
--------------------------------------------------------------------------------------------------------------------------------------------------------------------------------------------------------
--------------------------------------------------------------------------------------------------------------------------------------------------------------------------------------------------------
--------------------------------------------------------------------------------------------------------------------------------------------------------------------------------------------------------
--------------------------------------------------------------------------------------------------------------------------------------------------------------------------------------------------------
-------------------------------------------------------------------------------------------------------------------------------------------------------------------------------Tt-----------------------
------------------------------------------------------------------------------------G------------------------------------------------------------------------------------------tt----------------Tt-----
---------------------------------------------Tt--------------------------------G-%%%%%-------------%%%%%%%%%%%--------------------F--------------------------------------------tt----------------tt-G---
---------------------------------------------tt--------------------------------%%%%%||-------------|||||||||||--------------------%-----------------------------%%%%%---G-%%%%%%%%%%%-----%%%%%%-tt%%%--
---------------------------------------------tt---%%%%%-------%%%%%%%%%%-------|||||||-22S2--K-----|||||||||||--------------------|----------%%%%----%%%--------%%%%%%%%%%|||||||||||-----||||||%%%%%%F%
-------------------%%%%%%%%%%-----------%%%%%%%%%%%||||-------||||||||||-------|||||||-----%%%%%%%%%||||||||||--------------------|----------||||----|||--------|||||||||||||||||||||-----|||||||||||| |
XXXXXXXXXXXXXXXXXXX||||||||||XXXXXXXXXXX|||||||||||XXXXXXXXXXXXXXXXXXXXXXXXXXXX|||||XXXXXXX|||||||||XXXXXXXXXXXXXXXXXXXXXXXXXXXXXXXXXXXXXXXXX||||----|||XXXXXXXXXXXXXXXXXX|||||||||||XXXXX||||||XXXXXXXX