--------------------------------------------------------------------------------------------------------------------------------------------------------------------------------------------------------
--------------------------------------------------------------------------------------------------------------------------------------------------------------------------------------------------------
--------------------------------------------------------------------------------------------------------------------------------------------------------------------------------------------------------
--------------------------------------------------------------------------------------------------------------------------------------------------------------------------------------------------------
--------------------------------------------------------------------------------------------------------------------------------------------------------------------------------------------------------
--------------------------------------------------------------------------------------------------------------------------------------------------------------------------------------------------------
--------------------------------------------------------------------------------------------------------------------------------------------------------------------------------------------------------
--------------------------------------------------------------------------------------------------------------------------------------------------------------------------------------------------------
--------------------------------------------------------------------------------------------------------------------------------------------------------------------------------------------------------
------------------Tt------------------------------------------------------------------------------------------------------------------------------------------------------------------------------------
------------------tt--K------Tt-------------------------------------------------------------------------------------------------------------------------------------------------------------------------
------------------tt-%%%-----tt--------------------------------------------------------------------------------------------------- --------------------------------------------------------------------G
------------------tt-|||-----tt-------------C2-------------------------------------------------------------------------K----------%--------------------------------------------K----------------------%%
---------------%%%%%%%%|-----tt---K---------%%%%%%%%%%%%--------------G-------------K-----------------------G-------%%%%%%%%%%%---|--------------------------------------K-----%%%%%------------------||
---------------|||||||||-%%%%%%%%%%%--------||||||||||||-------%%%---%%%-----%%%----%%%%--------%%%%%-----%%%%%-----|||||||||||---|----------------------------%%%%----%%%%%---|||||------------------||
XXXXXXXXXXXXXXX||||||||XX|||||||||||XXXXXXXXXXXXXXXXXXXXXXXXXXX|||---|||XXXXX|||----||||XXXXXXXX|||||-----|||||XXXXXXXXXXXXXXXXXXXXXXXXXXXXXXXXXXXXXXXXXXXXXXXX||||----|||||XXXXXXXXXXXXXXXXXXXXXX    ||