--------------------------------------------------------------------------------------------------------------------------------------------------------------------------------------------------------
--------------------------------------------------------------------------------------------------------------------------------------------------------------------------------------------------------
--------------------------------------------------------------------------------------------------------------------------------------------------------------------------------------------------------
--------------------------------------------------------------------------------------------------------------------------------------------------------------------------------------------------------
--------------------------------------------------------------------------------------------------------------------------------------------------------------------------------------------------------
--------------------------------------------------------------------------------------------------------------------------------------------------------------------------------------------------------
--------------------------------------------------------------------------------------------------------------------------------------------------------------------------------------------------------
--------------------------------------------------------------------------------------------------------------------------------------------------------------------------------------------------------
--------------------------------------------------------------------------------------------------------------------------------------------------------------------------------------------------------
-----------------------------Tt--------------------------------------------------------------Tt---------------------------------------------------------------------------------------------------------
-----------------------------tt--------------------------------------------------------------tt---------------------------------------------------------------------------------------------------------
---------------------------G-tt-GK-----------------------------------------------------------tt----------------------------------- -G-----------------------------------------%%%%%%%%%%----------------
--------------------------%%%%%%%%%---U------------------------------------K--------------%%%%%%%%------------------------------%%%%%%%%%%%-----------%%%---------------------||||||||||----%%%%%-------
-----------------G--------|||||||||----%%%%%--%%%%------------%%%%%%-------%%%%------%%%%-||||||||--------------G---------------|||||||||%%%----------|||---%%%%%%------K---G-||||||||||----|||||-------
---------------%%%%%--%%%%|||||||||%%%-|||||--||||------------||||||-------||||------||||-||||||||--%%%%-----%%%%%--------------||||||||||||----------|||---||||||----%%%%%%%%%%||||||||----|||||---- %%
XXXXXXXXXXXXXXX|||||--||||||||||||||||X|||||--||||XXXXXXXXXXXXXXXXXXXXXXXXX||||------||||X||||||||XX||||-----|||||XXXXXXXXXXXXXXXXXXXXXXXXXXXXXXXXXXXXXXXXXX||||||XXXX||||||||||XXXXXXXXXXXXXXXXXX   |||