--------------------------------------------------------------------------------------------------------------------------------------------------------------------------------------------------------
--------------------------------------------------------------------------------------------------------------------------------------------------------------------------------------------------------
--------------------------------------------------------------------------------------------------------------------------------------------------------------------------------------------------------
--------------------------------------------------------------------------------------------------------------------------------------------------------------------------------------------------------
--------------------------------------------------------------------------------------------------------------------------------------------------------------------------------------------------------
--------------------------------------------------------------------------------------------------------------------------------------------------------------------------------------------------------
--------------------------------------------------------------------------------------------------------------------------------------------------------------------------------------------------------
--------------------------------------------------------------------------------------------------------------------------------------------------------------------------------------------------------
-----------------------------------------------Tt-------------------------------------------------------------------------------------------------------------------------------------------------------
-----------------------------------------------tt-----------------------------------------------------------------------------------------------------------------------Tt------------------------------
-----------------------------------------------tt----------------------------------------------------Tt---------------------------Tt------------------------------------tt------------------------------
---------------------------------------USUU%%%%%%%%%-------------------------------------------------tt---------------------------Ft---------------------------------G--tt---------%%%%-----------%%%%%%
-------------------------------------------|||||||||------------------------------%%%%%------%%%-----tt----------%%%%%%-----------tt--------------------------------%%%%%%%%%%%----||%%%%%%%%%%%%-||||||
----------%%%%---%%%%---------%%%----------||||||||%----------------------2SC2U---|||||------|||-----tt----------||||||-----------tt------------------------------%%|||||||||||----||||||||||||||-|F||||
----------||||---||||---------|||----------||%%%%|||-----------------%%%%---------|||||------|||-%%%%%%%%%%%-----||||||-------%%%%%%%%%%--------------------------|||||||||||||----||||||||||||||-| ||||
XXXXXXXXXX||||---||||XXXXXXXXX|||XXXXXXXXXXXX||||XXXXXXXXXXXXXXXXXXXX||||XXXXXXXXX|||||------|||X|||||||||||XXXXX||||||XXXXXXX||||||||||XXXXXXXXXXXXXXXXXXXXXXXXXXXX|||||||||||XXXXXXXXXXXXXXXXXXXXXXXXX