--------------------------------------------------------------------------------------------------------------------------------------------------------------------------------------------------------
--------------------------------------------------------------------------------------------------------------------------------------------------------------------------------------------------------
--------------------------------------------------------------------------------------------------------------------------------------------------------------------------------------------------------
--------------------------------------------------------------------------------------------------------------------------------------------------------------------------------------------------------
--------------------------------------------------------------------------------------------------------------------------------------------------------------------------------------------------------
--------------------------------------------------------------------------------------------------------------------------------------------------------------------------------------------------------
--------------------------------------------------------------------------------------------------------------------------------------------------------------------------------------------------------
--------------------------------------------------------------------------------------------------------------------------------------------------------------------------------------------------------
--------------------------------------------------------------------------------------------------------------------------------------------------------------------------------------------------------
-----------------------------------------------------------Tt-------------------------------------------------------------------------------------------------------------TTt---------------------------
-----------------------------------------------------------tt-------------------------------------------------------------------------------------------------------------ttt---------------------------
-----------------------------------------------K-----------tt---------------------------------------------------SU-----------G---- ---------------------------------------ttt---------------------------
------------------------------------------%%%--%%%%%-------tt-------------------G-------------------%%%---%%%%-----%%%%-----%%%---%--------------%%%-----------------%%%%%%tt%%----------------2UC    --
----------G------------G-----%%%%%%%%-----|||--|||||----%%%%%%%%------%%%%%---%%%-------------------|||---||||-----||||-----|||---|-----C22S-----|||-----------------||%%%%%%%%%---K--------------------
----------%%%%%------%%%%%---||||||||-----|||--|||||----||||||||------|||||---|||-------------------|||---||||-----||||-----|||%%%|-%%%----------|||-----------------|||||||||||%%%%-----%%%%---------%%
XXXXXXXXXX|||||------|||||XXX||||||||XXXXX|||--|||||XXXX||||||||XXXXXX|||||---|||XXXXXXXXXXXXXXXXXXX|||---||||XXXXX||||-----|||||||-|||XXXXXXXXXX|||XXXXXXXXXXXXXXXXXXXXXXXXXXXX||||-----||||XXXXX    ||