--------------------------------------------------------------------------------------------------------------------------------------------------------------------------------------------------------
--------------------------------------------------------------------------------------------------------------------------------------------------------------------------------------------------------
--------------------------------------------------------------------------------------------------------------------------------------------------------------------------------------------------------
--------------------------------------------------------------------------------------------------------------------------------------------------------------------------------------------------------
--------------------------------------------------------------------------------------------------------------------------------------------------------------------------------------------------------
--------------------------------------------------------------------------------------------------------------------------------------------------------------------------------------------------------
--------------------------------------------------------------------------------------------------------------------------------------------------------------------------------SC----------------------
--------------------------------------------------------------------------------------------------------------------------------------------------------------------------------------------------------
--------------------------------------------------------------------------------------------------------------------------------------------------SSUC2-%%%%%%%%%%%%----------k-------------------------
-----------------------------------------------------------------------------------------------------------------------------SSS------------------------||||||||||||------------------------------------
-------------------------g---------------------------------------U--------------------------g---g-----------------------------------------S2SUSS--------||||||||||||%%%%%%%%%%%%%%%%%-------------------
--------------------------------%%%%%%%------------------------------gggkkkggkggggg---------------------------------------------------------------------|||||||||||||||||||||||||||||-------------------
--------------------------------|||||||----------------------------------------------------%%%%%%%%%----------------------------------------------------|||||||||||||||||||||||||||||-------------------
--------------------------------|%%%%%|-----g--------g-----------------------------%%%%%%%%|||||||||------g------g---r-k---%%%%%%-----------------------|||||||||||||||||||||||||||||-------------------
------%%%%%---------------------|||||||----------------%%%%%%%%%%%%%%--------------|||||||||||||||||-----------------------||||||--%%%%%%%%%%%%%%%%%%%%%|||||||||||||||||||||||||||||----%%%%%%%%%    %%
XXXXXX|||||XXXXXXXXXXXXXX-----XXXXXXXXXXXXX----XXXXXXXX||||||||||||||XXXXXXXXXXXXXX|||||||||||||||||-----XXXXXXXXXXXX----XXXXXXXXXX||||||||||||||||||||||||||||||||||||||||||||||||||----|||||||||||| ||