--------------------------------------------------------------------------------------------------------------------------------------------------------------------------------------------------------
------------------------------------------------------------------------------- ----------------------------------------- -------------------------- ---------------------------------------------------
------------------------------------------------------------------- ------------------------------------ -----------------------------------------------------------------------------------------------
------------------------- ----------------------------  CC--------------------------------------------------------------------- ------------------------------------------------------------------------
--------------------------------------------------------------------------------------------------------------------------- ----------------------------------------------------------------------------
--------------------------------------------------------------------------------------------------------------------------------------------------------------------------------------------------------
-------------------------------------------------------r----k-------------------------------------------------------------------------------------------------------------------------------------------
------------------------------------------------------%%% %%%----------------------------------------------------------------------------- -------------------------------------------------------------
-- ---------------------------------------------------|||||||-----------------------------------------y-------SU S ------------------------------------- -----------------------------------------------
------------------------- ------- ---%%% %------------||||%%%%%--------------------------------------%  %------------------------------------------ ----------------------------------------------------
-------------------------------------|||||------------|||||||||--------------------------------------||||-------------- --------------------------------------------------------------------------------
------------ ------------------------|||||------------|||||||||--y-------------------- t--t ---------||||------------------------------------------------------------ ----------------------------------
------------------------% %%%--%%%%%-|||||-----------%%%%%% % %%  %%%%---%%%----------t --tt-----% %%%|||----%%%%% %--tt--- t------%%%%--- %%%%%%%%%%%F%%% %%%%% %%%% %%%%%%%%%%%%%  %% %%%%%%%%%  %%%%%
------------------------|||||--|||||-|%%%|----%%---%%|||||||| ||||||||---|||% %%%%%%%%%%%%%% %%%-|||y|r||-rr-|||| ||--tt---tt------||||---|||||||||||| |||||||||||||||||||||||||||||||||||||||||||||||||
-------------%%%%---%%%%|||||--|||||-|||r|----||---|||||||||||||||||||---|||||||||||||||||||||||%% %%%%%%%%% |||||||%%%%%%%%%%%%%%%||||---|||||||||||||||||||||||||| |||||||||||||||||||||||||||||||||||
 XX  XXXXXXXX||||---|||||||||--|||||XXXXXXXXXX||---|||||||||||||||||||---||||||||||||||||||||||||||||||||||||||||||||||||||||||||||||||---|||||||||||||||||||||| ||||||||||||||||||||||||||||||||||| |||