--------------------------------------------------------------------------------------------------------------------------------------------------------------------------------------------------------
--------------------------------------------------------------------------------------------------------------------------------------------------------------------------------------------------------
--------------------------------------------------------------------------------------------------------------------------------------------------------------------------------------------------------
--------------------------------------------------------------------------------------------------------------------------------------------------------------------------------------------------------
--------------------------------------------------------------------------------------------------------------------------------------------------------------------------------------------------------
--------------------------------------------------------------------------------------------------------------------------------------------------------------------------------------------------------
--------------------------------------------------------------------------------------------------------------------------------------------------------------------------------------------------------
--------------------------------------------------------------------------------------------------------------------------------------------------------------------------------------------------------
--------------------------------------------------------------------------------------------------------------------------------------------------------------------------------------------------------
--------------------------------------------------------------------------------------------------------------------------------------------------------------------------------------------------------
------------------------------------------------------------------------gggggkrkk---------%%%%%%%%------------------------------------------------------------------------------------------------------
--------------------------------%%%%%-----------g---------------------r--|||||||----------||||||||---------------------------------------------SSSSSSCSSS-------------------22SCCSSC------SS2S----------
--------------------------------|||||--------------------%%%%%%%%%%%%%%--|||||||-%%%%%%%%%||||||||k----%%%%%%%%-----%%%%%%%-------------tt--------------------------------------------------------------
----------------------------g---|||||---------%%%%%%%----||||||||||||||--|||||||-|||||||||||||||||-----||||||||-----|||||||-------------tt-------------------------------------------------------F------
------%%%%%---------------------|||||---------|||||||----||||||||||||||%%%%%%%%%%|||||||||||||||||-----||||||||-----|||||||-------------tt------------------------------------------------------- ------
XXXXXX|||||XXXXXXXXXXXXXX-----XXXXXXXXX-----XXXXXXXXXXXXX|||||||||||||||||||||||||||||||||||||||||-----||||||||---XXXXXXXXXXXX-----XXXXXXXXXXXXXXXXXXXXXXXXXXXXXXXXXXXXXXXXXXXXXXXXXXXXXXXXXXXXXXXXXXFXX