---------------------------------------------------------------------------------------------------------------------------------        ---------------------------------------------------------------
---------------------------------------------------------------------------------------------------------------------------------        ---------------------------------------------------------------
---------------------------------------------------------------------------------------------------------------------------------        ---------------------------------------------------------------
---------------------------------------------------------------------------------------------------------------------------------        ---------------------------------------------------------------
---------------------------------------------------------------------------------------------------------------------------------        ---------------------------------------------------------------
---------------------------------------------------------------------------------------------------------------------------------        ---------------------------------------------------------------
---------------------------------------------------------------------------------------------------------------------------------        ---------------------------------------------------------------
-------------------------------------------------------------------------------Tt------------------------------------------------        ---------------------------------------------------------------
-------------------------------------Tt----------------------------------------tt------------------------------------------------        ---------------------------------------------------------------
-------------------------------------tt----------------------------------------tt------------------------------------------------        ---------------------------------------------------------------
-----------------------GK------------tt---------------------Tt-----------------tt------------------------------------------------        ---------------------------------------------------------------
----------------------G%-%%%%--------tt---------------------tt------------%%%%%%%%%%%%--------%%%--------------------------------        ---------------------------------------------------------------
--------------------%%%%%%%%%---%%%%%%%%%%%%--K-K-----------tt%%%---------||||||||||||--------|||--------------------------------        --------------G----------------------------------------------%%
--------------------|||||||||---||||||||||||--%%%-----22----tt|||---------||||||||||||---%%%--|||-------------------GK-----------        ------%%%-----%%%%%---%%%--------------------------------C2UC||
--------------------|||||||||---||||||||||||--|||-------%%%%%%%%%%%-------||||||||||||---|||--|||%%%%%%------%%%%--%%%%----------        ------|||-----|||||---|||------------------------------------||
XXXXXXXXXXXXXXXXXXXX|||||||||XXX||||||||||||XXXXXXXXXXXX|||||||||||XXXXXXXXXXXXXXXXXXXXXX|||XXXXX||||||XXXXXX||||--||||XXXXXXXXXX        XXXXXX|||-----|||||XXXXXXXXXXXXXXXXXXXXXXXXXXXXXXXXXXXXXXXXXX||