--------------------------------------------------------------------------------------------------------------------------------------------------------------------------------------------------------
--------------------------------------------------------------------------------------------------------------------------------------------------------------------------------------------------------
--------------------------------------------------------------------------------------------------------------------------------------------------------------------------------------------------------
--------------------------------------------------------------------------------------------------------------------------------------------------------------------------------------------------------
--------------------------------------------------------------------------------------------------------------------------------------------------------------------------------------------------------
--------------------------------------------------------------------------------------------------------------------------------------------------------------------------------------------------------
--------------------------------------------------------------------------------------------------------------------------------------------------------------------------------------------------------
--------------------------------------------------------------------------------------------------------------------------------------------------------------------------------------------------------
------------------ t------------------------------------------------------------------------------------------------------------------------------------------------------------------------------------
------------------tt--------------------Tt--------------------------------------------------------------------------------------------------------------------------------------------------------------
------------------tt--------------------tt--------------------------------------------------------------------------------------------------------------------------------------------------------------
------------------tt-K- %%%-------------tt------------------------Tt---------------------------------G-----G--%%%%%%%%%----------- --FK-----------------------------K-----------------------------------
-------------%%%%%%%%%%%|||----------G--tt------------------------tt-------------------------------%%%%%%%%%--|||||||||-----------%-%  ------------------------ UCU22U------------K---------------------
-------------||||||||||||||--------%%%%%%%%%%%--------------------tt---G----%%%%%%-----%%% %%%%%%%-|||||||||--|||||||||-----------|-|||---------------------------------------CSC C---------------------
-------------||||||||||||||--------|||||||||||----------------%%%%%%%%%%%---||||||-----|||||||||||-|||||||||--|%%%|||||-----------|-%%%%%%%%%%-------------------------------------------%%%%%------%%%%
 XX    X X   XX   XXXXXXXXXX   XXXX|||||||||||  XXX XX XXXXX X|||||||||||  X||||||  X X||||||||||| XX  XXXXX XX|||XXXXXXXX  X XX X  ||||||||||XXXX   XXX  XXX X  XXXXX XXXXX  XX XXXXX XX|||||------||||