--------------------------------------------------------------------------------------------------------------------------------------------------------------------------------------------------------
--------------------------------------------------------------------------------------------------------------------------------------------------------------------------------------------------------
--------------------------------------------------------------------------------------------------------------------------------------------------------------------------------------------------------
--------------------------------------------------------------------------------------------------------------------------------------------------------------------------------------------------------
--------------------------------------------------------------------------------------------------------------------------------------------------------------------------------------------------------
--------------------------------------------------------------------------------------------------------------------------------------------------------------------------------------------------------
--------------------------------------------------------------------------------------------------------------------------------------------------------------------------------------------------------
--------------------------------------------------------------------------------------------------------------------------------------------------------------------------------------------------------
--------------------------------------------------------------------------------------------------------------------------------------------------------------------------------------------------------
-------------------------------------------------------------------------Tt-----------------------------------------------------------------------------------------------------------------------------
-----------------------------------------------------------------Tt------tt----------------------------------------------------------G------------------Tt-------------------Tt-------------------------
----------G--------------------K-------G-------------------------tt------t--------------------------------------------------------F--%%%%%%-------------tt-------------------tt-------------------------
--------%%%%-------------------%%%%%%%%%%%----%%%%%--------------tt--K%%%%%%%%%-------%K%%%%%%------------------------------------%--||||||-------------tt-------------------tt-------------------------
--------||||-------------------|||||||||||----|||||--%%%%%----%%%%%%%%|||||||||-----%%%%%%%%%|---------------------------%%%%%%%%%%%%||||||-------------tt--G----------------tt---2U-----%%%%%%%F%%%----
--------||||-------------------|||||||||||----|||||--|||||----|||||||||||||||||-----||||||||||---------------------------||||||||||||||||||--------%%%%%%%%%%%-----------%%%%%%%%%-------||||||| |||----
XXXXXXXXXXXXXXXXXXXXXXXXXXXXXXXXXXXXX|||||----|||||XX|||||XXXX||||||||XXXXXXXXXXXXXXXXXXXXXXXXXXXXXXXXXXXXXXXXXXXXXXXXXXX||||||||||||XXXXXXXXXXXXXX|||||||||||XXXXXXXXXXX|||||||||XXXXXXXXXXXXXXXXXXXXXX