--------------------------------------------------------------------------------------------------------------------------------------------------------------------------------------------------------
--------------------------------------------------------------------------------------------------------------------------------------------------------------------------------------------------------
--------------------------------------------------------------------------------------------------------------------------------------------------------------------------------------------------------
--------------------------------------------------------------------------------------------------------------------------------------------------------------------------------------------------------
--------------------------------------------------------------------------------------------------------------------------------------------------------------------------------------------------------
--------------------------------------------------------------------------------------------------------------------------------------------------------------------------------------------------------
--------------------------------------------------------------------------------------------------------------------------------------------------------------------------------------------------------
--------------------------------------------------------------------------------------------------------------------------------------------------------------------------------------------------------
---------------------------------------Tt---------------------------------------------------------------------------------------------------------------------------------------------------------------
---------------------------------------tt--------------------------------------------------------------------------------------------------------------------------------Tt-----------------------------
---------------------------------------tt--------------------------------------------------------------------------------------------------------------------------------tt---------G-------------------
-------------------K-----------------K-tt--------------------------------------------------------------------------------G--------F--------------------------------------tt%%%%%%%%%%-------------------
------------------%%%%%%%%%%--------%%%%%%%%%---K--G------------%%%%%%%%%%%%-%%%----%%%%-----------------------------%%%%%--%%%%--%------------------------------G--%%%%%%%%%%||||||%%%%%%%%%-----------
------------------||||||||||--------|||||||||---%%%%%---------G-|||%%%%%%|||-|||----||||------------%%%%%S222U2------|||||--||||--|-----K-----------------%%%----%%%||||||||||||||||||||||||%%%-------F-
------------------||||||||||--------|||||||||---|||||-------%%%-||||||||||||-|||----||||------------|||||------------|||||--||||%%%%%%%%%-----------------|||----|||||||||||||%%%%%%|||||||||||------- -
XXXXXXXXXXXXXXXXXX||||||||||XXXXXXXX|||||||||XXXXXXXXXXXXXXX|||XXXXXXXXXXXXXX|||----||||XXXXXXXXXXXXXXXXXXXXXXXXXXXXX|||||--|||||||||||||XXXXXXXXXXXXXXXXX|||----|||XXXXXXXXXX||||||XXXXXXXX|||XXXXXXXXX