--------------------------------------------------------------------------------------------------------------------------------------------------------------------------------------------------------
--------------------------------------------------------------------------------------------------------------------------------------------------------------------------------------------------------
--------------------------------------------------------------------------------------------------------------------------------------------------------------------------------------------------------
--------------------------------------------------------------------------------------------------------------------------------------------------------------------------------------------------------
--------------------------------------------------------------------------------------------------------------------------------------------------------------------------------------------------------
--------------------------------------------------------------------------------------------------------------------------------------------------------------------------------------------------------
--------------------------------------------------------------------------------------------------------------------------------------------------------------------------------------------------------
------------------------------------------------- t-----------------------------------------------------------------------------------------------------------------------------------------------------
-------------------------------------------------tt-----------------------------------------------------------------------------------------------------------------------------------------------------
-------------------------------------------------t -----------------------------------------------------------------------------------------------------------------------------------------------------
-------------------------------------------------tt-----------------------------------------------------------------------------------------------------------------------------------------------------
----------------------------------------------  %%%%%%%----------------- ------%%% %%-%%%%-- -------------------------------------F---------- ----------------------------------------------------------
-------------------%%%%%------%  ----%%%------|||||||||- C 2S-%% %---  %%%-----||| ||-||||--%%%%%------%%%--- --------------------%---------U CUUCS-- -------- ----2U2UU-- -----------------------%%% %-
-------------------|||||------|||----|||------|||||||||-------||||---|||||-----||%%%%%%%%%--|||||------|||% %%%---%%%%------------|-----------%%%---%%%%--%%%%%---------%%%%----%%%---------------|||||-
-------------------|||||------|||----|||------|||||||||-------||||---|||||-----|||||||||||--|||||------||||||||---||||------------|-----------|||---||||--|||||---------||||----|||---------------|||||-
   XX   XXXX X XXXX|||||------|||X XXXXXX   XXX X XX  XXX X  X||||---|||||XXX XXX  XXX X  XX|||||------||||||||---||||XXXXXXXXXXXXXX  XX    X  X XX ||||--|||||X XXXXXXX||||----|||X XXX XX  XX XX|||||X