--------------------------------------------------------------------------------------------------------------------------------------------------------------------------------------------------------
--------------------------------------------------------------------------------------------------------------------------------------------------------------------------------------------------------
------------------------------------ ------------------------------------------------------------------------------------------------------------------------------ ------------------------------------
---------------------------------------------------------------------------------- ---------------------------------------------------------------------------------------------------------------------
------ -------------------------------------------------------------------------------------------------------------------------------------------------------------------------------------------------
--------------------------------------------------------------------------------------------------------------------------------------------------------------------------------------------------------
-----------------------------------------------------------------------------------------------------------------------------------------------U----------------------------------------%%%%%%----------
-------------------------------------------------------------------------------------------------------------------------------------------------------SSCS-----------------------------||||||----------
------------------------------------------------------------------------------ ------------------------------------------------%%% %%% --- -------------------------------%%%%%---------||||||----------
------ --------------------------------- ------ ---------------------------------g---------------------------------------------||||||||------------kkgggkggkr-------------| %%%%%%------||||||----------
--------------------------g-----------  ---------------------S2SCS---------------------------- --------------------------------||||||||----  %%%%%%-----------------------||||||||----%  %%%%%%% %%%% %%
------------------------------------------------------------kgggggggg---------------- ---------------------------------------%%%%%%%%%%  %%||||||||----------%  %%%%% ---%%% %%%%%%%%%|||||||||||||||%||
----------------------------------------------------------r------------------------------------- --%% %%  -------------------|||||||| |||||||||||||----------|||||||||---|||||||||||||||||||||||||||||||
-------------------------------------------------- %%%%%%% ---------- %% %% %% %---------------g-g-|||||||-------------------||||||||||||||||||||||%%%   %%%%|||||||||---|||||||||||||||||||||||||||||||
------ %%%%- ------------------------------ ------|||||||||----------|||||||||||-------------------|||||||-------------------||||||||||||||||||| |||||||||||||||||||||---|||||||||||||||||||||||||||||||
XXXXXX|||||XXXXXXXXXXXXXX----XXXXXXXX---XXXXXXXXXX|||||||||XXXXXXXXXX|||||||||||----XXXXXXXXXX---XXXXXXXXXXXX-----XXXXXXXXXXX|||||||||||||||||||||||||||||||||||||||||---|||||||||||||||||||||||||||||||