--------------------------------------------------------------------------------------------------------------------------------------------------------------------------------------------------------
--------------------------------------------------------------------------------------------------------------------------------------------------------------------------------------------------------
--------------------------------------------------------------------------------------------------------------------------------------------------------------------------------------------------------
--------------------------------------------------------------------------------------------------------------------------------------------------------------------------------------------------------
--------------------------------------------------------------------------------------------------------------------------------------------------------------------------------------------------------
--------------------------------------------------------------------------------------------------------------------------------------------------------------------------------------------------------
--------------------------------------------------------------------------------------------------------------------------------------------------------------------------------------------------------
--------------------------------------------------------------------------------------------------------------------------------------------------------------------------------------------------------
--------------------------------------------------------------------------------------------------------------------------------------------------------------------------------------------------------
------------------------------------------------------------------------------------------Tt----------------------------------------------------Tt------------------------------------------------------
------------------------------------------------------------------------------------------tt----------------------------------------------------tt---------------------Tt---------------------------KG--
-------------------------------------Tt---------------G--------------------K--------------tt-G------------------------------------F-------------tt---------------------tt--------------------------CSSSC
-------------------------------------tt-----------CSCU2C----------%%%%-----%%%%-----------tt%%%%%%%%------------------------------%---------%%%%%%%%%%-----------------tt-----UUSS----------------------
-----------------------%%%%%%%%--%%%%tt---------------------------||||-----||||-------%%%%%%%%%%||||-----------------G--------K---|----%%%%%%|||||||||-----------------tt----------------------%%%%%%F--
-----------------------||||||||--|%%%%%%%%%%----------------------||||-----||||-------||||||||||||||----------------%%%%------%%%-|----|||||||||||||||------------%%%%%%%%%%------%%%%%%%%-----|||||| --
XXXXXXXXXXXXXXXXXXXXXXXXXXXXXXXXXX||||||||||XXXXXXXXXXXXXXXXXXXXXX||||-----||||XXXXXXX||||||||||XXXXXXXXXXXXXXXXXXXX||||------|||XXXXXX||||||XXXXXXXXXXXXXXXXXXXXX||||||||||XXXXXX||||||||XXXXX||||||XXX