----------------------- ---------------------------------------------- ------------------------------------------------------------------------------------ --------------------------------------------
---------------------------------------------------- ------------------------------------- ----------------------------------------------------------------------------------- -------------------------
------------------------------------ -------------- ---------------------------------------------------------------------------------------------------------- -----------------------------------------
----------------------------------- ------------------------------------ -------------------------------------------------------------------------------------------------------------------------------
--------------------------------------------------------------------------------------------------------------------------------------------------------------------------------------------------------
----------------------------------------------------------------  ------ ---------- --------------------------------- ------------------------------------------------------ ---------------------------
------------------------------------------------------------ -------- ------------------------------------------------------------------------------------------ --------------------------------- -----
--------------------------------------------------------------r------------------------------------------------------------------------------------- ---------------------------------- ----------------
------------------------------------------ ----------------%  %-------------------------------------- --------------------------------------------------------------------------------------------------
 ----------------------------------  ----------------------||||-----------------------------------------------------------------------------------------------------------------------------------------
--- ---------------------------------------SCSS------------||||----------------------------------- --#----2SSSCS--------------------------- ------------------------------------------------------------
-----------------------------------------------------------||||----------------r------%% --------##--##----------------------------------------------------------------------------------------------- -
---------------- ---------------------------------------%     |-----------%%  % %%%%--|||------  %%-- %%%---------------%%%---%  % %%%--- %  %------------------------- ------- ------------------------
------------%% --- %%---#--#----------------------------|||||||-----------||||||||||--|||- ----||||--||||----------  %  |||---||||||||---|||||----------------------------------------------------------
------------|||---|||--##--##-- %%---%%% % % %%%%%  % %  % % %% %%% ------||||||||||--||G------||||--||||%%   %  % ||||||||---||||||||---|||||%% %%%%%F%%  % %%%%  %  %%% %  %%%%%% %%  %%%% %% %%%%  %%
 XXXXXXXXXXX|||---|||XXXX--XXX |||---|||||||||||||||||||||||||||||||XXXXXX|||| |||||XXXXXXXXXXX||||- ||||||||||||||||||||||---||||||||---|||||||||||||X|||||||||||||||||||||||||||||||||| ||||||||||||||