--------------------------------------------------------------------------------------------------------------------------------------------------------------------------------------------------------
--------------------------------------------------------------------------------------------------------------------------------------------------------------------------------------------------------
--------------------------------------------------------------------------------------------------------------------------------------------------------------------------------------------------------
--------------------------------------------------------------------------------------------------------------------------------------------------------------------------------------------------------
--------------------------------------------------------------------------------------------------------------------------------------------------------------------------------------------------------
--------------------------------------------------------------------------------------------------------------------------------------------------------------------------------------------------------
--------------------------------------------------------------------------------------------------------------------------------------------------------------------------------------------------------
--------------------------------------------------------------------------------------------------------------------------------------------------------------------------------------------------------
--------------------------------------------------------------------------------------------------------------------------------------------------------------------------------------------------------
------------------------------------------------------------------------------------------------------------------------------------------------------------------g-------------------------------------
---------------------------------------------------------------------------------------------------------------------------------------------------------------------------------------%%%%%%%%%%%%%%F%%
---------------------------------------------------------U---kkggkgggkkkgkg------------------------------USC2SSCC----------------------------------g---SCCCCSSS--%%%%%%%%%%%%%%%%%%%%%%||||||||||||||%||
----------------------------------------------------------------CSC2SSCS2----------------------------------------------------------------------------------------|||||||||||||||||||||||||||||||||||||||
--------------------------g------------------------------------------------%%%%%%%%%%%%----------------------------------------g--------%%%%%%%%%%%%-------------|||||||||||||||||||||||||||||||||||||||
------%%%%%----------------------------------------------------------------||||||||||||---------------------------------%%%-------------||||||||||||-------------|||||||||||||||||||||||||||||||||||||||
   XXX|||||XXXXXXX  X XXX----    X    X  XX---- XXX X  X X XXX X      XXXXX||||||||||||---- X XX   XXXX X   XXXX X -----|||----XXXX XXXX|||||||||||| XX XXX XXX  |||||||||||||||||||||||||||||||||||||||