--------------------------------------------------------------------------------------------------------------------------------------------------------------------------------------------------------
-------------------------------------------------------------------- ----------------------------------- ----------- -----------------------------------------------------------------------------------
----------------------------- ------- ----------------------------------------- ------------------------------------------------------------------------------------------------------------------------
-------------------------------- -----------------------------------------------------------------------------------------------------------------------------------------------------------------------
--------------------------------------------------------------------------------------------------------------------------------------------------------------------------------------------------------
------------ -------------------------------------------------------------------------------------------------------------------------------------------------------------------------------------------
------------------------------------------------------------------------------------------------------------------------------------------------------------- ------------------------------------------
-----------------------------------------------------------------------Tt----------------------------------------------------------- -------------------------------------------------------------------
----------------------------------------------- -------------------Tt--tt-------------------------------------------------------------------------------------------------------------------------------
------------------------ t-----------------------------------------tt--tt-------------------------------------------------------------------------------------------------------------------------------
------------------------tt-----------------------------------------tt--tt-------------------------------------------------------------------------------------------------------------------------------
------- ----------------tt----------------------------- ----------%%%%%%%% %%%%%%-%%%%----------G---------------------------G-----F-----G--------------------------------K-G----------------------------
--------G----- ---------tt---------------SS-------------------%%%%%%%%%%%%|||||||-||||----------CC2SU-------------- --------%%%%%-%----%%%%------------------------SU---2SUS--------------G-----------%%
-------%%%%%%%%%%%%%%%%%%%%%%- -------------------------------||||||||||||||||%%%%%%%%%%------------------------------------|||||-|----||||--------------------------------------------%%%%%-%%%%-----||
-------|||||||||| |||||||||||--------------%%%----%%%---------||||||||||||||||||||||||||-------------%%%---%%%%-------------|||||-|----||||----%%%%%-----------------------------------||%%%%%%%%%%---||
  XX  X||||||||||||||||||||||XXXX XXXXXXXX |||--- |||  XXXX   XX   XXXX X    XXXXXX XXX XX  X  XXX XX|||---|||| XXXX   XXXX |||||-|----||||XXX |||||XXXXXX XX   XXXXXXX  XXXXXX XXX  X X ||||||||||X X||