--------------------------------------------------------------------------------------------------------------------------------------------------------------------------------------------------------
--------------------------------------------------------------------------------------------------------------------------------------------------------------------------------------------------------
--------------------------------------------------------------------------------------------------------------------------------------------------------------------------------------------------------
--------------------------------------------------------------------------------------------------------------------------------------------------------------------------------------------------------
--------------------------------------------------------------------------------------------------------------------------------------------------------------------------------------------------------
--------------------------------------------------------------------------------------------------------------------------------------------------------------------------------------------------------
--------------------------------------------------------------------------------------------------------------------------------------------------------------------------------------------------------
--------------------------------------------------------------------------------------------------------------------------------------------------------------------------------------------------------
--------------------------------------------------------------------------------------------------------------------------------------------------------------------------------------------------------
--------------------------------------------------------------------------------------------------------------Tt------------------------------------------------------------------------------------  --
--------------------------------------------------------------------------------------------------------------tt-----------------G------GK-----------------Tt---------------------------------------  --
--------------------------------------------------------------------------------------------------------------tt----K----------%%% %%%%%%%%%%--------------tt------------------K--------------------  --
-------------------------%%%%%%%%%%---------------------------%%%%%%%%%%%-----------------------------G----%%%%%%%%%%%%%%%%%%%%|||%||||||||||--------------tt----------------%%%-------------G---%    %%
-------------------------||||||||||---------------------------|||||||||||---------------------------%%%%%%%||||||||||||||||||||||||||||||||||--------------tt---22CU---------|||-------%%%%%%%%%%|||||||
-------------------------||||||||||---%%%%------%%%%%---------|||||||||||-------------%%%%%%%%%%----|||%%%%||||||||||||||||||||||||||||||||||---------%%%%%%%%%%-------------|||-------|||||||||||||||||
XXXXXXXXXXXXXXXXXXXXXXXXXXXXXXXXXXXXXX||||------|||||XXXXXXXXX|||||||||||XXXXXXXXXXXXX||||||||||XXXXXXX||||||||||||||XXXXXXXXXXXXXXXXXXXXXXXXXXXXXXXXX||||||||||XXXXXXXXXXXXX|||XXXXXXXXXXXXXXXXX|||||||