--------------------------------------------------------------------------------------------------------------------------------------------------------------------------------------------------------
--------------------------------------------------------------------------------------------------------------------------------------------------------------------------------------------------------
--------------------------------------------------------------------------------------------------------------------------------------------------------------------------------------------------------
--------------------------------------------------------------------------------------------------------------------------------------------------------------------------------------------------------
--------------------------------------------------------------------------------------------------------------------------------------------------------------------------------------------------------
--------------------------------------------------------------------------------------------------------------------------------------------------------------------------------------------------------
-----------------------------------------------------------------------------------------------------------------------------------------------------------------------CUSS2----------------------------
--------------------------------------------------------------------------------------------------------------------------------------------------------------------------------------------------------
--------------------------------------------------------------------------------------------------------------------------------------------------------------------------------------------------------
-----------------------------U--------------------------------------------------------------------------------------------------------------------------------------------------------------------------
------------------------------------CCCCC---------------g---g-------------%%%%%%%----------------------------------------------------------------------- %  %%   %% %%%%% %%% --------------------------
---------------------------------kkgkgkgggg-------------------------------|||||||--------------------------------------%%%%%----------------------------||||||||||||||||||||||--------------------------
-------------------------------------------------------------%%%%%---g---g|||g|||--------------------------------------|||||----------------------------||||||||||||||||||||||-k---r--------------------
-------------------------%%%%%%%%---------- %% % %%%% %------|||||--------|||||||----g-----g---g-----------------------|||||--k-------------------------||||||||||||||||||||||--------------------------
------ %%% --------------||||||||----------||||||||||||---- %%%% %%%----%% %%  %% % ----------------------------------X X|||---------------%%  %%%%%%%%%||||||||||||||||||||||% %  %%%%%%%% %%%%%% %%F%%
 X   X|||||XXXXXXXXX XXXX||||||||XX XXXXXXX||||||||||||----|||||||||----||||||||||||---XXX XX XXX---XX XXX     XX----XXX XX X-----XX XXXXXX|||||||||||||||||||||||||||||||||||||||||||||||||||||||||| ||