--------------------------------------------------------------------------------------------------------------------------------------------------------------------------------------------------------
--------------------------------------------------------------------------------------------------------------------------------------------------------------------------------------------------------
--------------------------------------------------------------------------------------------------------------------------------------------------------------------------------------------------------
--------------------------------------------------------------------------------------------------------------------------------------------------------------------------------------------------------
--------------------------------------------------------------------------------------------------------------------------------------------------------------------------------------------------------
--------------------------------------------------------------------------------------------------------------------------------------------------------------------------------------------------------
--------------------------------------------------------------------------------------------------------------------------------------------------------------------------------------------------------
--------------------------------------------------------------------------------------------------------------------------------------------------------------------------------------------------------
--------------------------------------------------------------------------------------------------------------------------------------------------------------------------------------------------------
--------------------------------------------------------------------------------------------------------------------------------------------------------------------------------------------------------
-----------------------------------------G-----------------------------------------------------------------------------------------------------------------------------------G------------------F-------
----------------------------------------%%%%---------------------------2SSU2U---------------%%%-----------------------------%%%%%%F%%%-----------%%%%-----------------------%%%%%%%%%----G------ K------
------------------------------------G---||||-CU2UC2-----------------------------------------GG|---------%%%-----------------||||||%|||-----%%%%--||||-----------------------|||||||||%%%%%-----%%%------
----------------------------------%%%%%%%%%%------------------------------------------%%%%%%%%%---------|||-----------------||||||||||-----||||--||||---------------------K-||||||||||||||-----|||------
----------------------------------||||||||||------------------------------------------|||||||||---------|||-----------------||||||||||-----||||--||||-----------------%%%%%%%%%%%%||||||||-----|||------
XXXXXXXXXXXXXXXXXXXXXXXXXXXXXXXXXX||||||||||XXXXXXXXXXXXXXXXXXXXXXXXXXXXXXXXXXXXXXXXXX|||||||||XXXXXXXXXXXXXXXXXXXXXXXXXXXXXXXXXXXXXXXXXXXXXXXXXXXXXXXXXXXXXXXXXXXXXXX||||||||||||XXX|||||-----|||XXXXXX