--------------------------------------------------------------------------------------------------------------------------------------------------------------------------------------------------------
--------------------------------------------------------------------------------------------------------------------------------------------------------------------------------------------------------
--------------------------------------------------------------------------------------------------------------------------------------------------------------------------------------------------------
--------------------------------------------------------------------------------------------------------------------------------------------------------------------------------------------------------
--------------------------------------------------------------------------------------------------------------------------------------------------------------------------------------------------------
--------------------------------------------------------------------------------------------------------------------------------------------------------------------------------------------------------
--------------------------------------------------------------------------------------------------------------------------------------------------------------------------------------------------------
------------------------------------------------------------CSC-------------------------------------------------------------------------------------------%%%%%%%---------------------------------------
-------------------------------------------------------g---g-g------------------------------------------------------CCS------------------------------r----|||||||---------------------------------------
------------------------------------SCSSC--------------------------------------------------------------------------ggggggk--------------------------------|||||||---------------------------------------
----------------------------------ggggkgggkg---------------------------------------------------------------------r--------------------%%%%%%%%%%%%%%----%%%%%%%%%%%%%-----------------------------------
--------------------------------r--------------------------%%%%%%-----------------------------------------%%%%%%%%--------%%%%%%%%%%%%||||||||||||||----|||||||||||||---------------------------%%    %%
-------------------------%%%%%%%%-----------%%%%%%%%%%-----||||||----------------g------g-----------------||||||||--------||||||||||||||||||||||||||----|||||||||||||---------------k-----------||||| ||
-------------------------||||||||-----------||||||||||-----||||||-----------------------------g--g--------||||||||%%%%%%%%||||||||||||||||||||||||||----|||||||||||||%%%%%%%%%%%%%%-------------||||||||
------%%%%%--------------||||||||%%%%%%%%%%%||||||||||---%%%%%%%%%%%-----%%%----%%%%%%%%%-----------------||||||||||||||||||||||||||||||||||||||||||----|||||||||||||||||||||||||||%%%%%%%%%%%%%||||||||
XXXXXX|||||XXXXXXXXXXXXXX|||||||||||||||||||||||||||||---|||||||||||-----|||----|||||||||----XXXXXXXXXXXXX||||||||||||||||||||||||||||||||||||||||||----||||||||||||||||||||||||||||||||||||||||||||||||