--------------------------------------------------------------------------------------------------------------------------------------------------------------------------------------------------------
--------------------------------------------------------------------------------------------------------------------------------------------------------------------------------------------------------
--------------------------------------------------------------------------------------------------------------------------------------------------------------------------------------------------------
--------------------------------------------------------------------------------------------------------------------------------------------------------------------------------------------------------
--------------------------------------------------------------------------------------------------------------------------------------------------------------------------------------------------------
--------------------------------------------------------------------------------------------------------------------------------------------------------------------------------------------------------
--------------------------------------------------------------------------------------------------------------------------------------------------------------------------------------------------------
--------------------------------------------------------------------------------------------------------------------------------------------------------------------------------------------------------
------------------------------------------------------------------g-------------------------------------------------------------------------------------------------------------------------------------
----------------------------------------SSSSSS2CS------------------------------------------------------------------%%%%%--------------------------------------------------------------------------------
--------------------------------------ggggkgggkkggg----------------------------------------------------------------|%%%%--------------------------------------------------------------------------------
------------------------------------r----------------------------------%%%%%%%----g-----g----g---------------------|||||----------------------------------------------------------%%%%%%%---------------
-------------------------%%%%%%%%%%%%--------------%%%%%%%%%%%%%%------|||||||-----------------------------------%%%%%%%%---------------------------------------------------------|||||||---------------
-------------------------||||||||||||--------------||||||||||||||----%%%%%%%%%%%%---------------------gg---------||||||||--------------------------%%%%%%%%%%%%%%-r---r--k--------|||||||-----------F---
------%%%%%--------------||||||||||||%%%%%%%%%%%%%%||||||||||||||----||||||||||||--------------------------------||||||||-----%%%----%%%%%%%%%%%%%%||||||||||||||-----------------|||||||----------- ---
XXXXXX|||||XXXXXXXXXXXXXX||||||||||||||||||||||||||||||||||||||||----||||||||||||-----XXXXXXXXXXXX---XXXXXXXXXXXX||||||||-----|||----||||||||||||||||||||||||||||XXXXXXXXXX-----XXXXXXXXXXXXXXXXXXXXXFXX