--------------------------------------------------------------------------------------------------------------------------------------------------------------------------------------------------------
--------------------------------------------------------------------------------------------------------------------------------------------------------------------------------------------------------
--------------------------------------------------------------------------------------------------------------------------------------------------------------------------------------------------------
--------------------------------------------------------------------------------------------------------------------------------------------------------------------------------------------------------
--------------------------------------------------------------------------------------------------------------------------------------------------------------------------------------------------------
--------------------------------------------------------------------------------------------------------------------------------------------------------------------------------------------------------
--------------------------------------------------------------------------------------------------------------------------------------------------------------------------------------------------------
--------------------------------------------------------------------------------------------------------------------------------------------------------------------------------------------------------
----------------------------------------------------------------------------------------------------------------------------------------------------------Tt--------------------------------------------
--------------------------------Tt--------------------------------------------------------------------------------------Tt--------------------------------tt--------------------------------------------
--------------------------------tt--------------------------------------------------------------------------------------tt--------------------------------tt--------------------------------------------
--------------------------------K%-----------------------------------------------------------------------------K------K-tt--------F----------------------Ktt----------------------------------2CUSCUU---
---------------------%%%%%%%%%%%||--------------------------G--G--------------------------------------------22USSU--%%%%%%%%%%%%--%------------------%%%%%%%%%%%%-------------%%%%%%%%%-----------------
---------------------||||||||%%%||%%%%%---------C2C--------UCUCU-------------%%%%%---%%%----------G-----------------||||||||||||--|------------------||||||||||||-----%%%%%%%%|||||||||------------F----
---------------------||||||||||||||||||-------------------------%%%%---%%%%--|||||---|||%%%%----%%%-----------------||||||||||||--|----%%%-----------||||||||||||-----|||||||||||||||||------------ ----
XXXXXXXXXXXXXXXXXXXXXXXXXXXXX||||||||||XXXXXXXXXXXXXXXXXXXXXXXXX||||---||||XX|||||---|||||||----|||XXXXXXXXXXXXXXXXX||||||||||||XXXXXXX|||XXXXXXXXXXXXXXXXXXXXXXXXXXXXXXXXXXXX|||||||||XXXXXXXXXXXXXXXXX