--------------------------------------------------------------------------------------------------------------------------------------------------------------------------------------------------------
--------------------------------------------------------------------------------------------------------------------------------------------------------------------------------------------------------
--------------------------------------------------------------------------------------------------------------------------------------------------------------------------------------------------------
--------------------------------------------------------------------------------------------------------------------------------------------------------------------------------------------------------
--------------------------------------------------------------------------------------------------------------------------------------------------------------------------------------------------------
--------------------------------------------------------------------------------------------------------------------------------------------------------------------------------------------------------
--------------------------------------------------------------------------------------------------------------------------------------------------------------------------------------------------------
--------------------------------------------------------------------------------------------------------------------------------------------------------------------------------------------------------
----------------------------------------------------------------%%%%%---------------SSSSCC2CUC--%%%%%%%%%-----------------g---g--g----------------------------------------------------------------------
----------------------------------------------------------------|||||---------------------------|||||||||-----------------------------------------------gg--g-------------------------------------------
-------------------------------------gkkkkgkgggkg---------------|||||----------2USS-------------|||||||||---%%%%%%%%%%%%%-------------------------------------------------------------------------------
-----------------------------------r--||||||||||----------------|||||---------------------------|||||||||---|||||||||||||-----%%%%%%%------------------%%%%%%%%%%%%-----g--------C2SUC2C----------------
-------------------------%%%%%%%%%%%--||||||||||-%%%%%%%%-----%%%%%%%%%-------------------------|||||||||---|||||||||||||-----|||||||------------------||||||||||||-------------------------------------
-------------------------|||||||||||--||||||||||-||||||||-----|||||||||-------------------------|||||||||---|||||||||||||----%%%%%|||------------------||||||||||||----%%%%%%%%-------------------------
------%%%%%--------------|||||||||||%%%%%%%%%%%%%||||||||-----|||||||||%%%%%%%%%%%%-------------|||||||||---|||||||||||||---%%%%%%%%%%%%%----%%%%%%%%%%||||||||||||----||||||||-----------%%%%%%%%    %%
XXXXXX|||||XXXXXXXXXXXXXX||||||||||||||||||||||||||||||||-----|||||||||||||||||||||XXXXXXXXXXXXX|||||||||---|||||||||||||---|||||||||||||----||||||||||||||||||||||----||||||||XXXXXXXXXXX||||||||||| ||