------- --------------------------------------------------------------------------------------- -------------------------- ------------------------------------------------ ----------------- ----------
--------------------------------------------------------------------------------------------------------------------------- ----------------------------------------------------------------------------
---------------------------------------------------------- ------------- -------------------- --------------------------------------------------------------------------------------------------- ------
--------------------------------------------- ----------------------------------------- --------------------------------------- ------------------------------------------------------------------------
------------------------------------------ ------------ ------------------------------------------------------------------ ----------------------------------- ----------------- -----------------------
---------------------------------------------------------------------------------------------------------------------------- ---- -- ------ ----------------- -------------------------- ---------------
------- --------------------------------------- ---------------------------------------------------------------------------------------------- ----- ---------------------------------------------------
--------------- ----------------------------------------------------------------------------------------------- ------- --------------------------------------------------------------------------------
------------------------ ------------ ------------------------------------------------------------- ------- -----------------U--------------------------------------------------------------------------
----------------------------------------------- ---------------------------- --------------------------------------------------------  S 2S----------------- -------- -----CCC22S--- ---- --------------
------------------------------------------------------------------------------- CCCCS S---------------------------- -------------------------------------------------------------------------%%% %%%% F%
- -------------------------------%% %------ ---------------------------------             - -------------- --------------- ------             ----- --------%%%%%%% %%%%-----------%%%%% %%%% |||||||%||
---------------------------------||||-------------------------------------- ------------------------------------------ %% %%%%%%%---------------------------||||||||||||------- ---|||||||||||||||||||||
--------------------------------% %% ----- ------------------------% %% %%% --------------%   %%%%--------------------|||| ||||||-------------%%  % %%%%%%%%||||||||||||%%% %%%%  %||||||||||||||||| |||
------%%% %---------------------||| |-------- ---------------------|||||||||------- ------||| ||||--------- ----------| |||||||||-------------||||||||||||||||||||||||||||||||||||||||||||||||||||||||||
 X X X|||||XXXXXXXXXXXXXX-----XXXXXXXX---X XXX XXXX XXX--- XXXX XXX|||||||||XX  XXXXXXX X |||||| |---XXXX X XX X X----|||| ||||||XX XXXXXXXXX ||||||||||||||||||||||||||||||||||||||||||||||||||||| ||||