----------------------------------------------------------------------------------------- -------- ---- ---------- ---------------------------------------------------------------- --- ----------------
----------- ----------------------------------------------- -------------------------------------------------------  ------------------------------------------- ---------------------------------------
---------------------------------------------------------------------------------------------- ---------------------------------------------------------------------------------------------------------
------------------------- -------- ----- ------------------ -------------------- ------------------------------------------------------------------------------ ----------------------------------------
--------------------------- ------------------------------------------------------------------------------------------------------------------------------------------------------------------- -- -----
--------------------- -------- --- ----------------------------------------------------------- -------------------------------------------------------------------------------- --- ------------------ -
---------------------------------------------------------------------------- ------------------------------------------------------------------------------- ------------ ------------------------------
---------------------------------------------------------------------- ---------------- ------------------------- ---- ---------------- ----------------------------------- ----------------------------
- --  --------------------------------- -------------------------------- -------------------------------------------------------------- ------ -------------------------------------------- ------------
 --------------------------------------------------------------------------------------------------------------------Tt---------------------------------- ---------------------Tt-----------------------
--------------------------------------------------------------------------------------------------- ------------ ----tt----------------------------- ----- --------------------tt--------- ---------- --
------------CCCC2U%%%%%% %- C22U22C----------  ------------------------ -- -----------%%%%%%-------------------------tt----------- -------------- -----------------------------tt-------------------%%%%
-- ---------------||||||||--------------- -------------------------------------------- |||||UUC-----------------%%%%%%%%  --%%%%--%%%%%--- ---- - -----CS-------------------%%%%%%%%%------ --------||||
------------------||||||||---- -------%%%---% %%--%%%%%------%%%%-2SSC2S%%%%-%%%%%% --||||||-- -----------------|||| |||||--||||--|||||------%%%% %%%%%%----- ------ -- ----|||||||||---------------||||
-------- ---------||||||||------------|||---||||--|||||------||||-------||||-|||%%%---||||||--------------------||||||||| --||||--|||||-- ---|||| ||| ||-%%%------%%%%------|||||||||---------- ----|%%%
XXX  XXXXXXX X X XXXXXXXX  XXXX   XXXX|||---||||X |||||------||||X  XXXXXXX X X |||  X X  XXXXX X X XX   XX     |||||||||| X |||--|||||X    XXXXX XXX X  |||------||| XXXXXX||||||||| XXX XXX  X XX  |||