--------------------------------------------------------------------------------------------------------------------------------------------------------------------------------------------------------
--------------------------------------------------------------------------------------------------------------------------------------------------------------------------------------------------------
--------------------------------------------------------------------------------------------------------------------------------------------------------------------------------------------------------
--------------------------------------------------------------------------------------------------------------------------------------------------------------------------------------------------------
--------------------------------------------------------------------------------------------------------------------------------------------------------------------------------------------------------
--------------------------------------------------------------------------------------------------------------------------------------------------------------------------------------------------------
--------------------------------------------------------------------------------------------------------------------------------------------------------------------------------------------------------
--------------------------------------------------------------------------------------------------------------------------------------------------------------------------------------------------------
--------------------------------------------------------------------------------------------------------------------------------Tt----------------------------------------------------------------------
--------------------------------------------------------------------------------------------------------------------------------tt----------------------------------------------------------------------
-----------------------------Tt-------------------------------------------------------------------------------------------------tt----------------------------------------------------------------------
-----------------------------tt-------------------------------------------------------K----------------------------------------GttFG--------------------------------------G-----------------------------
----------K----------------K-tt----------------------------------------------------%%%%%222CCU--------------------------SUC%%%%%%%%%%-------------------------%%%%---%%%%%C2U-------------------------%%
-------%%%%%-%%%-----%%%--%%%%%%%%-----------K--------G----------------------------|||||-----------------------------------||||||||||-------------------------||||---|||||---%%%%%------%%%%--------F-||
-------|||||-|||-----|||--||||||||-------%%%%%%%%%%--%%%-------------%%%%%%--------|||||-----------------------------------||||||||||-------------------------||||---|||||---|||||------||||-------- -||
XXXXXXX|||||X|||-----|||XX||||||||XXXXXXX||||||||||--|||XXXXXXXXXXXXX||||||XXXXXXXXXXXXXXXXXXXXXXXXXXXXXXXXXXXXXXXXXXXXXXXX||||||||||XXXXXXXXXXXXXXXXXXXXXXXXX||||---|||||XXX|||||------||||XXXXXXXXXXXX