--------------------------------------------------------------------------------------------------------------------------------------------------------------------------------------------------------
--------------------------------------------------------------------------------------------------------------------------------------------------------------------------------------------------------
-----------------------------------------------------------------------------------U--------------------------------------------------------------------------------------------------------------------
-------------------------------------------------------------------------------------------SCCCSS-------------------------------------------------------------------------------------------------------
--------------------------------------------------------------------------------------------------------------------------------------------------------------------------------------------------------
---------------------------------------------------------------------------------------ggkgggkgggggk----------------------------------------------------------------------------------------------------
----------------------------------------------------------------------------%%%%%%%%%%%-----------------------------%%%%%-------------------------------------------------------------------------------
----------------------------------------------------------------------------|||||||||||-------------%%%%%%%%%%%-----|||||-------------------------------------------------------------------------------
----------------------------------------------------------------------------|||||||||||-------------|||||||||||-----|||||--------------------------------k-------r-k------SC2SSSSCCS--------------------
---------------------------------------CCSUSCSS--%%%%%%%%%%%----------------|||||||||||%%%%%%%%%%%%%|||||||||||-----|||||-------------------------------------------------------------------------------
-------------------------------------------------|||||||||||---%%%%%%%%%%%%%|||||||||||||||||||||||||||||||||||---%%%%%%%%----%%%%%%%%%%%%%%%%%%%%%%%%%%----%%%%%%%%%%%%--------------------------------
--------------------------------SSUSCS-----------|||||||||||---||||||||||||||||||||||||||||||||||||||||||||||||---||||||||----||||||||||||||||||||||||||----||||||||||||--------------------------------
-------------------------------------------------|||||||||||---||||||||||||||||||||||||||||||||||||||||||||||||---||||||||----||||||||||||||||||||||||||----||||||||||||%%%%%%%%%%%%%%------------------
-------------------------------------------------|||||||||||---||||||||||||||||||||||||||||||||||||||||||||||||---||||||||----||||||||||||||||||||||||||----||||||||||||||||||||||||||------------------
------%%%%%--------------------------------------|||||||||||---||||||||||||||||||||||||||||||||||||||||||||||||---||||||||----||||||||||||||||||||||||||----||||||||||||||||||||||||||---%%%%%%%%%    %%
XXXXXX|||||XXXXXXXXXXXXXXXXXXXXXXXXXXXXXXXXXXXXXX|||||||||||---||||||||||||||||||||||||||||||||||||||||||||||||---||||||||----||||||||||||||||||||||||||----||||||||||||||||||||||||||---|||||||||||| ||