-----------------------------------------------------------------------------------------------------------------------------       --------------------------------------------------------------------
-----------------------------------------------------------------------------------------------------------------------------       --------------------------------------------------------------------
-----------------------------------------------------------------------------------------------------------------------------       --------------------------------------------------------------------
-----------------------------------------------------------------------------------------------------------------------------       --------------------------------------------------------------------
-----------------------------------------------------------------------------------------------------------------------------       --------------------------------------------------------------------
-----------------------------------------------------------------------------------------------------------------------------       --------------------------------------------------------------------
-----------------------------------------------------------------------------------------------------------------------------       --------------------------------------------------------------------
-----------------------------------------------------------------------------------------------------------------------------       --------------------------------------------------------------------
-----------------------------------------------------------------------------------------------------------------------------       --------------------------------------------------------------------
------------------------------------------------------------Tt-------------------Tt------Tt----------------------------------       --------------------------------------------------------------------
---------------------------------G--------------------------tt-------------------tt------tt----------------------------------       -----------------------------------------------------------------Tt-
----------------------------2S2SUSU-------------------------tt-------------------tt------tt------------------------UCC-------       ---------------------------Tt------------------------------------tt-
------------------C----------------------%%%%----%%%-----%%%%%%%%-%%%%%%%%%%%%%%%%%%%%%%-tt---%%%%%%--------G----------------       %%%%%-%----%%%%------------tt----%%%%------%%%%-----------------Gtt-
-------------------%%%--%%%%-------------||||----|||-----||||||||-||||||||||||||||||||%%%%%%%%||||||--------%%%%-----G-------       |||||%|%%%-||||------------tt----||||------||||----CUCCUU---%%%%%%%%
-------------------|||--||||--------%%%%%||||----|||-----||||||||-||||||||||||||||||||||||||||||||||--------||||----%%%%%%---       ||||||||||-||||--------%%%%%%%%%-||||------||||-------------||||||||
XXXXXXXXXXXXXXXXXXX|||--||||XXXXXXXX|||||||||----|||XXXXXXXXXXXXXX||||||||||||XXXXXXXXXXXXXXXXXXXXXXXXXXXXXXXXXXXXXX||||||XXX       |||||XXXXXX||||XXXXXXXX|||||||||X||||------||||XXXXXXXXXXXXX||||||||