--------------------------------------------------------------------------------------------------------------------------------------------------------------------------------------------------------
--------------------------------------------------------------------------------------------------------------------------------------------------------------------------------------------------------
--------------------------------------------------------------------------------------------------------------------------------------------------------------------------------------------------------
--------------------------------------------------------------------------------------------------------------------------------------------------------------------------------------------------------
--------------------------------------------------------------------------------------------------------------------------------------------------------------------------------------------------------
--------------------------------------------------------------------------------------------------------------------------------------------------------------------------------------------------------
--------------------------------------------------------------------------------------------------------------------------------------------------------------------------------------------------------
--------------------------------------------------------------------------------------------------------------------------------------------------------------------------------------------------------
------------------Tt------------------------------------------------------------------------------------------------------------------------------------------------------------------------------------
------------------tt-----------------------------------------------------------------------Tt-----------------------------------------------------------------------------------------------------------
------------------tt-----------------------------------------------------------------------tt-----------------------------------------------------------------------------------------------------------
------------------tt--------K-----------%%%%%%---------------------------------------------tt-------------------------------------F----------------------------------------------------------G----------
--------------%%%%%%-%%%---%%%----%%%%--||||||---------------------------------------------tt--G----------------------------------%-----------------------------------%%%%%%%%%%%%%%%%----%%%%----------
--------------|%%%%%%%%%%%-|||----||||--||||||------------------------------------------%%%%%%%%----------------------------------|----------------U2-----------------||||||||||||||||----||||---F------
--------------||||||||||||-|||----||||--||||||-------------------------------%%%%%------||||||||----------------------------------|-----------------------------------||||||||||||||||----||||--- ------
XXXXXXXXXXXXXXXXXXXXXXXXXXX|||----||||XXXXXXXXXXXXXXXXXXXXXXXXXXXXXXXXXXXXXXX|||||XXXXXXXXXXXXXXXXXXXXXXXXXXXXXXXXXXXXXXXXXXXXXXXXXXXXXXXXXXXXXXXXXXXXXXXXXXXXXXXXXXXXXXXXXXXXXXX|||||----||||XXXXXXXXXX