--------------------------------------------------------------------------------------------------------------------------------------------------------------------------------------------------------
--------------------------------------------------------------------------------------------------------------------------------------------------------------------------------------------------------
--------------------------------------------------------------------------------------------------------------------------------------------------------------------------------------------------------
--------------------------------------------------------------------------------------------------------------------------------------------------------------------------------------------------------
--------------------------------------------------------------------------------------------------------------------------------------------------------------------------------------------------------
--------------------------------------------------------------------------------------------------------------------------------------------------------------------------------------------------------
--------------------------------------------------------------------------------------------------------------------------------------------------------------------------------------------------------
-------------------------------------------------------------------------------Tt-----------------------------------------------------------------------------------------------------------------------
-------------------------------------------------------------------------------tt----------------------------------Tt-----------------------------------------------------------------------------------
----------Tt-------------------------------------------------------------------tt----------------------------------tt-------------------Tt--------------------------------------------------------------
----------tt-----------Tt------------------------------------------------------tt----------------------------------tt-------------------ttG-------------------------------------------------------------
--------GKtt-----------tt--------------------------------------------------%%%%%%%%%-------------------------------tt--%%%%%%%%%%- -----tt%%GK%%%-------------------------------------------------------
-------%%%%%%%%%-------tt--G-----------------------------------------------||||||%%%%--------------------------%%%%%%%%%%||||||||-%--%%%%%%%%%|||--------%%%%%------%%%---------------------------------
-------|||||||||--%%%%%%%%%%%%---------------------------------------------||||||||||----------------G-G-------|||||K||||%%%%||||-|--||||||||||||--------|||||------|||----------------------------G----
-------|||||||||--||||||||||||---------------------------------------------||||||||||-------%%%%%---%%%%%------|||||%%%%|||||||||-|--||||||||||||--------|||||------|||-----%%%%%%%%--------------   ---
XXXXXXX|||||||||XX||||||||||||XXXXXXXXXXXXXXXXXXXXXXXXXXXXXXXXXXXXXXXXXXXXXXXXXXX||||XXXXXXX|||||---|||||XXXXXXXXXXX||||XXXXXXXXXXXXX|||||||||XXXXXXXXXXX|||||------|||XXXXX||||||||XXXXXXXXXXXXXX|||---