-----------------------------------------------------------------------------------------------------------------------------      ---------------------------------------------------------------------
-----------------------------------------------------------------------------------------------------------------------------      ---------------------------------------------------------------------
-----------------------------------------------------------------------------------------------------------------------------      ---------------------------------------------------------------------
-----------------------------------------------------------------------------------------------------------------------------      ---------------------------------------------------------------------
-----------------------------------------------------------------------------------------------------------------------------      ---------------------------------------------------------------------
-----------------------------------------------------------------------------------------------------------------------------      ---------------------------------------------------------------------
-----------------------------------------------------------------------------------------------------------------------------      ---------------------------------------------------------------------
-----------------------------------------------------------------------------------------------------------------------------      ---------------------------------------------------------------------
-----------------------------------------------------------------------------------------------------------------------------      ---------------------------------------------------------------------
-----------------------------------------------------------------------------------------------------------------------------      ---------------------------------------------------------------------
-----------------------------------------------------------------------------------------------------------------------------      ---------------------------------------------------------------------
--------------G---------------------------------------------------------------------%%%%%%-----------------------------------      -------------------K-------------------------------------------------
-----------%%%%%--%%%-----------------%%%%--%%%%---------------------%%%%%%---------||||||--%%%---%%%%%------------G---------      ----------%%%-----%%%------------K-----------------------------------
-----------|||||--|||-----UU2UU-------||||--||||---------------------||||||G-----G--||||||--|||---|||||---%%%%%---%%%%-------      ----------|||-----|||%%%%------%%%--G--------%%%---%%%%--------------
-----------|||||--|||-----------------||||--||||-------%%%%%%%%------||||||%%%--%%%%||||||--|||---|||||---|||||---||||-------      ----------|||-----|||||||------|||-%%%-------|||---||||---------%%%%-
XXXXXXXXXXX|||||--|||XXXXXXXXXXXXXXXXX||||--||||XXXXXXX||||||||XXXXXXXXXXXX|||--||||XXXXXXXX|||---|||||XXX|||||---||||XXXXXXX      XXXXXXXXXX|||-----|||||||------|||X|||XXXXXXX|||---||||XXXXXXXXX||||-