--------------------------------------------------------------------------------------------------------------------------------------------------------------------------------------------------------
--------------------------------------------------------------------------------------------------------------------------------------------------------------------------------------------------------
--------------------------------------------------------------------------------------------------------------------------------------------------------------------------------------------------------
--------------------------------------------------------------------------------------------------------------------------------------------------------------------------------------------------------
--------------------------------------------------------------------------------------------------------------------------------------------------------------------------------------------------------
--------------------------------------------------------------------------------------------------------------------------------------------------------------------------------------------------------
--------------------------------------------------------------------------------------------------------------------------------------------------------------------------------------------------------
--------------------------------------------------------------------------------------------------------------------------------------------------------------------------------------------------------
-------------------------------------------------------------g-------------------------------------------------------------------------------g-----g--------------------------------%%%%%---------------
------------------------------------------------------------------------------------------------------------------------------------------------------------------------------------|||||---------------
--------------------------------------kggggggkkk-------------------------------------------------------------------------------g-g----------%%%%%%%%%%------------------------------|||||---------------
------------------------------------r--||||||||---------------------------g--g-----g--------------------kggggggggg------------------%%%%%%--||||||||||--g%%%%%%%%%%%%%--------------|||||---------------
-------------------------%%%%%%%%%%%%--||||||||-%%%%%%%%%%%%%-----------------------------------------------------------------------||||||--||||||||||---|||||||||||||------------%%%%%%%%%-------------
-------------------------||||||||||||--||||||||-|||||||||||||----------------------g------------------r-----------%%%%%%%%%%%%%-----||||||--||||||||||---|||||||||||||-----g-g----|||||||||-------------
------%%%%%--------------||||||||||||%%%%%%%%%%%|||||||||||||----%%%%%%%%----------------%%%%%%%%%%%%%%-----------|||||||||||||---%%%%%%%%%%||||||||||---|||||||||||||------------|||||||||%%%%%%%    %%
XXXXXX|||||XXXXXXXXXXXXXX||||||||||||||||||||||||||||||||||||----||||||||-----XXXXXXXXXXX||||||||||||||XXXXXXXXXXX|||||||||||||---||||||||||||||||||||---|||||||||||||----XXXXXXXX||||||||||||||||||| ||