--------------------------------------------------------------------------------------------------------------------------------------------------------------------------------------------------------
--------------------------------------------------------------------------------------------------------------------------------------------------------------------------------------------------------
--------------------------------------------------------------------------------------------------------------------------------------------------------------------------------------------------------
--------------------------------------------------------------------------------------------------------------------------------------------------------------------------------------------------------
--------------------------------------------------------------------------------------------------------------------------------------------------------------------------------------------------------
--------------------------------------------------------------------------------------------------------------------------------------------------------------------------------------------------------
--------------------------------------------------------------------------------------------------------------------------------------------------------------------------------------------------------
-----------------------------------------------------------------------------U--------------------------------------------------------------------------------------------------------------------------
----------------------------------------------------------------------------------------------------------gg--------------------------------------------------------------------------------------------
-----------------------------------------------------------------------------------%%%%%%%----------------------%%%%%-----------------------------------------------------------------------------------
---------------------------------------------------------------------------------ggggggkggkk--------------------|||||-----------------------------------------------------------------------------------
--------------------------------------ggkggkkggg--------------%%%%%-%%%%%%%%%%%%%--|||||||----------------------|||||-------%%%%%%---------------------------------------------------CCSSSCU------------
---------------------------------------%%%%%%%%---------------|||||-|||||||||||||--|||||||--%%%%%%%%%%%%%-------|%%%|-------||||||------------g-----g-----------------------------------------%%%%    %%
------------------------------------r--||||||||-%%%%%%%%%-----|||||-|||||||||||||--|||||||--|||||||||||||-----%%%%%%%%%-----|%%%%|--------------------------g-----g------%%%%%%%%%%-----------||||||| ||
------%%%%%--------------%%%%%%%%%%%%--||||||||-|||||||||---%%%%%%%%|||||||||||||%%%%%%%%%%%|||||||||||||-----|||||||||-----||||||-----------%%%%%%%%%%%-----------------||||||||||-----------||||||||||
XXXXXX|||||XXXXXXXXXXXXXX||||||||||||XXXXXXXXXXX|||||||||---|||||||||||||||||||||||||||||||||||||||||||||-----|||||||||---XXXXXXXXXXXXXXXXXXX|||||||||||---XXXXXXXXXXXXXX||||||||||XXXXXXXXXXX||||||||||