--------------------------------------------------------------------------------------------------------------------------------------------------------------------------------------------------------
--------------------------------------------------------------------------------------------------------------------------------------------------------------------------------------------------------
--------------------------------------------------------------------------------------------------------------------------------------------------------------------------------------------------------
--------------------------------------------------------------------------------------------------------------------------------------------------------------------------------------------------------
--------------------------------------------------------------------------------------------------------------------------------------------------------------------------------------------------------
--------------------------------------------------------------------------------------------------------------------------------------------------------------------------------------------------------
--------------------------------------------------------------------------------------------------------------------------------------------------------------------------------------------------------
-----------------------------------------------------------------------------------------------------------------------------------------------------------------------Tt-------------------------------
------------------------------Tt---------------------------------------------------------------------------------------------------------------------Tt----------------tt-------------------------------
------------------------------tt---------------------------------------------------------------------------------------------------------------------tt----------------tt-------------------------------
------------------------------tt---------------------------------------------------------------------------------------------------------------------tt----------------tt-------------------------------
-------------------------%%%%%%%%%%-----------------------------------------------------------------------------------------------F-----------G--%%%%%%%%%%%-------%%%%%%%%%----------------------------
-------------------K--G--||||||||||--------------------G---------------------------------------------------G-------------------%%%%---------%%%%-|||||||||||-------|||||||||----------------------------
------------------%%%%%%-||||||||||-------------------2U----------------------------%%%%%%--------------K-SSU------------------||||------%%%%%%%%%%|||||||||-------SSS2UUC||-----------%%%%-----F-------
------------------||||||-||||||||||----------%%%---%%%------------------------------||||||-----%%%---%%%%%---------------------||||------|||||||||||||||||||-------|||||||||-----------||||----- -------
XXXXXXXXXXXXXXXXXXXXXXXXXXXXXXXXXXXXXXXXXXXXX|||---|||XXXXXXXXXXXXXXXXXXXXXXXXXXXXXX||||||XXXXX|||---|||||XXXXXXXXXXXXXXXXXXXXXXXXXXXXXXXXXXXXXXXXXXXXXXXXXXXXXXXXXXXXXXXXXXXXXXXXXXXXXXXXXXXXXXXXXXXXXX