--------------------------------------------------------------------------------------------------------------------------------------------------------------------------------------------------------
--------------------------------------------------------------------------------------------------------------------------------------------------------------------------------------------------------
--------------------------------------------------------------------------------------------------------------------------------------------------------------------------------------------------------
--------------------------------------------------------------------------------------------------------------------------------------------------------------------------------------------------------
--------------------------------------------------------------------------------------------------------------------------------------------------------------------------------------------------------
--------------------------------------------------------------------------------------------------------------------------------------------------------------------------------------------------------
--------------------------------------------------------------------------------------------------------------------------------------------------------------------------------------------------------
-----------------------------------------------------------------------------------------------k--------------------------------------------------------------------------------------------------------
--------------------------------------------------------------------------------------------%%%%%-------------------------------------------------------------------------------------------------------
----------------------------------------------tt--------------------------------------------|||||--------#--#-------------------------------------------------------------------------------------------
-------------------------------------------tt-tt--------------------------------------------|||||-------##--##------------------------------------------------------------------------------------------
-------------------------------------------tt-tt--------------#--#-----SCUC2----------------|||||-k----###--###-----------------------------------------------------------------------------------------
-----------------------------------------%%%%%%%%%%----------##--##------------------------%%%%%%%%%%%%%%%--%%%%%--------%%%%%--------------------------------------------------------------------------
-----------%%%%%%---%%%------------------||||||||||%%%%%%%--###--###-----------------------|||||||||||||||--|||||--------|||||---#---#---%%%%%%%% %%%%%%%%%%%%%%%%%%%%%%%%%%%%%%%%%%%%%%%%%%%%%%%%    %%
-----------||||||---|||--#--#------------|||||||||||||||||%%%%%--%%%%%-------%%%%---%%%%%%%|||||||||||||||--|||||%%%--%%%|||||--##---##--||||||||%||||||||||||||||||||||||||||||||||||||||||||||||||||||
XXXXXXXXXXX||||||---|||XXX--XXXXXXX--XXXX||||||||||||||||||||||--|||||XXXXXXX||||---||||||||||||||||||||||--||||||||--||||||||XXXX---XXXX|||||||||||||||||||||||||||||||||||||||||||||||||||||||||||||||