--------------------------------------------------------------------------------------------------------------------------------------------------------------------------------------------------------
--------------------------------------------------------------------------------------------------------------------------------------------------------------------------------------------------------
--------------------------------------------------------------------------------------------------------------------------------------------------------------------------------------------------------
--------------------------------------------------------------------------------------------------------------------------------------------------------------------------------------------------------
--------------------------------------------------------------------------------------------------------------------------------------------------------------------------------------------------------
--------------------------------------------------------------------------------------------------------------------------------------------------------------------------------------------------------
--------------------------------------------------------------------------------------------------------------------------------------------------------------------------------------------------------
--------------------------------------------------------------------------------------------------------------------------------------------------------------------------------------------------------
--------------------------------------------------------------------------CCSSSCC2CUC2-%%%%%%%%%%%%%%-g----------------------U--------------------------------------------------------------------------
---------------------------------------------------------------------------------------||||||||||||||-------------------------------C2C2SS--------------------------------------------------------------
--------------------------------------------------------------------SCU2SS-------------||||||||||||||%%%%%%%%%%%%%--------------------------------------------------------------------------------------
---------------------------------------------------------------------------------------|||||||||||||||||||||||||||---------------kggkgggkkggr-----------------r-------------------k------%%%%%%%%%    %%
-------------------------------%%%%%%%----------%%%%%%%%-------------------------------|||||||||||||||||||||||||||-----%%%%%%%%%%--------------------------------------------------------|||||||||||| ||
--------------------------g----|||||||-----g----||||||||-------------------------------|||||||||||||||||||||||||||-----||||||||||------------%%%%%%%%%%%%----%%%%%%%%%-----------%%%%%%%%|||||||||||||||
------%%%%%--------------------|XXX|||----------||||||||----%%%%%%%%%%%%%--------------|||||||||||||||||||||||||||-----||||||||||------------||||||||||||----|||||||||-----------|||||||||||||||||||||||
XXXXXX|||||XXXXXXXXXXXXXX----XXXXXXXXXXXXX----XXXXXXXXXXXXXX|||||||||||||XXXXXXXXXXXXXX|||||||||||||||||||||||||||-----||||||||||XXXXXXXXXXXX||||||||||||----|||||||||XXXXXXXXXXX|||||||||||||||||||||||