--------------------------------------------------------------------------------------------------------------------------------------------------------------------------------------------------------
-----------------------------------------------------     ----------------------------------------------------------------------------------------------------------------------------------------------
------------------------------------------------------------------------------ -------------------------------------------------------------------------------------------------------------------------
---------------------------------- ---------------------------------------------------------------------------------------------------------------------------------------------------------------------
------------------------------------------------------- -------------------------------SSUCS C--%%%%%%%%%-----------------------------------------------------------------------------------------------
------------------------------------------------------------------------------------------------|||||||||-----------------------------------------------------------------------------------------------
-------------------------------------------------------------------------------2S2SSU-----------|||||||||-------%%%%%%%---------------------------------------------------------------------------------
---------------------------------U--------------------------------------------------------------|||||||||-------|||||||-------------------U ------------------------------------------------------------
------------------------------------------------------------------------------------------------|||||||||-gg----||k||||-------------------------------------------------- %% ---------------------------
---------------------------------------%%%%%%%--------------g-g-g%%%% --------------------------|||||||||------%%%%||||-------r---k--------------------------------------|%%  %%------------------------
----------- ------ ------------------kgggkggggkk-----------------|||||-%%%%%% %%%%%%%-----------|||||||||----  %%% %%% %%%-----------------------------------------------|||||||-----CS 2CSS------------
-------------------------%%%%  %%%%%%--|||||||-------------------| %%%-||||||||||||||%%%%% %%%% |||||||||-----||||||||||||---%%%% %%%%%%%%%%  %---------------- -- -----%%%%%%%% %%---------------------
-------------------------||||||||||||--|||||||--%  %%%% %%%------|||||-|||||||||||||||||||||||||||||| |||-----||||||||||||---||||||||||||||||||-------------------------|||||||||||------------%%%%%%F%%
-------------------------||||||||||||--|||||||--|||||||||||----%%%% %%%||||||||||||||||||||||||||||||||||-----||||||||||||---||||||||||||||||||-------------------------|||||||||||------------||||||%||
------ %%%%--------------||||||||||||%%%%%%%%%%%|||||||||||----||||||||||||||||||||||||||||||||||||||||||-----||||||||||||---||||||||||||||||||-------------------------|||||||||||%%%%%%%%%%%%|||||||||
 X XXX|||||XXXX XXXX XXXX||||||||||||||||||||||||||||||||||----||||||||||||||||||||||||||||||||||||||||||-----||||||||||||---||||||||||||||||||-----XXXXXXXXXXX XXXXXXXX||||||||||||||||||||||||||||||||