-------------------------------------------------------------------------------------------------------------------------------         ----------------------------------------------------------------
-------------------------------------------------------------------------------------------------------------------------------         ----------------------------------------------------------------
-------------------------------------------------------------------------------------------------------------------------------         ----------------------------------------------------------------
-------------------------------------------------------------------------------------------------------------------------------         ----------------------------------------------------------------
-------------------------------------------------------------------------------------------------------------------------------         ----------------------------------------------------------------
-------------------------------------------------------------------------------------------------------------------------------         ----------------------------------------------------------------
-------------------------------------------------------------------------------------------------------------------------------         ----------------------------------------------------------------
-------------------------------------------------------------------------------------------------------------------------------         ----------------------------------------------------------------
---------------Tt--------------------------------------------------------------------------------------------------------------         ----------------------------------------------------------------
---------------tt--------------------------------------------------------------------------------------------------------------         -------------------------------------------------Tt-Tt----------
---------------tt--------------------------------------------------------------------------------------------------------------         --------------------------------Tt---------------tt-tt----------
------------USSSt--------------------CS2U----------------------G-G----K--------------------------------------------------------         %%%%%%%%%-----%%Tt%%%%%%%%%-----tt-----------%%%%%%%Tt%%--------
----------%%%%K%%%-%---------%%%--%%%-----------------------CSUC%%%---%%%%-----------------------------------------%%%--%%%----         |||||||||-----||tt||||||%%%%-%%%tt%%%%%%%%---|%%%%%%tt%|--------
----------|||%%%%%%%%%%%----%|||%%|||-%%%----------------------C|||---||||-%%%%------------%%%%--------------------|||--|||----         |||||||||--%%%||tt|||||||||%%|||%%||||||||U2SS|||%%%%%%%%-------
----------||||||||||||||----|||||||||-|||-----------------------|||---||||-||||---%%%--%%%%||||----%%%%%------%%%%%|||--|||%%%%         |||||||||--%%%%%%%%%%%%|||||||||||||||||||---||||||||||||-------
XXXXXXXXXXXXXXXXXXXXXXXXXXXX|||||||||X|||XXXXXXXXXXXXXXXXXXXXXXX|||---||||X||||XXX|||--||||||||XXXX|||||------||||||||--|||||||         XXXXXXXXXXX||||||||||||XXXX|||||||||||XXXXXXXXXXXXXXXXXXXXXXXXXX