--------------------------------------------------------------------------------------------------------------------------------------------------------------------------------------------------------
---------------------------------------------------------------------------------------------------------------------------------------------------- ---------------------------------------------------
---------------------- ------------------------------------------------------------------------------------------ ----------- --------------------------------------------------------------------------
--------------------------------------------------------------------------------------------------------------------------------- ----------------------------------------------------------------------
---------------------------------------- ---------------------------------------------------------------------------------------------------------------------------------------------------------------
------------------------------------------------------- -------- ---------------------------------------------------------------------------------------------------------------------------------------
-------------------------------------------------------------- ----------------------------- -----------------------------------------------------------------------------------------------------------
------------------ ------------ ------------------------------------------------------------------------------------------------------------------------------------------------------------------------
------- --------------------------------------------------------- ------------------- ------------------- ---------------------------------------------------------- ------------------ -- -------------
----------------- -------------------------------------------------------------------- ------------T -------------------------------------- ------------------------------------------------------------
----------------------------------------------------------------------------------------- ---------tt-------------------------------------------------------------------------------------------------- 
-----------------------------------------------------K----------------------G----------------------tt-----------------------------F-CU ---------------K-------------------------%%%  --G--%%% ----------
---------------------------------------------------- %%----K----------------%%%%% -------------%%%%% %%  ----------K--------------       % %%-------US2CS2--------------------% %%%%%%%%--||||----------
------------------------ ------------K--------------|||---%%%%%%%%--%%%%%%%%%|||||-------------||||||||||---%%%%--%%%-------------|||| ||||||----------------------- ---------||||||||||--||||----------
-----------------------------------%%%%% % %%%%-----|||---||||||||--||||||||||||||-------------||||||||||---||||--|||-------------|||||||||||------ ------%%%------% %%-------||||||||||--||||--%%%%% %%
 X X XXXX XXXXXXXX XXXXXXXXXXXXXXXX|||||||||||| X  X|||XXX|||||||| X|||||||||XXXXXXXX XX X X XX||||||||||XXX||||--||| XXXX XXXXXXXXXXXXXXXXXX X XXXXXXXXXX|||------||||XXXXXXXXXXXX X XXXXXXXXXX||||||||