--------------------------------------------------------------------------------------------------------------------------------------------------------------------------------------------------------
--------------------------------------------------------------------------------------------------------------------------------------------------------------------------------------------------------
--------------------------------------------------------------------------------------------------------------------------------------------------------------------------------------------------------
--------------------------------------------------------------------------------------------------------------------------------------------------------------------------------------------------------
--------------------------------------------------------------------------------------------------------------------------------------------------------------------------------------------------------
--------------------------------------------------------------------------------------------------------------------------------------------------------------------------------------------------------
--------------------------------------------------------------------------------------------------------------------------------------------------------------------------------------------------------
--------------------------------------------------------------------------------------------------------------------------------------------------------------------------------------------------------
--------------------------------------------------------------------------------------------------------------------------------------------------------------------------------------------------------
-------------------------------------------------------------------------------------------------------U------------------------------------------------------------------------------------------------
---------------------------------------ggggggkk--------------------------------------------g------------------------------------------------------------------------------------------------------------
-------------------------------------r--||||||-------------------------------------------------------------ggkggggkgggg------------------%%%%%%-----%%%%%%-----%%%%%------------------------------------
-------------------------%%%%%%%%%%%%%--||||||-%%%%%%%%%%%%------%%%%%%--------------------------------------||||||||-------------------%%%%%||-----||||||-----|||||------------------------------------
-------------------------|||||||||||||--||||||-||||||||||||------||||||----g---------g-------%%%%%%%%%%%%%%--||||||||--%%%%%%%%%%%------|||||||-----||||||-----|||||---g-k-r---------------------F------
------%%%%%--------------|||||||||||||%%%%%%%%%||||||||||||-----XXXXXXX----------------------||||||||||||||--||||||||--|||||||||||------|||||||-----||||||-----|||||----------------------------- ------
XXXXXX|||||XXXXXXXXXXXXXX||||||||||||||||||||||||||||||||||----XXXXXXXXXXX---XXXXXXXXXXXX----||||||||||||||XXXXXXXXXXXX|||||||||||----XXXXXXXX|---XXXXXXXXXXXXXXXXXXXXXXXXXXXXXXXXXXXXXXXXXXXXXXXXXXXFXX