--------------------------------------------------------------------------------------------------------------------------------------------------------------------------------------------------------
--------------------------------------------------------------------------------------------------------------------------------------------------------------------------------------------------------
--------------------------------------------------------------------------------------------------------------------------------------------------------------------------------------------------------
--------------------------------------------------------------------------------------------------------------------------------------------------------------------------------------------------------
--------------------------------------------------------------------------------------------------------------------------------------------------------------------------------------------------------
--------------------------------------------------------------------------------------------------------------------------------------------------------------------------------------------------------
--------------------------------------------------------------------------------------------------------------------------------------------------------------------------------------------------------
--------------------------------------------------------------------------------------------------------------------------------------------------------------------------------------------------------
--------------------------------------------------------------------------------------------------------------------------------------------------------------------------------------------------------
----------------------------------U----------------------------------------------------------------------------------------------------------------------------2S2CSSCSC--------------------------------
----------------------------------------------------------------------------------r------------------------------SSSCSCSS--------------------------------------------------%%%%%%%%%%-------------------
--------------------------------------ggkkkgkk-----------------------------------------------------------r---------------------------%%%%%%%%%%%---------------------------||||||||||-------------------
----------------------------------------||||------------------------------------%%%%----------%%%------------------------------------|||||||||||---------------------------||||||||||---%%%%%%%%%%    %%
-------------------------%%%%%%%%%%%%%--||||--%%%%%%%%%-------------------------|%%%%%%-------|||----%%%%%%%%%%----------------------|||||||||||---%%%%%%%%%%%%%%%%%%%%%%%%||||||||||---||||||||||||| ||
------%%%%%--------------|||||||||||||--||||--|||||||||-------------------------|||||||-------|||----||||||||||%%%%%%%%%%%%%---------|||||||||||---||||||||||||||||||||||||||||||||||---||||||||||||||||
XXXXXX|||||XXXXXXXXXXXXXX|||||||||||||XXXXXXXX|||||||||-----XXXXXXXXXXXXXX-----XXXXXXXXXX-----|||----|||||||||||||||||||||||XXXXXXXXX|||||||||||---||||||||||||||||||||||||||||||||||---||||||||||||||||