--------------------------------------------------------------------------------------------------------------------------------------------------------------------------------------------------------
--------------------------------------------------------------------------------------------------------------------------------------------------------------------------------------------------------
--------------------------------------------------------------------------------------------------------------------------------------------------------------------------------------------------------
--------------------------------------------------------------------------------------------------------------------------------------------------------------------------------------------------------
--------------------------------------------------------------------------------------------------------------------------------------------------------------------------------------------------------
--------------------------------------------------------------------------------------------------------------------------------------------------------------------------------------------------------
--------------------------------------------------------------------------------------------------------------------------------------------------------------------------------------------------------
---------------------------------------------------------------------------------------------------------------------------------------------------------Tt---------------------------------------------
-----------------------------------------------------------------------------------------------------------------------------------------Tt--------------tt---------------------------------------------
------------------------------------------------------Tt---------------------------------------------------------------------------------tt--------------tt---------------------------------------------
------------------------------Tt----------------------tt----------------------G----------------------------------------------------------tt----------G--- t-K-------------------------------------------
------------------------------tt----------------------tt---------------------SUCU22CG---------------------------------------------F---%%% %%%%%-----%%%% %%%%%------------------%%%%--------------------
------------------------------tt----------------------t ---------------------------- %%--GG--------------------G------------------%---|||||||||-----||||||||||------------------||||SC------------------
--------------------------K---tt-------------------% %%%%% %%------ UCUSS-----------|||-%%%------------------%%%----%%%%%%---%%%%%|---|||||||||-----||||||||||------------------||||-------------%%%%%--
-------------------------%% %%%%%%%----------------||||||||||-----------------------|||-|||------------------|||----||||||---||||||---|||||||||--% %%%%|||||||------------------||||-------------|||||--
 XXXXXX XX XXX  XXXXX XXX||||||||||XXXXX XX  XXX XXXXX XXXXXXXX X XXX X X X  XX X XX  XXXX    X  XXXXXXX   X |||----||||||---|||||  XXX XXX X XXX||||||X XXXXXX X XXX XXXXXXX   XXXXXX XX XXXXX  |||||--