--------------------------------------------------------------------------------------------------------------------------------------------------------------------------------------------------------
--------------------------------------------------------------------------------------------------------------------------------------------------------------------------------------------------------
--------------------------------------------------------------------------------------------------------------------------------------------------------------------------------------------------------
--------------------------------------------------------------------------------------------------------------------------------------------------------------------------------------------------------
--------------------------------------------------------------------------------------------------------------------------------------------------------------------------------------------------------
--------------------------------------------------------------------------------------------------------------------------------------------------------------------------------------------------------
-----------------------------------------------------------------------------------------------------------------------------------CC22-----------------------------------------------------------------
--------------------------------------------------------------------------------------------------------------------------------------------------------------------------------------------------------
----------------------------------------------------------------------------------------------------------------------------------r---------------------------------------------------------------------
--------------------------g----g-----------------------------------------------------------------------2CSCSC2USS--%%%%%%%%%%%%%%-----------------------------------------------------------------------
-------------------------------------------------------------------------------------------------------------------||||||||||||||%%%%%%%%---------------------------------------------------------------
-------------------------------------------------------------%%%%%%%-----------------------------SSU---------------||||||||||||||||||||||---------------------------------------------------------    %%
------------------------------%%%%%%%%-----------------------|||||||-----------------------------------------------||||||||||||||||||||||-----%%%-------------------------------------------------||| ||
------------------------------||||||||-----k-----k-----------|||||||-----------%%%%%%%%----------------------------||||||||||||||||||||||-----|||-------rk----------------------rr----------------||||||
------%%%%%-------------------||||||||-----------------------|XXXXXXX----------||||||||----------------------------||||||||||||||||||||||-----|||-------------------------------------------------||||||
XXXXXX|||||XXXXXXXXXXXXXX---XXXXXXXXXXXXXX----XXXXXXXXXX---XXXXXXXXXXXXX-----XXXXXXXXXXXXXXXXXXXXXXXXXXXXXXXXXXXXXX||||||||||||||||||||||-----|||----XXXXXXXX-----XXXXXXXXXXXXXXXXXXXXXXXXXXXXXXXX||||||