--------------------------------------------------------------------------------------------------------------------------------------------------------------------------------------------------------
--------------------------------------------------------------------------------------------------------------------------------------------------------------------------------------------------------
--------------------------------------------------------------------------------------------------------------------------------------------------------------------------------------------------------
--------------------------------------------------------------------------------------------------------------------------------------------------------------------------------------------------------
------------------------------------------------------------------------------------------------------------------CCU2S--%%%%%%%%%%---------------------------------------------------------------------
-------------------------------------------------------------------------------------------------------------------------||||||||||---------------------------------------------------------------------
------------------------------------------------------------------------------------------------------------SSU----------||||||||||--SSSSCCS------CSS2SCCSC---------------------------------------------
-------------------------------------------------------------------------------------------------------------------------||||||||||---------------------------------------------------------------------
----------------------------------------------------------g-g-----g------------------------------------------------------||||||||||---------------------------------------------------------------------
-------------------------------------------------------------------------------------------------------------------------||||||||||---------------------------------------------------------------------
-------------------------------------------------------------------------------------------------------%%%%%%%%%---------||||||||||%%%%%%%%%%%%%%%%%%%%%%%%%%-----------g-k-----------------------------
----------------------------------kgggkgggkk------------------%%%%%---------%%%%%----------------------|||||||||---------||||||||||||||||||||||||||||||||||||----------------------------SUSSSSCS-------
--------------------------------------------------------------|||||---g-----|||||--------------g--g----|||||||||---------||||||||||||||||||||||||||||||||||||-gg------g--------%%%%%%-------------------
--------------------------------r-----------%%%%%%%%%%%%%-----|||||---------|||||----------------------|||||||||---------||||||||||||||||||||||||||||||||||||-----------------%%%%|||---k----------F----
------%%%%%--------------%%%%%%%%-----------|||||||||||||-----|||||---------|||||------%%%----%%%%%%%%%|||||||||%%%%%%%%%||||||||||||||||||||||||||||||||||||%%%%%%%%%%%------|||||||-------------- ----
XXXXXX|||||XXXXXXXXXXXXXX||||||||XXXXXXXXXXX|||||||||||||---XXXXXXXXX-----XXXXXXXX-----|||----||||||||||||||||||||||||||||||||||||||||||||||||||||||||||||||||||||||||||-----XXXXXXXXXXXXXXXXXXXXXXXXFXX