--------------------------------------------------------------------------------------------------------------------------------------------------------------------------------------------------------
--------------------------------------------------------------------------------------------------------------------------------------------------------------------------------------------------------
--------------------------------------------------------------------------------------------------------------------------------------------------------------------------------------------------------
--------------------------------------------------------------------------------------------------------------------------------------------------------------------------------------------------------
--------------------------------------------------------------------------------------------------------------------------------------------------------------------------------------------------------
--------------------------------------------------------------------------------------------------------------------------------------------------------------------------------------------------------
--------------------------------------------------------------------------------------------------------------------------------------------------------------------------------------------------------
--------------------------------------------------------------------------------------------------------------------------------------------------------------------------------------------------------
--------------------------------------------------------------------------------------------------------------------------------------------------------------------------------------------------------
--------------------------------------------------------------U---------------------------------------------------------------------------g------gg---------------------2CSSUSS-------------------------
-----------------------------------------------------------------------------------------------------------------gkgggggggggg---------------------------------------------------------------------------
--------------------------g---g--g--------------------------------gkkkkggk--------------------tt---------------r--||||||||||-------------------------------------------g-g--g----------ggg--------------
--------------------------------------------------------------------||||----------------------tt--%%%%%%%%%%%%%%--||||||||||-%%%%%%%%%%%%-----------------------------------------------------------  %%
---------------------------------------g---%%%%%%%%----%%%%%%%%%%%--||||--%%%%%%%%%%%---------tt--||||||||||||||--||||||||||-||||||||||||----%%%%%%%%%%%%%----%%%%%%%%%%%%%%%%%%%%----%%%%%%%%%%%%  | ||
------%%%%%--------------------------------||||||||----|||||||||||--||||--|||||||||||-----%%%%%%%%||||||||||||||%%%%%%%%%%%%%||||||||||||----|||||||||||||----||||||||||||||||||||----||||||||||||||||||
XXXXXX|||||XXXXXXXXXXXXXX----XXXXXXXXX---XXXXXXXXXXXXXX|||||||||||XXXXXXXX|||||||||||-----|||||||||||||||||||||||||||||||||||||||||||||||----|||||||||||||----||||||||||||||||||||----||||||||||||||||||