--------------------------------------------------------------------------------------------------------------------------------------------------------------------------------------------------------
--------------------------------------------------------------------------------------------------------------------------------------------------------------------------------------------------------
--------------------------------------------------------------------------------------------------------------------------------------------------------------------------------------------------------
--------------------------------------------------------------------------------------------------------------------------------------------------------------------------------------------------------
--------------------------------------------------------------------------------------------------------------------------------------------------------------------------------------------------------
--------------------------------------------------------------------------------------------------------------------------------------------------------------------------------------------------------
--------------------------------------------------------------------------------------------------------------------------------------------------------------------------------------------------------
--------------------------------------------------------------------------------------------------------------------------------------------------------------------------------------------------------
------------------------------------------------------------------U-------------------------------------------------------------------------------------------------------------------------------------
--------------------------------------------------------------------------------------------------------------------------------------------------------------------------------------------------------
--------------------------------------------------------g---------------%%%%%%%%%-----------------------------------------------------------------------------------------------------%%%%%%%%%%%%    %%
----------------------------------kggkkkkg----------------------------gggkggggggggg-----------------------------------------------SSSSU--------------gggggggggggg---------------------||||||||||||||| ||
-----------------------------------%%%%%%-----------------%%%%%%%%%%%%--|||||||||---------------%%%%%%------------------------------------------------%%%%%%%%%%-------------%%%%%%%%%||||||||||||||||||
--------------------------------r--||||||-%%%%%%%%%%%%%---||||||||||||--|||||||||--%%%%%%%%-----||||||---------------------------g---g-------------g--||||||||||-%%%%%%%%%%%%|||||||||||||||||||||||||||
------%%%%%--------------%%%%%%%%--||||||-|||||||||||||---||||||||||||--|||||||||--||||||||---%%%%%%%%%%%--------------------------------%%%%%%%%%%%--||||||||||-|||||||||||||||||||||||||||||||||||||||
XXXXXX|||||XXXXXXXXXXXXXX||||||||XXXXXXXXX|||||||||||||---||||||||||||XXXXXXXXXXXXX||||||||---|||||||||||-----XXX----XXXXXXXXXXXXXXXXXXXX|||||||||||XXXXXXXXXXXXX|||||||||||||||||||||||||||||||||||||||