---------------------------------------------------------------------------------------------------------------------------------     ------------------------------------------------------------------
---------------------------------------------------------------------------------------------------------------------------------     ------------------------------------------------------------------
---------------------------------------------------------------------------------------------------------------------------------     ------------------------------------------------------------------
---------------------------------------------------------------------------------------------------------------------------------     ------------------------------------------------------------------
---------------------------------------------------------------------------------------------------------------------------------     ------------------------------------------------------------------
---------------------------------------------------------------------------------------------------------------------------------     ------------------------------------------------------------------
---------------------------------------------------------------------------------------------------------------------------------     ------------------------------------------------------------------
---------------------------------------------------------------------------------------------------------------------------------     ------------------------------------------------------------------
---------------------------------------------------------------------------------------------------------------------------------     ------------------------------------------------------------------
---------------------------------------------------------------------------------------------------------------------------------     ------------------------------------------------------------------
-------------------G-------------------------------------------------------------------------------------------------------------     ------------------------------------------------------------------
------------%%-%%%%%%%-----------------------------------------------------------------------------------------------------------     ------------------------------------------------------------------
------%%%%%%||-|||K|||----------------------------------------------------------------------------%%%%%%%%%%%--------------------     ----K-------------------------------------------------------------
------|||%%%%%%%%%%%||------------------------------------------------K---------------------------|||||||||||--------------------     --%%%%%%%%%%%---------------------------------------%%%%----------
------||||||||||||||||------------------------------------------%%%%--%%%%%-----------------------|||||||||||--------------------     --|||||||||||---------------------------------------||||---------%
XXXXXXXXXXXXXXXXXXXXXXXXXXXXXXXXXXXXXXXXXXXXXXXXXXXXXXXXXXXXXXXX||||--|||||XXXXXXXXXXXXXXXXXXXXXXXXXXXXXXXXXXXXXXXXXXXXXXXXXXXXXX     XXXXXXXXXXXXXXXXXXXXXXXXXXXXXXXXXXXXXXXXXXXXXXXXXXXX||||XXXXXXXXX|