-------------------- -----------------------------------------------------------------------------------------------------------------------------------------------------------------------------------
 ---------------------------------------------------------------------------- ---------------------------------------------------------- ---------------------------------------------------------------
----- ------------------------------ ----------------------------------------------------------------------------------------------- ---------------- --------------------------------------------------
----------------------------------- ---------------------------------------------------------------------------------------------- ---------------------------------------------------------------------
----------------------------------------------------------------------------------------------------------------- ------------------------------------------ ----------------- -------------------------
-------------------------------------------------------------------------------------------------------- -------------------------------------------------- --------------------------------------------
--------------------- ----------------------------------------------------------------------------------------------------------------------------------------------------------------------------------
-- ------------------------------------ ----------------------------------------------------------------------------------------------------------------------------------------------------------------
---------------------------------------- ------------------------------------------------------------------------------------------------------------------ ---- ---------------------------------------
-------------------------- ------------ ---------------------------------------------------------------------------------------------------        -----------------------------------------------------
--------------------------------------------------------------------- ---------------------------- % %         -------------------------- --||||||--------- %  %    %%---------------------------  %% F%
----------------------------------------------%% %-----------------------           --------------|||||||||||||----  -------     %   %% % --||||||-  %%%   |||||||||||---------------------------|||| ||
----------------------------------------------|%%%%   --------------------------------------------|||||||||||||----------- -||||||||||||||-         ||||||||||||||||||---       %----------------|||||||
------------------------------- --- ----------||||||||---- ---------- --------------%% % %%%%%    |||||||||||||---%%%     %%||||||||||||||%% %%% % |||||||||||||||||||---||||||||---        %%%  |||||||
------    %------ -------------- -------------|| |||||-------  %        %-----------|||||||||||||||||||||||||||---||||||||||||||||||||||||||||||||||||||||||||||||||||---||||||||---||||||||||||||||||||
  X   |||||X  XX XXX X  X-----XXX  X    -----X X    X   X----||||||||||||XX  XX X XX|||||||||||||||||||||||||||---||||||||||||||||||||||||||||||||||||||||||||||||||||---||||||||---||||||||||||||||||||