--------------------------------------------------------------------------------------------------------------------------------------------------------------------------------------------------------
--------------------------------------------------------------------------------------------------------------------------------------------------------------------------------------------------------
--------------------------------------------------------------------------------------------------------------------------------------------------------------------------------------------------------
--------------------------------------------------------------------------------------------------------------------------------------------------------------------------------------------------------
--------------------------------------------------------------------------------------------------------------------------------------------------------------------------------------------------------
--------------------------------------------------------------------------------------------------------------------------------------------------------------------------------------------------------
--------------------------------------------------------------------------------------------------------------------------------------------------------------------------------------------------------
--------------------------------------------------------------------------------------------------------------------------------------------------------------------------------------------------------
--------------------------Tt----------------------------------------------------------------------------------------------------------------------------------------------------------------------------
--------------------------tt-------------------------------------------------------------------------------------------------------------------------------Tt-------------------------------------------
--------------------------tt-------------------------------------------------------------------------------------------------------------------------------tt-------------------------------------------
--------------------------tt------------------------------------------------------------------------------------------------------F------------------------tt----------------------------------------U2U
----------------------%%%%%%%%%-----------------------------------------------------%%%%%%%%%%%---%%%--%%%%%----------------------%------%%%------%%%--%%K%%%%%%%%--------------------------------------
----------------------|||||||||-----------------------------------------------------|||||||||||---|||--|||||----------%%%%%%%%%%--|------|||------|||--||%||||||||2UC2C-----------------G-------F-------
----------------------|||||||||-----------------------------------------------------|||||||||||---|||--|||||----------||||||||||--|------|||------|||--|||||||||||------------------%%%%%%%%%%%- -------
XXXXXXXXXXXXXXXXXXXXXXXXXXXXXXXXXXXXXXXXXXXXXXXXXXXXXXXXXXXXXXXXXXXXXXXXXXXXXXXXXXXXXXXXXXXXXXXXXX|||--|||||XXXXXXXXXX||||||||||XXXXXXXXX|||------|||XX||X||||||||XXXXXXXXXXXXXXXXXX|||||||||||XXXXXXXXX