--------------------------------------------------------------------------------------------------------------------------------------------------------------------------------------------------------
--------------------------------------------------------------------------------------------------------------------------------------------------------------------------------------------------------
--------------------------------------------------------------------------------------------------------------------------------------------------------------------------------------------------------
--------------------------------------------------------------------------------------------------------------------------------------------------------------------------------------------------------
--------------------------------------------------------------------------------------------------------------------------------------------------------------------------------------------------------
--------------------------------------------------------------------------------------------------------------------------------------------------------------------------------------------------------
--------------------------------------------------------------------------------------------------------------------------------------------------------------------------------------------------------
---------------------Tt------------------------------------------------------------------------------------------------------------------------------------------------Tt-------------------------------
--------------Tt----- t------------------------------------------------------------------------------------------------------------------------------------------------ t-------------------------------
--------------tt-----tt------------------------------------------------------------------------------------------------------------------------------------------------tt-------------------------------
--------------t -----tt-- t--------------------------------------------------------------------------------------------------------------------------------------------tt-------------------------------
--------------tt-- %%%%%%tt%------------ %% %%%%%%--------------------------------------------------------------------------------F-------------------------------%%%%%% %%%%------ t-------------------
---------- %%%%% %%||||||tt|------------||||||||||---------------%% %%%%%% %%%%-----------------------------------------------%%%%%%------% %% ------%%%%---------|%%%%%%||||------  -------------------
----------||||||||||%%%% %%%%%%%--------||||||||||-----%%%%%%%%--||||||||||||||---------------------------------------%%%%% %%% ||||------|||||------||||---------|||||||||||--K--- t--K----------------
----------||||||||||||||||||||||----% %%%%%% %||||-----||||||||--||||||||||||||-----------%  ----------%%%---%%%------||||||||||||||------|||||------||||---------|||||||||||-%%%% %%%%%%---------------
 XXX XXXXXXXXX XXXXXXXXX  XXXXXXXX X||||||||||XX  XX XX||||||||X ||||||||||||||XX XX X XXX|||XXXXX X XX|||---|||XXXXXXXXXXXXXXXX XXXXXXXXX|||||------|||| XXXXXXXXXXXXXXXXXXXX|||||||||||XXXXXXX XXX XXX