--------------------------------------------------------------------------------------------------------------------------------------------------------------------------------------------------------
--------------------------------------------------------------------------------------------------------------------------------------------------------------------------------------------------------
--------------------------------------------------------------------------------------------------------------------------------------------------------------------------------------------------------
--------------------------------------------------------------------------------------------------------------------------------------------------------------------------------------------------------
--------------------------------------------------------------------------------------------------------------------------------------------------------------------------------------------------------
--------------------------------------------------------------------------------------------------------------------------------------------------------------------------------------------------------
--------------------------------------------------------------------------------------------------------------------------------------------------------------------------------------------------------
--------------------------------------------------------------------------------------------------------------------------------------------------------------------------------------------------------
--------------Tt-----------------------------------------------------------------------------------------------Tt--------------------Tt-----------------------------------------------------------------
--------------tt-----------------------------------------------------------------------------------Tt----------tt--------------------tt-----------------------------------------------------------------
--------------tt-----------------------------------------------------------------------------------tt----------tt--------------------tt-G---------------------------------------------------------------
--------------tt-------------------------------------------------------------------------------G---tt----------tt-----------G-----F%%%%%%%--------------------------------------------------------------
---------%%%%%%%%%%-%------------G---------G--------------------------------------------------%%%%%%%%%%%-%%%%%%%%%%%%%---%%%%%---%|||||||------%%%---%%%UU-----GG--------------------------------------
---------||||||||||%|%%%%----G-%%%------%%%%%-------------------------------------------------|||||||||||-|||||||||||||---|||||---||||||||------|||---|||------C2CC2-----K----------------------F-------
---------||||||||||||||||-%%%%%|||------|||||-------------------------------------------------|||||||||||-|||||||||||||---|||||---||||||||------|||---|||----------------%%%%%----%%%%%--------- -------
XXXXXXXXX||||||||||XXXXXXX||||||||------|||||XXXXXXXXXXXXXXXXXXXXXXXXXXXXXXXXXXXXXXXXXXXXXXXXXXXXXXXXXXXXX|||||||||||||---|||||XXXXXXXXXXXXXXXXX|||---|||XXXXXXXXXXXXXXXX|||||----|||||XXXXXXXXXXXXXXXXX