----------------------------------------- --------------------------------------------------------------------------------------------------------------------------------------------------------------
----------------------------------------- ------------------ -------------------------------------------------------------------------------------------------------------------------------------------
----------------------------------------- ---------------------------------------------------------------------------------------------------------------------------------------------------- ---------
---------- ------------------------------------------------------------------------------------------- ------------------------------------------------------------------------ ------------------------
--------------------------------------------------------------------------------------------------------------------------------------------------------------------------------------------------------
---------------------------------------------------------------------------------------------------------------------------------- ---------------------------------------------------------------------
 --------------------------- ---------------------------------------------------------------------------------------------------------------------------------------------------------------------------
------------------------------------------------ ------------------------------------------------------------ ---------------------- ---------------------------- --------------------------------------
------------------------------------------------------------------------------------------------------------------- -------- t------------- --------------------------------  --------------------------
---------------------------------------------------------------- ----------------------------------------------------------- t----------------------------------------------tt--------------------------
------------------------------------------------- ---------------------------------------- t------------- t-----------------tt------------------------------------------- --t --- ----------------------
-------------------------------------- --------------------------------------------------- t-U CS--------tt-------------% %%%% %%%F------------------------------------%%%% %%%%%%%---------------------
-------%%%%%------% %% -----%%%%-----%%%%%--------  ------- ------------------------------tt-- ------- --tt--%%%%% %%%--||||||||||%------------ -----------------------||||||||||||---------------- --- 
-------|||||------|||||-----||||-----|||||-------- %%----%%% ----------%%%---- %%-S2 2U%%%%%%%%% ----% %%%%% %| ||||||--|||||||||||---------%% %%%%%%%%%------%%%%%%%%%||||||||| %%-------------- %%%%%%
-------|||||------|||||-----||||-----|||||--------|||----||||- --------|||----|||------||||||||||----||||||||||  %%%%|--|||||||||||---------||||||||||||------|||||||||||||||||||||--------------|||||||
 XXXXXX|||||------|||||X XX ||||-----|||||XXX   XX|||----||||X  XXXXXX |||----|||   XX XXXX XXXXX XXX|||||||||X||||||X  XX XXX XX XXXXXXXX X XXXXXXXXXXXXXXXXX|||||||||XXXX XX  XX    XXXXXXXX X |||||||