--------------------------------------------------------------------------------------------------------------------------------------------------------------------------------------------------------
--------------------------------------------------------------------------------------------------------------------------------------------------------------------------------------------------------
--------------------------------------------------------------------------------------------------------------------------------------------------------------------------------------------------------
--------------------------------------------------------------------------------------------------------------------------------------------------------------------------------------------------------
--------------------------------------------------------------------------------------------------------------------------------------------------------------------------------------------------------
--------------------------------------------------------------------------------------------------------------------------------------------------------------------------------------------------------
--------------------------------------------------------------------------------------------------------------------------------------------------------------------------------------------------------
--------------------------------------------------------------------------------------------------------------------------------------------------------------------------------------------------------
----------------------------------------------------------------------------g-g----g--------------------------------------------------------------------------------------------------------------------
----------------------------------g----------------SSSCSCCS---------------------------------------------------------------------------------------------------------------------------------------------
--------------------------ggg---------------------gkggggkggggg----------------------------------------------------U----------------------g--------------------------------------------------------------
--------------------------------%%%%%%----------r------------------------------------------CSSS2SCS2------------------gggkggkgg-------------------------------------------------------------------------
--------------------------------||||||--%%%%%%%%%-------------%%%%%%%%%%%%%-----%%%%%%-----------------------------------------------------------g-g----------------------------------------------------
--------------------------------||||||--|||||||||-------------|||||||||||||-----||||||-----------------------------------------%%%%%%%%%------------------------------gr------r--------------%%%%%    %%
------%%%%%---------------------||||||--|||||||||%%%%%%%%%%%%%|||||||||||||-----||||||----------------------%%%%%%%%%%---------|||||||||---%%%%%%%%%%%---------------------------------------|||||||| ||
XXXXXX|||||XXXXXXXXXXXXXX-----XXXXXXXXXX|||||||||||||||||||||||||||||||||||---XXXXXXXXXXXXXXXXXXXXXXXXX-----||||||||||XXXXXXXXX|||||||||---|||||||||||---XXXXXXXXXXXXXXXXXXXXXXXXXXXXXXXXXXXX|||||||||||