--------------------------------------------------------------------------------------------------------------------------------------------------------------------------------------------------------
--------------------------------------------------------------------------------------------------------------------------------------------------------------------------------------------------------
--------------------------------------------------------------------------------------------------------------------------------------------------------------------------------------------------------
--------------------------------------------------------------------------------------------------------------------------------------------------------------------------------------------------------
--------------------------------------------------------------------------------------------------------------------------------------------------------------------------------------------------------
--------------------------------------------------------------------------------------------------------------------------------------------------------------------------------------------------------
-----------------------------------------------------------------------------------------------------------------U--------------------------------------------------------------------------------------
-----------------------------------------------------------------------------%%%-----------------------------------------SSC----------------------------------------------------------------------------
------------------------------------------------------------------------g----|%%%%%%%-------------------------------------------------------------------------------------------------------------------
----------------------------------------------------U2SS2C-%%%%%%%%%%%%%-----||||||||----------%%%%%%%---------------kgggkkggk--------------------------------------------------------------------------
-----------------------------------------------------------|||||||||||||----%%%%%%%%%%%%%------|||||||----%%%%%%%%%%%----------------------%%%%%%%%%%---------------------------------------------------
--------------------------gg--g---------------S2US---------|||||||||||||----|||||||||||||------|||||||----|||||||||||---------%%%%%%%%%%%%%||||||||||-k----r--k---------%%%%%%----%%%%%%%---------------
-----------------------------------------------------------|||||||||||||----|||||||||||||----%%%%%%%%%%%%%|||||||||||---------|||||||||||||||||||||||-------------------||||||----|||||||---------------
-----------------------------------------------------------|||||||||||||----|||||||||||||----||||||||||||||||||||||||%%%%%%%%%|||||||||||||||||||||||%%%%%%%%%%%%%%-----||||||----|||||||---------------
------%%%%%------------------------------------------------|||||||||||||----|||||||||||||----||||||||||||||||||||||||||||||||||||||||||||||||||||||||||||||||||||||-----||||||----|||||||---------------
XXXXXX|||||XXXXXXXXXXXXXX----XXXXXXXXXXXXXXXXXXXXXXXXXXXXXX|||||||||||||----|||||||||||||----||||||||||||||||||||||||||||||||||||||||||||||||||||||||||||||||||||||---XXXXXXXXXXXXXXXXXXXXXXXXXXXX    XX