--------------------------------------------------------------------------------------------------------------------------------------------------------------------------------------------------------
--------------------------------------------------------------------------------------------------------------------------------------------------------------------------------------------------------
--------------------------------------------------------------------------------------------------------------------------------------------------------------------------------------------------------
--------------------------------------------------------------------------------------------------------------------------------------------------------------------------------------------------------
--------------------------------------------------------------------------------------------------------------------------------------------------------------------------------------------------------
--------------------------------------------------------------------------------------------------------------------------------------------------------------------------------------------------------
--------------------------------------------------------------------------------------------------------------------------------------------------------------------------------------------------------
------------------------------------------------------------------------------------------------------------------------------------Tt------------------------------------------------------------------
------------------------------------------------------------------------------------------------------------------------------------tt------------------------------------------------------------------
----------------------------------------------------------------------------------------------------------------------Tt------------tt------------------------------------------------------------------
----------------------------------------------------------------------------------------------------------------------tt------------tt------------Tt----------------------------------------------------
--------------------------------------------%%%---------------------------------------------------------CCCS%%%-------tt---------%F%%%%%%%%-------tt----------------------------------------------------
------------------K------------%%%%%%%-%%---|||-------------------------------------------------------------|||-------tt---------|%||||||||-------tt-----------------------------2S2UCS-----------------
-------------%%%%%%------------||||%%%%%%%%%%||-----------------------%%%%%---------------------------------|||----%%%%%%%%%-----||||||||||-------tt---G-------------------------------%%%%%%%%%%%%--F--
-------------||||||------------||||||||||||||||-----------------------|||||----------------------------%%%%-|||----|||||||||-----||||||||||---%%%%%%%%%%---%%%------%%%----------------||||||||||||-- --
XXXXXXXXXXXXX||||||XXXXXXXXXXXXXXXX||||||||||XXXXXXXXXXXXXXXXXXXXXXXXX|||||XXXXXXXXXXXXXXXXXXXXXXXXXXXX||||XXXXXXXX|||||||||XXXXXXXXXXXXXXXXXX||||||||||XXX|||------|||XXXXXXXXXXXXXXXX||||||||||||XXXXX