----------------------------------------------------------------------- - --------------------------------------------------- --------------------------------------------------------------- ----     -
-------------------------------------------------------------- --------------------------------  --------------------------------------------------------------------------------- ---------------------
-------------------------------------------------------------------- ------------------------------------------------------------------------ ----------------------------------------------------------
--------------------------------------------------------------------------------------------------------------------------------------------------------------------------------------------------------
--------------------------------------------------------------------------------------------------------------- ----------------------------- ----------------------------------------------------------
------------------------------------------------------- ---------------------------------------------------------------------------- -------------------------------------------------------------------
---------------------------------------------------------------------------------------------------------------------------------------------- ---------------------------------------------------------
------------------------------------------------------------------------------------------------------------------------------------------- --------------------- --------------------------------------
-----------------------------------------------------------------T -------------------------------------------------------------------- -- ------------------------------------------------------------ 
------------------------------------- ---------------------------tt---------------------------- -- ----------------------- -----------------------------------------------------------------------------
----------K------------------------------------------------ ---G-tt------ -------- -------------- ------------------------------------------------------------------------------------------------------
-------US2UUU -----------------------------------------------%%% %%%% %%----------------------------------------------------------F--------------Tt-----------------------------------------------------
------------------%%%%%------% %%%- ----------- -------------| |||||||||-------%  %% %%  --------%%%%% ------------K--------------%----%%%% %----tt---------------------------------- ------UUC U------%
------------------|||||------|||||----G--------------% % %%%% ||||||||||-------||||||||||----- --||||||----------%  %%% %---------|- --||||||----t --G---- ----------------------------------------C2C |
------- ----------|||||------|||||--%% --------------|||||||||||||||||||-------||||||||||--------||||||----------||||||||---------|----||||||-%%% %%%%%--------------------------------------------- --|
 XXXXXXXXXXXXXXXXX|||||- ----|||||XX||| XXXXXX XX XXXXXXX X XXXXXXXXXXXX XXXX XXXXXXXX X XXXXXXXXX XXXXXXXXXXXXXX |||||||XXXX XXXX XXXXX XXXXX |||||||| XX XXXXX XXXXXXXXXXXXXXXXXXXX XXXXXXXX XXXXX  XX