-----------------------------------------------------------------------------------------------------------------------------        -------------------------------------------------------------------
-----------------------------------------------------------------------------------------------------------------------------        -------------------------------------------------------------------
-----------------------------------------------------------------------------------------------------------------------------        -------------------------------------------------------------------
-----------------------------------------------------------------------------------------------------------------------------        -------------------------------------------------------------------
-----------------------------------------------------------------------------------------------------------------------------        -------------------------------------------------------------------
-----------------------------------------------------------------------------------------------------------------------------        -------------------------------------------------------------------
-----------------------------------------------------------------------------------------------------------------------------        -------------------------------------------------------------------
-----------------------------------------------------------Tt----------------------------------------------------------------        -------------------------------------------------------------------
-----------------------------------------------------------tt------------------------------------------Tt--------------------        -------------------------------Tt----------------------------------
-----------------------------------------------------------tt----------------------------Tt------------tt--------------------        -------------------------------tt----------------------------------
-----------------------Tt----------------------------------tt----------------------------tt------------tt-------------------T        -------------------------------tt----------------------------------
-----------CCUC--------tt------------------------------%%%-%%K%%%%-----------------------tt------------tt-------------------t        --------%%%--------------------tt-K--------------------------------
-----------------------tt----------------------------K-%%%%%%%%%||-----------------------tt-K------%%%%%%%%%G---------------t        --------|||-----------------%%%%%%%%%-------------------------%%%--
-----------------------tt-------------------------UUCC2|||||||||||------------------%%%%%%%%%%%----||||||%%%%%-----------%%%%        --------|||---G---------G---|||||||||-------------------------|||--
------------------%%%%%%%%%%%%-------------------------|||||||||||------------------|||||||||||--%%%%%||||||||-----------||||        %%%%%%%%%||--%%%%%----%%%%%-|||||||||--------%%%%%%%%%%%%-----|||--
XXXXXXXXXXXXXXXXXX||||||||||||XXXXXXXXXXXXXXXXXXXXXXXXXXXXXXXXXXXXXXXXXXXXXXXXXXXXXXXXXXXXXXXXXXX|||||XXXXXXXXXXXXXXXXXXXXXXX        |||||||||XXXX|||||----|||||XXXXXXXXXXXXXXXXXX||||||||||||XXXXX|||--