---------------------------------------------------------------------------------------------------- ---- ----------------------------------------------------------------------------------------------
-------------------------------------------------- -----------------------------------------------------------------------------------------------------------------------------------------------------
-------------- ------------------------- ----------------------------------- --------- ----------------------------------------------------------------------------------------------  -----------------
---------------------------------------------------------------------------------------------------- -------------------------------------------------- ------------------------- ----------------------
------- ---------------------------------------- ------------------------------------------------------- -----------------------SSS2C----------------------------------- ------ ------------------------
------------------------------ ----------------------------------------- ------------------------------------------------------gkkkgkgg---------------- ------------------------------------------- ----
---------------------------------------------------------- ----------------------------- S2CSC2SCU-- %%% % %  ---CCS---------  -------------------------------------------------------------------------
------------------------------------ --------------------------------------------------------- -----||||||||||--------% %%% % ---------  %  % %------------------------------------------------ --------
----------------------------------------------------------------------------------2US  C------------||||||||||g-----g-| ||||||---------||||||||----g----------------------g-------g--- S2CSUC-----------
----------------------------------------- ----------------------------------------------------------||||||||||--------||||||||%%  % %  ||||||||------------- -----S --- -------- -----------------------
----- -------------- ---------------U-- ---------------------------------------- ---------------- --||||||||||% %  %  ||||||||||||||||||| |||||--- %%%%%% %   %----- --%%  %% %% %%---------------------
----------- ----------------------------kggggkgg--------------------%%   ---------------------------||||||||||||||||||||||||||||| |||||||||||||---|||||||||||||--------|||||||| |||---------------------
-------------------- ---------------------% %%----------------------|||||-  % %%%%%%%%%-------------||||||||||||| |||||||||||||||| ||||||||||||---|||||||||||||--- ----|||||||||| |% %%  %%%%   --------
------------- ----------------------------||||--% % %% %%%% %-------|||||-|||||||||||||---------- --|||||||||| ||||||||||||||||||||||||||||||||---|||||||||||||%%% %  %|||||||||||||||||| ||||||--------
------% % %------------ ------ % %  %% %--||||--|||||||||||||------XX||||-|||||||||||||-------------|||||||||||||||||||||||||||||||||||||||||||---||||||||||||||||||||||||||||||||||||||||||||||--------
 XXXX |||||XXXXXX XXXXXXX-----||||||||||XXX XXX |||||||||||||-----XXXXX X |||||||||||||X XXXXXXXXXXX|||||||||||||||||||||||||||||||||||||||||||---||||||||||||||||||||||||||||||||||||||||||||||XX XXFXX