--------------------------------------------------------------------------------------------------------------------------------------------------------------------------------------------------------
--------------------------------------------------------------------------------------------------------------------------------------------------------------------------------------------------------
--------------------------------------------------------------------------------------------------------------------------------------------------------------------------------------------------------
--------------------------------------------------------------------------------------------------------------------------------------------------------------------------------------------------------
--------------------------------------------------------------------------------------------------------------------------------------------------------------------------------------------------------
--------------------------------------------------------------------------------------------------------------------------------------------------------------------------------------------------------
--------------------------------------------------------------------------------------------------------------------------------------------------------------------------------------------------------
-------------------------------------------Tt-----------------------------------------------------------------------------------------------------------------------------------------------------------
-------------------------------------------tt-----------------------------------------------------------------------------------------------------------------------------------------------------------
--------------------------------------Tt---tt-----------------------------------------------------------------------------------------------------------------------------------------------------------
--------------------------------------tt-G-tt-------------------------------------------------------G----------------------------------------------------------------Tt---------Tt----------------------
--------------------------------------%%%%%%%%%%%------------------------------------------------%%%%%%%%%%----------------------- --------------------------SU------tt---------tt----------------------
---------------------------------%%%%%%%%%%%%||||---------------------------------K--------------||||||||||---G------G------------%------------G-G--------%%%%-SCUS2-%%%%%%%%%--tt----------%%%%--    %-
---------------------------------||||||||||||||||---------------------G------G----%%%%%---%%%----||||||||||-%%%%%---%%%-----------|------------%%%%-------||||---%%%%%%%%%%|||--tt----------||||--|||||-
----------%%%---%%%%-------------||||||||||||||||-------%%%%---%%%-%%%%------%%%%%|||||---|||----||||||||||-|||||---|||-----------|------------||||-------||||---||||||||||%%%%%%%%%%-------||||--|||||-
XXXXXXXXXX|||---||||XXXXXXXXXXXXXXXXXXXXXXXXXXXXXXXXXXXX||||---|||X||||------||||||||||---|||XXXXXXXXXXXXXXX|||||---|||XXXXXXXXXXXXXXXXXXXXXXXXXXXXXXXXXXX||||XXXXXXXXXXXXX||||||||||XXXXXXX||||--|||||X