--------------------------------------------------------------------------------------------------------------------------------------------------------------------------------------------------------
--------------------------------------------------------------------------------------------------------------------------------------------------------------------------------------------------------
--------------------------------------------------------------------------------------------------------------------------------------------------------------------------------------------------------
--------------------------------------------------------------------------------------------------------------------------------------------------------------------------------------------------------
--------------------------------------------------------------------------------------------------------------------------------------------------------------------------------------------------------
--------------------------------------------------------------------------------------------------------------------------------------------------------------------------------------------------------
--------------------------------------------------------------------------------------------------------------------------------------------------------------------------------------------------------
--------------------------------------------------------------------------------------------------------------------------------------------------------------------------------------------------------
--------------------------------------Tt---------------------------Tt-----------------------------------------------------------------------------------------------------------------------------------
--------------------------------------tt---------------------------tt----------------------------------------------------------------------------------Tt----------------------Tt-----------------------
-----------------------------------K--tt---------------------------tt----------------------------------------------------------------------------------tt----------------------tt----K------------------
-----------G----------------K----%%%%%%%%%%--------------------%%%%%%%%%%%--------------------------------------------------------F--------------------tt---------%%%------G---tt-%%%%%%---%%%%%%%%%%%--
-----------%%%----%%%%-----SC2CCC||||||||||--------------------|||||||||||-----------%%%%%-------------------%%%------------------%---------------%%%%%%%%%%------|||-----%%%%%%%%%%%|||---|||||||||||--
---------K-|||----||||-----------||||||||||--------------------|||||||||||-----------|||||-------%%%%%%%%%---|||----------%%%%----|---------------||||||||||------|||-----||||||||||||||---||||||%%F%%%%
-------%%%%|||----||||-----------||||||||||--------------------|||||||||||-----------|||||-------|||||||||---|||----------||||----|---------------||||||||||------|||-----||||||||||||||---|||||||| ||||
XXXXXXX|||||||----||||XXXXXXXXXXXXXXXXXXXXXXXXXXXXXXXXXXXXXXXXXXXXXXXXXXXXXXXXXXXXXXX|||||XXXXXXX|||||||||XXXXXXXXXXXXXXXX||||XXXXXXXXXXXXXXXXXXXXXXXXXXXXXXXXXXXXXXXXXXXXXXXXXXXXXXXXXXXXXXXXXXXXXXXXXX