--------------------------------------------------------------------------------------------------------------------------------------------------------------------------------------------------------
--------------------------------------------------------------------------------------------------------------------------------------------------------------------------------------------------------
--------------------------------------------------------------------------------------------------------------------------------------------------------------------------------------------------------
--------------------------------------------------------------------------------------------------------------------------------------------------------------------------------------------------------
--------------------------------------------------------------------------------------------------------------------------------------------------------------------------------------------------------
--------------------------------------------------------------------------------------------------------------------------------------------------------------------------------------------------------
--------------------------------------------------------------------------------------------------------------------------------------------------------------------------------------------------------
--------------------------------------------------------------------------------------------------------------------------------------------------------------------------------------------------------
--------------------------------------------------------------------------------------------------------------------------------------------------------------------------------------------------------
-------------------------------------------------------------------------------------------------------------------------------------------------------------------------------------Tt-----------------
---------------------------------------------------------------------------------------------------Tt-------------------------------------------Tt-----------------------------------tt-----------------
----------------------------------%%%%%%%%%-%%-----------------------------------------------------tt----------------------------- -------------tt-----------------------------------tt-----------------
---------------------%%%%-----%%%-|||||||||-||--------------%%%%%-----%%%%%------------------------tt--%%%%%%%%%%-----------------%-K-----------tt-----------------------%%%%%%--%%%-tt---------------%%
---------------------||||-----|||-|||%%%%%%%%%%%%-----------|||||-----|||||--%%%-----%%%%%---------tt--||||||||||--%%%K%-%%%%---%%%%%-----------tt--G--------------%%%%--||||||-%%%%%%%%%%%-----------||
---------------------||||-----|||-|||||||||||||||-----------|||||-----|||||--|||-----|||||----%%%%%%%%%%|||||||||--|||%%%%%%|---|||||%%%--%%%%%%%%%%%%%------------||||--||||||-|||||||||||-----------||
XXXXXXXXXXXXXXXXXXXXX||||-----|||XXXXXXXXXXXXXXXXXXXXXXXXXXX|||||-----|||||XX|||-----|||||XXXX||||||||||XXXXXXXXXXXXXX||||||XXXXXXXXX|||--|||||||||||||XXXXXXXXXXXXXXXXXX||||||X|||||||||||XXXXXXX    ||