--------------------------------------------------------------------------------------------------------------------------------------------------------------------------------------------------------
--------------------------------------------------------------------------------------------------------------------------------------------------------------------------------------------------------
--------------------------------------------------------------------------------------------------------------------------------------------------------------------------------------------------------
--------------------------------------------------------------------------------------------------------------------------------------------------------------------------------------------------------
--------------------------------------------------------------------------------------------------------------------------------------------------------------------------------------------------------
--------------------------------------------------------------------------------------------------------------------------------------------------------------------------------------------------------
--------------------------------------------------------------------------------------------------------------------------------------------------------------------------------------------------------
--------------------------------------------------------------------------------------------------------------------------------------------------------------------------------------------------------
-------------------------------------------------------------Tt-----------------------------------------------------------------------------------------------------------------------------------------
-------------------------------------------------------------tt-----------------------------------------------------------------------------------------------------------------------------------------
---------------------------------Tt--------------------------tt-----------------------------------------------------------------------------------------------------------------------------------------
---------------------------------tt%%%%%%%%%-----------%%%%%-tt------------------------------------------------------------------- ----------------------Tt--------------22------------------------  ---
---------------------------------tt|||||||||-----------|%%%%%%%%%%%%-----------------------%%%%%%%%%%---------------------------G-%-----------%%%%%%%%%--tt----%%%%--------------------------------  ---
------------------------------%%%%%%%%%%||||-----------|||||||||||||-----------------------||||||||||-----------------%%%%%-----%%%%----%%%%%%%%%%%||||--tt----||||--------------------------------  ---
--------------------%%%%------||||||||||||||-%%%%------|||||||||||||-----------------------||||||||||-%%%%%--%%%------|||||-----||||----|||||||||||||%%%%%%%%%%%|||-%%%%-----%%%--%%%%%---------%%    %%
XXXXXXXXXXXXXXXXXXXX||||XXXXXX||||||||||XXXXX||||XXXXXXXXXXXXXXXXXXXXXXXXXXXXXXXXXXXXXXXXXX||||||||||X|||||--|||XXXXXXXXXXXXXXXXXXXXXXXXXXXXXXXXXXXXX|||||||||||XXXX||||XXXXX|||--|||||XXXXXXXXX||||||||