--------------------------------------------------------------------------------------------------------------------------------------------------------------------------------------------------------
--------------------------------------------------------------------------------------------------------------------------------------------------------------------------------------------------------
--------------------------------------------------------------------------------------------------------------------------------------------------------------------------------------------------------
--------------------------------------------------------------------------------------------------------------------------------------------------------------------------------------------------------
--------------------------------------------------------------------------------------------------------------------------------------------------------------------------------------------------------
--------------------------------------------------------------------------------------------------------------------------------------------------------------------------------------------------------
--------------------------------------------------------------------------------------------------------------------------------------------------------------------------------------------------------
--------------------------------------------------------------------------------------------------------------------------------------------------------------------------------------------------------
--------------------------------------------------------------------------------------------------------------------------------------------------------------------------------------------------------
-------------------------------------------------------------------------------------------------------------------------------------------------------Tt-----------------------------------------------
-------------------------------------------------------------------------------------G-G----------------------K----G----Tt-----------------------------tt-----------------------------------------------
---------------------------------Tt-------------------------------------KG-----------CCCU-%%%%--------------%%%%%%-%%%%-tt-------- --------------------tt---------------------------%%%%%%%%%-----------
---------------------------------tt----------------------------%%%%-----%%%---------------||||--------------|%%%%%%%%%%-tt--------%----------------%%%%%%%%%%-----------------------|||||||||-----------
------------------------------G--tt----------------K-----------||||-----|||---------------||||----------CU--|||||||||||-tt--------|----------------||||||||||--G--------------------|||||||||-----------
----------------------------%%%%%%%%%%%%-----------%%%-----%%%-||||-----|||---------------||||--------------|||||||||%%%%%%%%-----|----------------||||||||||%%%%%-----%%%%%--------|||||||||-----------
XXXXXXXXXXXXXXXXXXXXXXXXXXXX||||||||||||XXXXXXXXXXX|||-----|||X||||-----|||XXXXXXXXXXXXXXXXXXXXXXXXXXXXXXXXXXXXXXXXXX||||||||XXXXXXXXXXXXXXXXXXXXXX|||||||||||||||-----|||||XXXXXXXXXXXXXXXXXXXXXX    XX