---------------------------------------------------------------------------------------------------------------------------------         --------------------------------------------------------------
---------------------------------------------------------------------------------------------------------------------------------         --------------------------------------------------------------
---------------------------------------------------------------------------------------------------------------------------------         --------------------------------------------------------------
---------------------------------------------------------------------------------------------------------------------------------         --------------------------------------------------------------
---------------------------------------------------------------------------------------------------------------------------------         --------------------------------------------------------------
---------------------------------------------------------------------------------------------------------------------------------         --------------------------------------------------------------
---------------------------------------------------------------------------------------------------------------------------------         --------------------------------------------------------------
---------------------------------------------------------------------------------------------------------------------------------         --------------------------------------------------------------
---------------------------------------------------------------------------------------------------------------------------------         ----------------------------------------------Tt--------------
---------------------------------------------------------------------------------------------------------------------------------         ----------------------------------------------tt--------------
---------------------------------------------KG----------------------------------------------------------------------------------         ----------------------------------------------tt--------------
--------------------------------------------%%%%%------------------------------------G------------G--------------------------G-%%         ----------------G--------------------------GG-tt--------------
--------------------------------------------||||G---------------------------%%%%%%%%%%%%---%%%%%%%%%%-----------------------%%%%%         --------------%%%--%%%%%----%%%%----------%%%%%%%%%%%---------
--------------------------------------------||%%%%%%%%%%--------------------||||||||||||---||||||||||-----------------------|||||         --------------|||--|||||----||||----------|||||||||||--------%
--------------------------------------------||||||||||||--------------------||||||||||||---||||||||||-----------------------|||||         --------------|||--|||||----||||----------|||||||||||--------|
XXXXXXXXXXXXXXXXXXXXXXXXXXXXXXXXXXXXXXXXXXXXXX||||||||||XXXXXXXXXXXXXXXXXXXX||||||||||||XXX||||||||||XXXXXXXXXXXXXXXXXXXXXXX|||||         XXXXXXXXXXXXXX|||--|||||XXXXXXXXXXXXXXXXXX|||||||||||XXXXXXXX|