--------------------------------------------------------------------------------------------------------------------------------------------------------------------------------------------------------
--------------------------------------------------------------------------------------------------------------------------------------------------------------------------------------------------------
--------------------------------------------------------------------------------------------------------------------------------------------------------------------------------------------------------
--------------------------------------------------------------------------------------------------------------------------------------------------------------------------------------------------------
--------------------------------------------------------------------------------------------------------------------------------------------------------------------------------------------------------
--------------------------------------------------------------------------------------------------------------------------------------------------------------------------------------------------------
--------------------------------------------------------------------------------------------------------------------------------------------------------------------------------------------------------
--------------------------------------------------------------------------------------------------------------------------------------------------------------------------------------------------------
-------------------------------------------------------g------------------------------------------------------------------------------------------------------------------------------------------------
-------------------------------------CUCCC--%%%%%%%%----------------------------------------------------------------------------------------------------------------------------------------------------
--------------------------------------------||||||||--------------------------------------------------------CCS2S2--------------------------------------------------------------------------------------
------------------------------SUSCC2--------||||||||------------------------------C2SUSSS-----------------ggkgkggkkgk--------------------------------CS2SSSS---------------SUS---------------%%%%%    %%
--------------------------------------------||||||||-----------------g---%%%%%--------------------------r------------------------------------------------------------------------------------|||||||| ||
--------------------------------------------||||||||----%%%%%%%%%%%%-----|||||--gg---------%%%%%%%%%%%%%%------------%%%%%%%%%%%%%---------g--------------------------------------g------r---|||||||||||
------%%%%%---------------------------------||||||||----||||||||||||----XXXXXX-------------||||||||||||||------------|||||||||||||-----------------------------------------------------------|||||||||||
XXXXXX|||||XXXXXXXXXXXXXXXXXXXXXXXXXXXXXXXXX||||||||----||||||||||||---XXXXXXXXXXXXXXXXXXXX||||||||||||||XXXXXXXXXXXX|||||||||||||---XXXXXXXXXXXXXXXXXXXXXXXXXXXXXXXXXXXXXXXXXXXXXXXXXXXXXXXX|||||||||||