--------------------------------------------------------------------------------------------------------------------------------------------------------------------------------------------------------
--------------------------------------------------------------------------------------------------------------------------------------------------------------------------------------------------------
--------------------------------------------------------------------------------------------------------------------------------------------------------------------------------------------------------
--------------------------------------------------------------------------------------------------------------------------------------------------------------------------------------------------------
--------------------------------------------------------------------------------------------------------------------------------------------------------------------------------------------------------
--------------------------------------------------------------------------------------------------------------------------------------------------------------------------------------------------------
--------------------------------------------------------------------------------------------------------------------------------------------------------------------------------------------------------
--------------------------------------------------------------------------------------------------------------------------------------------------------------------------------------------------------
---------------------------------------------------------------------------------------------------------------------------------SS S-------------------------------------------------------------------
-----------------------------------------------------------------------------------------CS2U-----------------------------------------------------------------------------------------------------------
--------------------------------------------------------------------------------------------------------------------------------------------------------------------------------------------------------
---------------------------------------------------------------------k-----------------------------------------------------------g-r--------------------------------------------------------------------
-------------- %--- %%%  --%%% --------------  %% ------------------%%  % ------------------g------ t----tt---------------------%%% %%% %  --% %%%------------------------------------------------------
--------------||---||||||--||||--------------|||||------------------||||||------------%%%%  %% -Tt-tt----tt---------------------|||||||||||--|||||------------------------------------------------------
--------------||---||||||--||||----- %%---%%%|||||--------%%%%-- % %||||||------------|||||||||-tt-tt----tt-------- %%%%---%%%%%|||||||||||--|||||  %%%%% F%%%% %%%%%%% %%% % %%% %% % %%% %%%%%%%%% %%%
 X XXXX XXXXX ||---||||||--||||XXXXX|||---|||||||| XXX XXX||||--|||||||||| XXX --XXXX |||||||||XXXXXX XXXXXXXXX XXX|||||---||||||||||||||||--|||||||||||||X|||||||||||||||||||||||||||||||||||||||||||||