--------------------------------------------------------------------------------------------------------------------------------------------------------------------------------------------------------
--------------------------------------------------------------------------------------------------------------------------------------------------------------------------------------------------------
--------------------------------------------------------------------------------------------------------------------------------------------------------------------------------------------------------
--------------------------------------------------------------------------------------------------------------------------------------------------------------------------------------------------------
--------------------------------------------------------------------------------------------------------------------------------------------------------------------------------------------------------
--------------------------------------------------------------------------------------------------------------------------------------------------------------------------------------------------------
--------------------------------------------------------------------------------------------------------------------------------------------------------------------------------------------------------
--------------------------------------------------------------------------------------------------------------------------------------------------------------------------------------------------------
-------------------------------------------------------------------------------------------------------------------Tt-----------------------------------------------------------------------------------
-------------------------------------------------------------------------------------------------------------------t -----------------------------------------------------------------------------------
-------------------------------------------------------------------------Tt----------------------------------------tt--------------------------------------------------------------------------G--------
---------------------G---------------------------------------------------  ---------------------------------------Ktt-------------F----------------------------------------------------------UUU--------
-----------------%%%%%------%% %-----------------------------------------tt-----------------------------------%%%% %%%%%%----%%%--%%%----------KG---------G-----K----------------------------------%%%%%
-----------------|||||------||||--------------% % %% %   %%%%%%----------tt---------------------% %%--%%%-----|||||||||||----|||--|||---------SSU S 2-- %%%%--%%%---------K--------K---------------|||||
-----------------|||||------||||--------------|||||||||||||||||-----%  % %% %%%-----------------||||--|||-----|||||||||||----|||--|||------------------|||||--|||%%%%%----%% %--- %%----% %%%------|||||
 XXXXX XXXXXXXXXX|||||------||||X XXXXXXXXXXXX|||||||||XX XX X X XXX||||||||||| X XXXXX XXXXXXXX||||--|||XXXXXX XXX XXXXXXXXX|||--|||XXXX XX XX XXXXXXX|||||--||||||||----||||XX |||----|||||XXXXXX|||||