--------------------------------------------------------------------------------------------------------------------------------------------------------------------------------------------------------
--------------------------------------------------------------------------------------------------------------------------------------------------------------------------------------------------------
--------------------------------------------------------------------------------------------------------------------------------------------------------------------------------------------------------
--------------------------------------------------------------------------------------------------------------------------------------------------------------------------------------------------------
--------------------------------------------------------------------------------------------------------------------------------------------------------------------------------------------------------
--------------------------------------------------------------------------------------------------------------------------------------------------------------------------------------------------------
--------------------------------------------------------------------------------------------------------------------------------------------------------------------------------------------------------
--------------------------------------------------------------------------------------------------------------------------------------------------------------------------------------------------------
---------------------------------------------------------------------------------------------------------------------------------------------------------------------------------------r-k--------------
--------------------------------------------------------------------------------------------------------------------------------------------------------------------------------------------------------
-----------------------------------------------------------------------------------------------gkgggggggg---------------------  2CSC--------------------------------------------------%%%%%% %%%% %%%F% 
----------------------------------------g-g--------------------------------------------------r--||||||||----------- %%%%%% ----------------------------------SCCS SU -----------------|||||||||||||||%||
------------------------------------------------------------------------------- %%%%--%%% %%% --||||||||-% %%%%% %%||||||||-g---g--k------------------------------------%%%%%%%%%%%%%%||||||||||||||||||
------------------------------%% % %%------------------------------------------|||||--||||||||--||||||||-||||||||||||||||||----------------%%%-------------r--------r---||||||||||||||||||||||||||||||||
------%%%%%-------------------|||||||------------------------------------------|||||--||||||||%%% %% % %%||||||||||||||||||%%%%%%% %%%-----|||--------------------------||||||||||||||||||||||||||||||||
 XXX X|||||XXXX XXXXX XXX---XX XXXXXXXXX-----X XXXXXXXXX X----XXXXXXXXXX X---XXXXX XXX||||||||||||||||||||||||||||||||||||||||||||||||-----|||---- X XX XXXX XXXXXXXXXXX||||||||||||||||||||||||||||||||