--------------------------------------------------------------------------------------------------------------------------------------------------------------------------------------------------------
--------------------------------------------------------------------------------------------------------------------------------------------------------------------------------------------------------
--------------------------------------------------------------------------------------------------------------------------------------------------------------------------------------------------------
--------------------------------------------------------------------------------------------------------------------------------------------------------------------------------------------------------
--------------------------------------------------------------------------------------------------------------------------------------------------------------------------------------------------------
--------------------------------------------------------------------------------------------------------------------------------------------------------------------------------------------------------
--------------------------------------------------------------------------------------------------------------------------------------------------------------------------------------------------------
----------------------------------------------------------------------------------------------------------------------------------------------------%%%%%%%---------------------------------------------
----------------------------------------------------------------------------g----g-g----------------------------------------------------------------|||||||---------------------------------------------
--------------------------g--g--g-----------------2CUSCSSSSCC-%%%%%%%%%%%%%-------------------------------------------------------------------------|||||||---------------------------------------------
--------------------------------------------------------------|||||||||||||-------------------------------------------------------------------------|||||||---------------------------------------------
--------------------------------------------S2S2US------------|||||||||||||---------------------------------------------------%%%%%--g-rr---------%%%%%%%%%%%%-------------------------U22SC------------
--------------------------------------------------------------|||||||||||||-----%%%%%%%%%%%%------------------------------g---|||||---------------||||||||||||----rk-------k----------------------------
--------------------------------------------------------------|||||||||||||-----||||||||||||----------------------------------|||||-%%%%%%%%%%%%%%||||||||||||-----------------------k-----k------------
------%%%%%---------------------------------------------------|||||||||||||-----||||||||||||----------------------------------|||||-||||||||||||||||||||||||||---%%%%%%%%%%%%%%%%%%%--------------------
      ||||| X X XXXX XX X--- X  XXXXXX    X XXXXX  X XXXX X X |||||||||||||-----||||||||||||---     X XXX---- X XX XX XX --- XX   XX||||||||||||||||||||||||||---||||||||||||||||||| XXX    X  X XXXF X 