--------------------------------------------------------------------------------------------------------------------------------------------------------------------------------------------------------
--------------------------------------------------------------------------------------------------------------------------------------------------------------------------------------------------------
--------------------------------------------------------------------------------------------------------------------------------------------------------------------------------------------------------
--------------------------------------------------------------------------------------------------------------------------------------------------------------------------------------------------------
--------------------------------------------------------------------------------------------------------------------------------------------------------------------------------------------------------
--------------------------------------------------------------------------------------------------------------------------------------------------------------------------------------------------------
--------------------------------------------------------------------------------------------------------------------------------------------------------------------------------------------------------
--------------------------------------------------------------------------------------------------------------------------------------------------------------------------------------------------------
------------------------------------------------------------------U--------------------------g-----gr---------------------------------------------------------------------------------------------------
-------------------------------------------------------------------------SSSSCCC-----------------------------USSC22CS---------------------------------------------------------k-k-------k---------------
--------------------------------------------------------------------------------------------%%%%%%%%%%%%%%----------------------------------------------------------------------------------------------
--------------------------------%%%%%%--------------------------------gggkggggkggk----------||||||||||||||----------------------------------------------------------------------------------%%%%%%    %%
--------------------------------||||||--------------------%%%%%%%%%%%%----------------------||||||||||||||--------------------------------------------------------%%%%%%%-------------------||||||||| ||
--------------------------------||||||-----g------tt------||||||||||||------------%%%%%%%%%%||||||||||||||%%%%%%%%%%%%%%-----------------------------------------%%%%||||-------------------||||||||||||
------%%%%%---------------------||||||------------tt------||||||||||||------------||||||||||||||||||||||||||||||||||||||-----------------------------------------||||||||-------------------||||||||||||
XXXXXX|||||XXXXXXXXXXXXXX-----XXXXXXXXXXX-----XXXXXXXXX---||||||||||||XXXXXXXXXXXX||||||||||||||||||||||||||||||||||||||---XXXXXXXXXXXXXX-----XXX----XXXXXXXXXXXXXXXXXXXXXXXX-----XXXXXXXXXX||||||||||||