--------------------------------------------------------------------------------------------------------------------------------------------------------------------------------------------------------
--------------------------------------------------------------------------------------------------------------------------------------------------------------------------------------------------------
--------------------------------------------------------------------------------------------------------------------------------------------------------------------------------------------------------
--------------------------------------------------------------------------------------------------------------------------------------------------------------------------------------------------------
--------------------------------------------------------------------------------------------------------------------------------------------------------------------------------------------------------
--------------------------------------------------------------------------------------------------------------------------------------------------------------------------------------------------------
--------------------------------------------------------------------------------------------------------------------------------------------------------------------------------------------------------
--------------------------------------------------------------------------------------------------------------------------------------------------------------------------------------------------------
---------------------------------------------------------------------------------------------------------------------------------------------Tt------------Tt-------------------------------------------
----------------------------------Tt---------------------------------------------------------------------------------------------------------tt------------tt-------------------------------------------
----------------------------------tt---------K--------------------------------------------------------------------------------------------K-Ktt------------tt-------------------------------------------
----------------------------------tt---%%%%%%%%---------------------CC22-------------------------------------K--------------------F-------%%%tt------------tt-------------------------------------------
--------------------G-------------tt-K-||||||||----------------%%%%%--------------------%%%%%%---------------2SUUU2---------------%-----%%%%%%%%%%%----%%%%%%%%%%-------------G-------U2----------------
--------------U2SS-%%%%-------%%%%%%%%%||||||||------%%%%%%%%%%%||||--------------------||||||----------------------------------UC|-----|||||||||||----||||||||||------------%%%%%%%%%----------F-------
-------------------||||-------|||||||||||||||||------|||||||||||||||--------------------||||||---------------------%%%%%%%%%%%----|-----|||||||||||----||||||||||------------|||||||||---------- -------
XXXXXXXXXXXXXXXXXXX||||XXXXXXX|||||||||XXXXXXXXXXXXXX|||||||||||XXXXXXXXXXXXXXXXXXXXXXXX||||||XXXXXXXXXXXXXXXXXXXXX|||||||||||XXXXXXXXXX|||||||||||XXXX||||||||||XXXXXXXXXXXX|||||||||XXXXXXXXXXXXXXXXXX