--------------------------------------------------------------------------------------------------------------------------------------------------------------------------------------------------------
--------------------------------------------------------------------------------------------------------------------------------------------------------------------------------------------------------
--------------------------------------------------------------------------------------------------------------------------------------------------------------------------------------------------------
--------------------------------------------------------------------------------------------------------------------------------------------------------------------------------------------------------
--------------------------------------------------------------------------------------------------------------------------------------------------------------------------------------------------------
--------------------------------------------------------------------------------------------------------------------------------------------------------------------------------------------------------
--------------------------------------------------------------------------------------------------------------------------------------------------------------------------------------------------------
--------------------------------------------------------------------------------------------------------------------------------------------------------------------------------------------------------
-----------------------------------------Tt----------------------------------------Tt-----------------------------------------------------------------------------------Tt------------------------------
-----------------------------------------tt----------------------------------------tt-----------------------------------------------------------------------------------tt------------------------------
-----------------------------------------tt----------------------------------------tt---G-------------------------------Tt----------------------------------------------tt------------------------------
--------------------------C22S----------Ktt-GK---------------------------------%%%%%%%%%%-------------------------------tt-------- ---------------------------G---------tt------------------------------
-------------%%%%%%%%%%%-------------%%%%%%%%%---------------------------------||||||||||--------%%%----%%%%%-----CUS--Gtt--K-----%---%%%%%-----------------%%%%%%%%%%%%%%%%%---------------------------
-------------|||||||||||-------------|||||||||---------------------------------||||||||||--------|||----|||||--------%%%%%%%%%%---|---|||||-----------------|||||||||||||||||-----------------------  %%
-------------|||||||||||-------------|||||||||----%%%--------------------------||||||||||--------|||----|||||--------||||||||||--%%%%%%%%%%%----------------|||||||||||||||||-%%%%%%%%%%------------||||
XXXXXXXXXXXXXXXXXXXXXXXXXXXXXXXXXXXXX|||||||||XXXX|||XXXXXXXXXXXXXXXXXXXXXXXXXXXXXXXXXXXXXXXXXXXX|||----|||||XXXXXXXX||||||||||XX|||||||||||XXXXXXXXXXXXXXXXXXXXXXXXX||||||||X||||||||||XXXXXXXXXX    XX