||||||||||||||||||||||||||||||||||||||||||Tt||||||||||||||||||||||||||||||||||||||||||||||||||||||||||||||||||||||||||||||||||||||||||||||||||||||||||||||||||||||||||||||||||||||||||||||||||||||||||||
||||||||||||||||||||||||||||||||||||||||||tt|||||||||||||||||||||||||||||||||||||||||||||||||||||||||||||||||||||||||||||||||||||||||||||||||||||||||||||||||||||||||||||||||||||||||||||Tt|||||||||||||
|||||||||||||Tt|||||||||||||||||||||||||||tt||||||||||||||||||||||Tt|||||||||||||||||||||||||||||||||||||||||||||||||||||||||||||||||||||||||||||||||||||||||||||||||||||||||||||||||||||tt|||||||||||||
|||||||||||||tt||||||||||||||||||||||||K||tt||||||||||||||||||||||tt||||||||||||K|||||||||||||||||||||||||||||||||||||||||||||||||||||||||||||||Tt|||||||||||||||||||||||||||||||||||||||tt|||||||||||||
|||||||||||||tt|||||||||||||||||||||||%%%%%%%%%%%|||||||||||||||||tt|||||||||||SU2C||||||||||||||||||||||||||||Tt|||||||||||||||||F|||||||G|||||tt|||||||||||||||||||||||||||||||||||||||tt|||||||||||||
|||||||||||||tt||||||||||||||||||||||G|||||||||||||||||%%%%|||||||tt|||||||||||||||||||||||||||||||||||||||||||tt||||||||||||||%%%%%|||%%%%|||||tt||||||||||K|||||||||||||||||||||||||%%%%%%%%||||||||||
||||||||||%%%%%%%%|||||||||||||||GK|2U||||||||||||||||||||||||%%%%%%%%%||||||||||||||||%%%%%||%%%%%||||%%%%||||tt||||||UC2UC||||||||||||||||%%%%%%%%%%||||CSUSSSS|||||||||||||||||||||||||||||||||||||||
||||||||||||||||||||||||||%%%%%%%%%%|||||||||||||||||||||||||||||||||||||||||||||||||||||||||||||||||||||||%%%%%%%%%%||||||||||||||||||||||||||||||||||||||||||||||||||%%%%%||||%%%%||||||||||||||||||||
XXXXXXXXXX||||||||XXXXXXXX||||||||||XXXXXXXXXXXXXXXXXXX||||XXX|||||||||XXXXXXXXXXXXXXXXXXXXXXX|||||||||||||||||||||||XXXXXXXXXX||||||||||||X||||||||||XXXXXXXXXXXXXXXXX|||||||||||||XX||||||||XXXXXXXXXX
