--------------------------------------------------------------------------------------------------------------------------------------------------------------------------------------------------------
--------------------------------------------------------------------------------------------------------------------------------------------------------------------------------------------------------
--------------------------------------------------------------------------------------------------------------------------------------------------------------------------------------------------------
--------------------------------------------------------------------------------------------------------------------------------------------------------------------------------------------------------
--------------------------------------------------------------------------------------------------------------------------------------------------------------------------------------------------------
--------------------------------------------------------------------------------------------------------------------------------------------------------------------------------------------------------
--------------------------------------------------------------------------------------------------------------------------------------------------------------------------------------------------------
----------------------------------------------------------------------------U---------------------------------------------------------------------------------------------------------------------------
--------------------------------------------------------------------------------------------------------------------------------------------------------------------------------------------------------
----------------------------------------------------------------------------------%%%%%%%---------------------------------------------------------------------------------------------------------------
--------------------------------------------------------------------------------kgkkggggggg-------------------------------------------------------------------------------------------------------------
--------------------------------------ggkkgggggggk----------------------%%%%%%%%--|||||||--------------------------------------------------------------------CC2SC--------------------------------------
------------------------------------------------------------------------||||||||--|||||||--%%%%%%%%%%%%%-----%%%%%-----------------------------------------------------------------------------%%%    %%
------------------------------------r-------------%%%%%%%%------g-g-----||||||||--|||||||--|||||||||||||-----|||||-----gg--------------------------tt------g---------g-------------------------|||||| ||
------%%%%%--------------%%%%%%%%%%%%-------------||||||||--------------||||||||%%%%%%%%%%%|||||||||||||-----|||||---------------------------------tt------------------------------------------|||||||||
XXXXXX|||||XXXXXXXXXXXXXX||||||||||||XXXXXXXXXXXXX||||||||-----XXXXXXXXX||||||||||||||||||||||||||||||||---XXXXXXXX---XXXXXXXXXX-----XXX----XXXXXXXXXXXXXXXXXXXXXXXXX-----XXXXXXXXXXXXXXXXXXXXX|||||||||