--------------------------------------------------------------------------------------------------------------------------------------------------------------------------------------------------------
--------------------------------------------------------------------------------------------------------------------------------------------------------------------------------------------------------
--------------------------------------------------------------------------------------------------------------------------------------------------------------------------------------------------------
--------------------------------------------------------------------------------------------------------------------------------------------------------------------------------------------------------
--------------------------------------------------------------------------------------------------------------------------------------------------------------------------------------------------------
--------------------------------------------------------------------------------------------------------------------------------------------------------------------------------------------------------
--------------------------------------------------------------------------------------------------------------------------------------------------------------------------------------------------------
--------------------------------------------------------------------------------------------------------------------------------------------------------------------------------------------------------
---------------------------------------------------------------------------------------------------------------------T ---------------------------------------------------------------------------------
--------------------------------------------------------------------------------------------------------------------- t---------------------------------------------------------------------------------
------------K---G------------------------------------------------------------------------------------------T --------tt---------------------------------------------------------------------------------
--------%%%%%%%%%%----------------------------------------------------------------------------------------- t----%% %%%%%%%%------F-------------K------------Tt--------------------------K--------------
--------|||||||%%%%%%%%%%----------------------------------------------------------%% ------%%%%%--%% %%%--t ----||||||||K||------%------% %%---% %%---------t -------------------------%% ------ %%----
--------|||||||||||||||||-----------------------------------G% %%%% %%% %----------|||------|||||--|||||%   % %%%||||||2C2||------|------||||---||||---------tt-G-----% %---------------|||------|||----
--------|||||||||||||||||------ %%------% %%%--------%%%%%% %  ||||||||||----------|||------|||||--|||||||||||||||||||||||||------|------||||---||||----%%%%%%%%% %---|||- % --% %------|||------|||----
 XXX XXXXXXXXXXXX XXXXXXXXXXXXX|||------|||||XXXXXX X||||||||||XX XXXXXXXXXXXXXXXXX|||------|||||XXXXXXX|||||||||XXXXXXXX XX XXXX XXXXXXX||||---||||X XX||||||||||| X XXXX|||--||| XXXXX|||------|||XX X