--------------------------------------------------------------------------------------------------------------------------------------------------------------------------------------------------------
--------------------------------------------------------------------------------------------------------------------------------------------------------------------------------------------------------
--------------------------------------------------------------------------------------------------------------------------------------------------------------------------------------------------------
--------------------------------------------------------------------------------------------------------------------------------------------------------------------------------------------------------
--------------------------------------------------------------------------------------------------------------------------------------------------------------------------------------------------------
--------------------------------------------------------------------------------------------------------------------------------------------------------------------------------------------------------
--------------------------------------------------------------------------------------------------------------------------------------------------------------------------------------------------------
--------------------------------------------------------------------------------------------------------------------------------------------------------------------------------------------------------
---------------------------------------------------------------------- t--------------------------------------------- t----------------------------------------------------------------------- t--------
---------- t----------------------------------------------------------tt---------------------------------------------t t----------------------------- t---------------------------------------tt--------
----------tt----------------------------------------------------------tt---------------------------------------------ttt-----------------------------tt---------------------------------------tt--------
----------tt----------------------------------------------------------tt- -------------------------------------------ttt - -------F-%%%%%%%%%%%%-----tt-----------------------------------%%%%%%%%%%%---
----------tt- - -------------------%%%%%%%%------------------------%%%%%%%%%%------------------------------------%%%%%%%%%%%------%-||||||||||||----S2t-----------------SCCSSSS-----------|||||||||||CUC
------%%%%%%%%%%-------------------||||||||UC2U--------------------||||||%%%%%%%%%%%%----------------------------%%%%%%%%%%%------|-||||||||||||%%%%%%%%%%%---------------------------%%%%|||||||||||---
------||||||||||-------------------||||||||------------------------|||||||||||||||%%%%%%%%%----------------------|||||||||||------|-|||||||||||||||||||||||-%%%----%%%%%--------------|||||||||||||||---
 XXXXX||||||||||XXX X  XXXX XXXXXXX||||||||XX  XX XXXXX  XXXX X XX   XXX  XXX XXXX|||||||||  XX XXX XXXXXXXXXXX XX XX XX  X XX XX X X X XXXX XXXXX     XXX X|||----|||||X   XXXXXXXXXX||||X  XX XXX X  X