--------------------------------------------------------------------------------------------------------------------------------------------------------------------------------------------------------
--------------------------------------------------------------------------------------------------------------------------------------------------------------------------------------------------------
--------------------------------------------------------------------------------------------------------------------------------------------------------------------------------------------------------
--------------------------------------------------------------------------------------------------------------------------------------------------------------------------------------------------------
--------------------------------------------------------------------------------------------------------------------------------------------------------------------------------------------------------
--------------------------------------------------------------------------------------------------------------------------------------------------------------------------------------------------------
--------------------------------------------------------------------------------------------------------------------------------------------------------------------------------------------------------
--------------------------------------------------------------------------------------------------------------------------------------------------------------------------------------------------------
--------------------------------------------------------------------------------------------------------------------------------------------------------------------------------------------------------
--------------------------------------------------------------------------------------------------------------------------------------------------------------------------------------------------------
-------------Tt-----------------------------------------------------------------------------------------------------------------------------------------------------------------------------------------
-------------tt---------------------------------------------------------G----------------------%%%%%%----------------------------- -----------------------------K-K----------------------G--------------
-------------tt------%%%%%---%%%%--------------------------------------%%%%--------------------||||||-----------------------------%----------------------%%%%%%%%%%---------------------%%%%------   --%
-------------tt------|||||---||||--------------------------------------||||--------------------||||||-----------------------------|--------------G-------||||||||||---------------------||||------|||--|
--------%%%%%%%%%%---|||||---||||----------------------%%%%%---%%%%----||||--------------------||||||-----------------------------|------------%%%%%%%%%%%|||||||||---------------------||||------|||--|
XXXXXXXX||||||||||XXX|||||---||||XXXXXXXXXXXXXXXXXXXXXX|||||---||||XXXX||||XXXXXXXXXXXXXXXXXXXXXXXXXXXXXXXXXXXXXXXXXXXXXXXXXXXXXXXXXXXXXXXXXXXX|||||||||||XXXXXXXXXXXXXXXXXXXXXXXXXXXXXX||||------||| X|