-----------------------------------------------------------------------------------------------------------------------------        -------------------------------------------------------------------
-----------------------------------------------------------------------------------------------------------------------------        -------------------------------------------------------------------
-----------------------------------------------------------------------------------------------------------------------------        -------------------------------------------------------------------
-----------------------------------------------------------------------------------------------------------------------------        -------------------------------------------------------------------
-----------------------------------------------------------------------------------------------------------------------------        -------------------------------------------------------------------
-----------------------------------------------------------------------------------------------------------------------------        -------------------------------------------------------------------
-----------------------------------------------------------------------------------------------------------------------------        -------------------------------------------------------------------
-----------------------------------------------------------------------------------------------------------------------------        --------------Tt---------------------------------------------------
-----------------------------------------------------------------------------------------------------------------------------        --------------tt---------------------------------------------------
-----------------------------------------------------------------------------------------------------------------------------        --------------tt---------------------------------------------------
---------------------------------------Tt------------------------------------------------------------------------------------        --------------tt---------------Tt----------------------------------
---------------------------------------tt-------------G-----------2-----------------------------CC----------------------G----        ---------%-%%%%%%%%------------tt----------------------------------
-------------------------------------K-tt----G-----%%%%%%%%%%%-----K---------------------------------------------------%%%%%%        ---------|-|||G||||---------G--tt----------------------------------
----------------------%%%%----------%%%%%%%%%%-----|||||||||||-----%%%%%----%%%%--%%%---------G------------%%---K------||||||        -------%%%%%%%%%|||--------%%%%%%%%%%%-----------------------------
----------------------||||----------||||||||||-----|||||||||||-----|||||----||||--|||%%%%%%%%%%---------%%%%%%%%%%-----||||||        -------||||||||||||--------|||||||||||--%%%%----------%%%------%%%%
XXXXXXXXXXXXXXXXXXXXXX||||XXXXXXXXXXXXXXXXXXXXXXXXX|||||||||||XXXXX|||||----||||XX|||||||||||||XXXXXXXXX||||||||||XXXXX||||||        XXXXXXXXXXXXXXXXXXXXXXXXXXXXXXXXXXXXXXXX||||XXXXXXXXXX|||------||||