--------------------------------------------------------------------------------------------------------------------------------------------------------------------------------------------------------
--------------------------------------------------------------------------------------------------------------------------------------------------------------------------------------------------------
--------------------------------------------------------------------------------------------------------------------------------------------------------------------------------------------------------
--------------------------------------------------------------------------------------------------------------------------------------------------------------------------------------------------------
--------------------------------------------------------------------------------------------------------------------------------------------------------------------------------------------------------
--------------------------------------------------------------------------------------------------------------------------------------------------------------------------------------------------------
----------------------------------------------------------------------------------------------------------------------------------------------------------------------------%%%%%%%%--------------------
----------------------------------------------------------------------------------------------------------------------------------------------------------------------------||||||||--------------------
-----------------------------------------------------------------------------------------------------------------------------------kk--k------------------------%%%%%%%-----||||||||--------------------
---------------------------------------------------------g------------------------------------------------------------------------------------------------------|||||||-----||||||||--------------------
---------------------------------U----------------------------tt------------------------------------------------------------------%%%%%%%%%%%%%%----------------|||||||---%%%%%%%%%%%%%%----------------
-------------------------------------ggkggkggk----------------tt-------------------------------------------------------%%%%%%%----||||||||||||||----------------|||||||---||||||||||||||----------------
--------------------------------------------------------------tt-------------------------%%%%%%%-----------------------|||||||----||||||||||||||--------------%%%%%%%%%%%%||||||||||||||----------------
----------------------------------------------%%%%%%%%----%%%%%%%%%----------------g---g-k||||||----------------------%%%%%|||----||||||||||||||----%%%%%%%%%%||||||||||||||||||||||||||----------------
------%%%%%--------------%%%%%%%%%%%%---------||||||||----|||||||||----------------------|||||||---------------------%%%%%%%%%%%%%||||||||||||||----||||||||||||||||||||||||||||||||||||%%%%%%%%%%    %%
XXXXXX|||||XXXXXXXXXXXXXX||||||||||||XXXXXXXXX||||||||----|||||||||----XXXXXXXXXXX-----XXXXXXXXXXXXX---XXXXXXXXXXXXXX|||||||||||||||||||||||||||----||||||||||||||||||||||||||||||||||||||||||||||||| ||