--------------------------------------------------------------------------------------------------------------------------------------------------------------------------------------------------------
--------------------------------------------------------------------------------------------------------------------------------------------------------------------------------------------------------
--------------------------------------------------------------------------------------------------------------------------------------------------------------------------------------------------------
--------------------------------------------------------------------------------------------------------------------------------------------------------------------------------------------------------
--------------------------------------------------------------------------------------------------------------------------------------------------------------------------------------------------------
--------------------------------------------------------------------------------------------------------------------------------------------------------------------------------------------------------
--------------------------------------------------------------------------------------------------------------------------------------------------------------------------------------------------------
--------------------------------------------------------------------------------------------------------------------------------------------------------------------------------------------------------
-----------------------------------------------------------------------------------------------------------------------------Tt-------------------------------------------------------------------------
-----------------------------------------------------------------------------------------------------------------------------tt-------------------------------------------------------------------------
----------------------------------G-------------Tt--------------------------------------------------------G------------------tt-------------------------------------------------------------------------
---------------------------%%%%Tt%%%%-----------tt------------------------------------------------------UT2UC--------------K-tt---F---------------------------------------------------------------------
---------------------------|G||tt||||-----------G%-----------G-------------------------------------------tt--------------%%%%%%%%%%----------%%%%%%----------G------------------------------------------
---------------------------%%%%%%%%%%----------%||%%%%%%%%%%%%%--------------%%%---------------------%%%%%%%%%-----------||||||||||----------||||||--------%%%-----%%%-----%%%%----G------K----------F--
-------%%%%%%%%%-----------||||||||||--------%%%||%%%%%||||||||--------------|||---------------------|||||||||-----------||||||||||----------||||||--------|||-----|||-----||||--%%%%%%%%%%---------- --
XXXXXXX|||||||||XXXXXXXXXXXXXXXXXXXXXXXXXXXXX||||||||||XXXX||||XXXXXXXXXXXXXXXXXXXXXXXXXXXXXXXXXXXXXXXXXXXXXXXXXXXXXXXXXX||||||||||XXXXXXXXXXXXXXXXXXXXXXXXXXXXXXXX|||-----||||XX||||||||||XXXXXXXXXXXXX