---------------------------------------------------------------------------------------------------------------------------------        ---------------------------------------------------------------
---------------------------------------------------------------------------------------------------------------------------------        ---------------------------------------------------------------
---------------------------------------------------------------------------------------------------------------------------------        ---------------------------------------------------------------
---------------------------------------------------------------------------------------------------------------------------------        ---------------------------------------------------------------
---------------------------------------------------------------------------------------------------------------------------------        ---------------------------------------------------------------
---------------------------------------------------------------------------------------------------------------------------------        ---------------------------------------------------------------
---------------------------------------------------------------------------------------------------------------------------------        ---------------------------------------------------------------
-------------------------------------------------------------------------------Tt------------------------------------------------        ---------------------------------------------------------------
-------------------------------------------------------------------------------tt----------------------------------Tt------------        ---------------------------------------------------------------
----------Tt-------------------------------------------------------------------tt----------------------------------tt------------        t--------------------------------------------------------------
----------tt-----------Tt------------------------------------------------------tt----------------------------------tt------------        tG-------------------------------------------------------------
--------GKtt-----------tt--------------------------------------------------%%%%%%%%%-------------------------------tt--%%%%%%%%%%        t%%GK%%%-------------------------------------------------------
-------%%%%%%%%%-------tt--G-----------------------------------------------||||||%%%%--------------------------%%%%%%%%%%||||||||        %%%%%|||--------%%%%%------%%%---------------------------------
-------|||||||||--%%%%%%%%%%%%---------------------------------------------||||||||||----------------G-G-------|||||K||||%%%%||||        ||||||||--------|||||------|||----------------------------G----
-------|||||||||--||||||||||||---------------------------------------------||||||||||-------%%%%%---%%%%%------|||||%%%%|||||||||        ||||||||--------|||||------|||-----%%%%%%%%--------------%%%---
XXXXXXX|||||||||XX||||||||||||XXXXXXXXXXXXXXXXXXXXXXXXXXXXXXXXXXXXXXXXXXXXXXXXXXX||||XXXXXXX|||||---|||||XXXXXXXXXXX||||XXXXXXXXX        |||||XXXXXXXXXXX|||||------|||XXXXX||||||||XXXXXXXXXXXXXX|||---