--------------------------------------------------------------------------------------------------------------------------------------------------------------------------------------------------------
--------------------------------------------------------------------------------------------------------------------------------------------------------------------------------------------------------
--------------------------------------------------------------------------------------------------------------------------------------------------------------------------------------------------------
--------------------------------------------------------------------------------------------------------------------------------------------------------------------------------------------------------
--------------------------------------------------------------------------------------------------------------------------------------------------------------------------------------------------------
--------------------------------------------------------------------------------------------------------------------------------------------------------------------------------------------------------
--------------------------------------------------------------------------------------------------------------------------------------------------------------------------------------------------------
--------------------------------------------------------------------------------------------------------------------------------------------------------------------------------------------------------
--------------------------------------------------------------------------------------------------------------------------------------------------------------------------------------------------------
-------------------------------------------------------------Tt-----------------------------------Tt----------------------------------------------------------------------------------------------------
-------------------------------------------------------------tt-----------------------------------tt----------------------------------------------------------------------------------------------------
----------%%%%%%%%%--------K------------------%%%%%%%%%%-----tt-----------------------------------tt----------------K------------- ---------------------------------------------------------------------
----------|||||||||%%%%%%%%%------------------||||||||||-%%%%%%%%%%------C2------------------%K%%%%%%%%%-----------%%%%%%%%-------%---------------------------------------------------------------------
----------||||||||||||||||||------------%%%%%-||||||||||-||||||||||-------------------------%%%%||||||||-----------||||||||-------|--------------------------------------------K------------------------
----------||||||||||||||||||------------|||||-||||||||||-||||||||||-------------------------||||||||||||-----------||||||||-------|---------------------------------%%%%-----%%%%----%%%%%%%%%%---------
XXXXXXXXXXXXXXXXXXXXXXXXXXXXXXXXXXXXXXXXXXXXXXXXXXXXXXXXXXXXXXXXXXXXXXXXXXXXXXXXXXXXXXXXXXXX||||XXXXXXXXXXXXXXXXXXX||||||||XXXXXXXXXXXXXXXXXXXXXXXXXXXXXXXXXXXXXXXXX||||-----||||XXXX||||||||||XXX    XX