--------------------------------------------------------------------------------------------------------------------------------------------------------------------------------------------------------
--------------------------------------------------------------------------------------------------------------------------------------------------------------------------------------------------------
--------------------------------------------------------------------------------------------------------------------------------------------------------------------------------------------------------
--------------------------------------------------------------------------------------------------------------------------------------------------------------------------------------------------------
--------------------------------------------------------------------------------------------------------------------------------------------------------------------------------------------------------
--------------------------------------------------------------------------------------------------------------------------------------------------------------------------------------------------------
--------------------------------------------------------------------------------------------------------------------------------------------------------------------------------------------------------
--------------------------------------------------------------------------------------------------------------------------------------------------------------------------------------------------------
---------------------------Tt---------------------------------------------------------------------------------------------------------------------------------------------------------------------------
---------------------------tt--------------------------------------------------------------------------------------------------------------------------------------------------------Tt-----------------
---------------------------tK--------------------------------------------------------------------------K---------------------------Tt------------------------------------------------tt-----------------
----------------G--------%%%%%%%%%%----22%%Tt%%%%%%%------------%%%%%%%%%%%-----%%%%-------------------2S2S2-G-------------------- tt------------------------------------------------tt-----------------
------%%%%%%%%%%%------%%%%%%%%%|||------||tt||||%%%%%%%%%%-----|||||||||||-----|||%%%%%%%%%%%%--S2---%%%%%%%%%%%-----------------%tt--G------%%%%-----%%%%----------------------%%%%%%%%%---%%%%%--- %%
------|||||||||||------||||||||||||----%%%%%%%%%|||||||||||G----|||||||||||-----|||||||||||||||-------|||||||||||---------------%%%%%%%%%-----||||---%%%%||----------------------|||||||||---|||||---|||
------|||||||||||------||%%%|||||||----||||||||||||||||||||%%%%-|||||||||||-----|||||||||||||||-------|||||||||||-----%%%%%%%%%%|||||||||-----||||---||||||----------------------|||||||||---|||||---|||
XXXXXX|||||||||||XXXXXXXX|||XXXXXXXXXXXXXXXXXXXXX||||||||||||||XXXXXXXXXXXXXXXXXXXXXXXXXXXXXXXXXXXXXXXXXXXXXXXXXXXXXXX|||||||||||||||||||XXXXXXXXXXXXXXXXXXXXXXXXXXXXXXXXXXXXXXXXXXXXXXXXXXXX|||||---|||