--------------------------------------------------------------------------------------------------------------------------- --- ------------------------------------------------------------------------
--------------------------------------- ------------------------------------------------------------------ ---------------------------------------------------------------------------------------------
-------------------- -------------------------- --------------------------------------------------------------------------------------------------------- ----------------------------------------------
-------- ---------------------------------------------- ---------------------------------------------- -------------------------------------------------------------------------------------------------
------------------------------------------- ------------------------------------------------------------------------------------------------- ----- -------------- -------------------------------------
--------------------------------------------------------------------------------------------------------------------------------------------------------------------------------------------------------
-------------------------------------------- -------------------------- ---------- ------------------------------------------------------------------------------------------------- ----- -------------
- -------------------------- ------------------- ------------------------------------------------------------------------------------------------------- -----------------------------------------------
---------------------------------------------------------------------------------------------------------------------------------------- ----------------------------------------- ----------- ---------
--------------------- -------------------------------------------------------------------------------------------------------U SSS -%% %% %% %   -- ----------------- ----------------------------------
-------------- -------------------------------------------------------------------------------------------r-------------------------||| ||||||||| %%% %%%% %  ------------------------------------------
----------------------- ------- ----------------------------------U---gggggrkrk--------------%%%% %%%%-------------------U----------||||||||||||||||||||||||||------------------- --%%%%%---------------
------------------- -------------------------------------------------------------------------|||||||||------------------------------||||||||||||||||||||||||||--------------r----- -|||||---------------
--------------------------g---%%%%%%g------g------g-g------------------- %% %--% %%%% %%%% % |||||||||------------ --------- -------||||||||||||||||||||||||||----------------------|||||---------------
------% %% ----------------- -||||||---------- -------------------------|||||--|||||||||||||| ||||||||------------------------------| ||||||||||||||||||||||||----%%%%%%%%%  %------|||||---------------
    XX|||||XXX  X    XX X---X X    X XX---X  X X  X   ----- XXX X X      XX  XX|||||||||||||||||||||||----- XXXXXXX  X  X     X  X X||||||||||||||||||||||||||----||||||||||||---- XXX X X X X   X X  F 