 ----------------------------------------------------------- ---- --- -----------------  --------- --------------------------------------------------------------------------------------- --- ---------
-------------------------------------------------------------------------------- ----------------------------------------------------- ------------------------------------- ---------- ----------------
------------------------------ ------------------- -----------------------------------------------------------------------------------------------------------------------------------------------------
-------------------------------------------------------------------------------------------------------------------------------------------------------- ----------------- ---------------------------- 
------------ ------------------------------------------------------------------------------------------------------------------------------------------- ----------- -----------------------------------
---------------------------------------- --------------------------------------------------------------------------------------------------------------- --------------------- -------------------------
------------------------------------------------------------------------- ----------------------------------------------------------------------- ------ -----------------------------------------------
---------------------- ---------------------------------------- ---------------------------------------------------------------------------------------- ---------------------------- ---------------Tt-
--------------- ---------------------------------- ----------------------------------------------------------------------------------------------------- ---------------------------- ---------------tt-
----------------------------------------------------------- --------------- ------------------------------------------------------------------------- -- --------------------------------------------tt-
----------------------------------------Tt-------------------------------------------------------------------------------- --------- ------------------- ----------Tt--------------------------------tt-
--- --------K----------------%%%%%------tt-----------2SC-  ---------- ------------------------- -----------------% %%%%%%--------- ----------------UC--- ----------tt-----------------------------%%%Tt%
--------- --%%%%%------%%%---|%%%|------tt-------- -----G----------------------------%%%% ---%%%--------- -------||||||||----%%%% %------------------------%%%%%%--tt------------ -------------SS2|||tt|
------------|||||------|||---|||||------tt------------%%%---------- -----------------|||||---|||-----------------||||||%%%%%-||||||-------- -- ------------|||||| -tt----------SSUSU------------%%%%%%%%
------------|||||------|||---|||||--%%%%%%%%%- -------|||----------------------- - --|||||---||| ----------------|||||||||||-||||||-------------%%%%%- ----||||| %%%%%%%%--------- -------------||||||||
 XXXXXXXXXXX|||||------||| XXX|||XXX|||||||||XXXXXXXXX| |XXXXXXXXXXXXXXXXXXXXXXXXXXXX|||||---|||XXXXXX XXXXXXXXXXXXXXXX|||||X|||||XXXXXXXXXXXXXX||| |XXXXX XXXXX||||||| |XXXXXXXXXXXX XXXXXXXXXXXXXXXXXX