----------------------------------------------------------------------------------------------------------------------------       ---------------------------------------------------------------------
----------------------------------------------------------------------------------------------------------------------------       ---------------------------------------------------------------------
----------------------------------------------------------------------------------------------------------------------------       ---------------------------------------------------------------------
----------------------------------------------------------------------------------------------------------------------------       ---------------------------------------------------------------------
----------------------------------------------------------------------------------------------------------------------------       ---------------------------------------------------------------------
----------------------------------------------------------------------------------------------------------------------------       ---------------------------------------------------------------------
----------------------------------------------------------------------------------------------------------------------------       ---------------------------------------------------------------------
----------------------------------------------------------------------------------------------------------------------------       ---------------------------------------------------------------------
----------------------------------------------------------------------------------------------------------------------------       ---------------------------------------------------------------------
----------------------------------------------------------------------------------------------------------------------------       -------------------------------Tt--------------------------Tt--------
----------------------------------------------------------------------------------------------------------------------------       -------------------------------tt--------------------------tt--------
------------------------------------------K----%%-%%K%%%%%------------------K-----------------------------------------------       ----------------------------G--tt---K----------------------tt--K-----
-------------------------------%%%------%%%--%%%%%%%%%%|||-----------------CSU22--------------------------------------------       ---------------------------%%%%%%%%%%-----------------%%%%%%%%%%%%%--
-------------------------------|||------|||--|||||||||||||------------------------------------------K-----------------------       ------------K------G-------||||||||||-%%%-------------|||||||||||||--
-------------------------------|||------|||--|||||||||||||-------------------------------%%%----%%%%%-------------------%%%%       -----------%%%%%%%%%-------||||||||||-|||-------------|||||||||||||--
XXXXXXXXXXXXXXXXXXXXXXXXXXXXXXX|||------|||XX||||||||||XXXXXXXXXXXXXXXXXXXXXXXXXXXXXXXXXX|||----|||||XXXXXXXXXXXXXXXXXXX||||       XXXXXXXXXXX|||||||||XXXXXXX||||||||||XXXXXXXXXXXXXXXXXXXXXXXXXXX|||--