-------------------------------------------------------------------------------------------------------------------------------------------------    ---------------------------------------------------
-------------------------------------------------------------------------------------------------------------------------------------------------    ---------------------------------------------------
-------------------------------------------------------------------------------------------------------------------------------------------------    ---------------------------------------------------
-------------------------------------------------------------------------------------------------------------------------------------------------    ---------------------------------------------------
-------------------------------r---g-------------------------------------------------------------------------------------------------------------    ---------------------------------------------------
-----------------------------%%%%%%%-------------------------------------------------------------------------------------------------------------    ---------------------------------------------------
-----------------------------|||||||-------------------------------------------------------------------------------------------------------------    ---------------------------------------------------
-----------------------------|||||||-------------------------------------------------------------------------------------------------------------    ---------------------------------------------------
----------------------------y|||||||-------------------------------------------------------------------------------------------------------------    ---------------------------------------------------
-------------------------%%%%%%|||||---------------------------------------------y------------------r--------CCSSS-------------------------------    ---------------------------------------------------
-------------------------|||||||||||------------------------------------------%%%%%%%--------------%%%%%%----------------------------------------    ---------------------------------------------------
-------------------------r|r|g|k||||--------y---------------------------------|||||||-----r-k------||||||----------------------------------------    ---------------------------------------------------
------------------------%%%%%%%%%%%%%%%%%%%%%%--#---#---------------%%---%%---|r|||||---%%%%%%%%%%%%%%%%%%%------r----------------#---#----------    ---------------------------------------------------
------------------------||||||||||||||||||||||%%%---%%%--%%%%%------||---||%%%%%%%%%%%%%|||||||||||||||||||-%%%%%%---------------##---##--%%%%%%%    %%%%%%%%%%%%%%%%%%%%%%%%%%%%%%%%%%%%%%%%%%%%%%%%%%%
------------------------|||||||||||||||||||||||||---|||--|||||------||---||||||||||||||||||||||||||||||||||-||||||-yk----------%%%%---%%%%|||||||    |||||||||||||||||||||||||||||||||||||||||||||||||||
XXXXXXXXXXXXXXXX---XXXXX|||||||||||||||||||||||||---|||XXXXXXXXXXXXX||---||||||||||||||||||||||||||||||||||XXXXXXXXXXXXXXXX--XX||||---|||||||||||    |||||||||||||||||||||||||||||||||||||||||||||||||||