--------------------------------------------------------------------------------------------------------------------------------------------------------------------------------------------------------
--------------------------------------------------------------------------------------------------------------------------------------------------------------------------------------------------------
--------------------------------------------------------------------------------------------------------------------------------------------------------------------------------------------------------
--------------------------------------------------------------------------------------------------------------------------------------------------------------------------------------------------------
--------------------------------------------------------------------------------------------------------------------------------------------------------------------------------------------------------
--------------------------------------------------------------------------------------------------------------------------------------------------------------------------------------------------------
--------------------------------------------------------------------------------------------------------------------------------------------------------------------------------------------------------
-------------------------------------------------------------------------------------------------------------------------------------------------------------------------------%%%%%--------------------
-------------------------------------------------------------------------------------------------------------------------------------------------------------------------------|||||--------------------
---------------------------g---------------------------------------------------------------k------------------------------------------------2SU2CS--%% %%%%% ------------------|||||--------------------
-------------------------------------------------------------------------------------------------- %%%%%%-------------------------------------------|||||||||----------------%%% %% %---%%% %%%%%%%%%F%%
------------------------------%%%%%------------gggggggkrrkr---------------------%  %% %-----------|||||||-------%%%%----------------- 22SSC---------|||||||||----------------||||||||---|||||||||||||%||
------------------------------|||||---------------------------------------------|||||||-----------|||||||-------||||--------------------------------|||||||||----------------||||||||---||||||||||||||||
------------------------------|||||----------r-------------%%%%%%%%%%%%%%-------|||||||-----------|||||||-------|%%%%%%%%---------------------------|||||||||-----%%% %%%%%% ||||||||---||||||||||||||||
------%%% %-------------------|||||--%%% %%%% -------------||||||||||||||-----%%%% %% %%%% -----%%%%%%%% %%%----|||||||||---------------------------|||||||||-----|||||||||||||||||||---||||||||||||||||
 XX X |||||XX X XXXX XXX ---XXXXXX  X|||||||||XXXXXX XXXXXX||||||||||||||-----|||||||||||||-----||||||||||||---XXXXXXXXXX  XXXXXXXXXXXXXX XXXXXXXXXX|||||||||-----|||||||||||||||||||---||||||||||||||||