--------------------------------------------------------------------------------------------------------------------------------------------------------------------------------------------------------
--------------------------------------------------------------------------------------------------------------------------------------------------------------------------------------------------------
--------------------------------------------------------------------------------------------------------------------------------------------------------------------------------------------------------
--------------------------------------------------------------------------------------------------------------------------------------------------------------------------------------------------------
--------------------------------------------------------------------------------------------------------------------------------------------------------------------------------------------------------
--------------------------------------------------------------------------------------------------------------------------------------------------------------------------------------------------------
--------------------------------------------------------------------------------------------------------------------------------------------------------------------------------------------------------
--------------------------------------------------------------------------------------------------------------------------------------------------------------------------------------------------------
--------------------------------------------------------------------------------------------------------------------------------------------------------------------------------------------------------
-----------------------------------------------------------------------------------------------------Tt-------------------------------------------------------------------------------------------------
-----------------------------------------------------------------------------------------------------tt---------------Tt---------------------------G----------------------------------------------------
----------------------------------------------------------------------------------G------------------tt---------------tt----------F---------------%%%%%%%%%%%---G------------------------%%%%%%%%%------
---------------------------K----------------------------------%%%---------------%%%-----%%%%%-------Ktt---K---K--G----tt---------2SS--------------||||||||||K-SC2C2----------------------|||||||||------
----------------%%%%%%---%%%%%%%%%--------%%%%---%%%----------|||---------------|||-----|||||----%%%%%%%%%%---%%%%%---tt--------------------------|||||||22SC----------------------------|||||||||F-----
----------------||||||---|||||||||--------||||---|||----------|||---------------|||-----|||||----||||||||||---||||%%%%%%%%%%----%%%---------------|||||||||||----------------------------||||||||| -----
XXXXXXXXXXXXXXXXXXXXXXXXXXXXXXXXXXXXXXXXXX||||XXXXXXXXXXXXXXXXXXXXXXXXXXXXXXXXXX|||-----|||||XXXX||||||||||XXXXXXX||||||||||XXXX|||XXXXXXXXXXXXXXXXXXXXXXXXXXXXXXXXXXXXXXXXXXXXXXXXXXXXXXXXXXXXXXXXXXXXX