--------------------------------------------------------------------------------------------------------------------------------------------------------------------------------------------------------
--------------------------------------------------------------------------------------------------------------------------------------------------------------------------------------------------------
--------------------------------------------------------------------------------------------------------------------------------------------------------------------------------------------------------
--------------------------------------------------------------------------------------------------------------------------------------------------------------------------------------------------------
--------------------------------------------------------------------------------------------------------------------------------------------------------------------------------------------------------
--------------------------------------------------------------------------------------------------------------------------------------------------------------------------------------------------------
--------------------------------------------------------------------------------------------------------------------------------------------------------------------------------------------------------
--------------------------------------------------------------------------------------------------------------------------------------------------------------------------------------------------------
--------------------------------------------------------------------------------------------------------------------------------------------------------------------------------------------------------
-----------------------------------------------------------------------------------------------------------------Tt-------------------------------------------------------------------------------------
-----------------------------------------------------------------------------------------------------------------tt----------------------------------------------------------------------------G--------
-----------------------------------------------------------------------------------------------------------------tt--------------- ------------------CS2U-------------------K------G-----------%%%------
-----------------------%%%%%---%%%%-----------------------------------------------------------------------------Ktt-K-------------%-------%%-%%%--------------------------%%%%%%%%GG%%---------|||--- %%
-----------------------|||||---||||-UC2UCS2-------------------------------------------------------%%%%%%------%%%%%%%%------------|-------||-|||-----------K--%%%%%-------|||||||%%%%%%--------|||---|||
-----------------------|||||---||||------------------%%%%%--%%%%----------------------------------||||||------||||||||------------|----%%%%%%%%%%----------%%%|||||-------|||||||||||||--------||%    %%
XXXXXXXXXXXXXXXXXXXXXXX|||||---||||XXXXXXXXXXXXXXXXXX|||||--||||XXXXXXXXXXXXXXXXXXXXXXXXXXXXXXXXXX||||||XXXXXXXXXXXXXXXXXXXXXXXXXXXXXXX||||||||||XXXXXXXXXX||||||||XXXXXXXXXXXXXX||||||XXXXXXXXXX|||||||