------------------------------------------------------------------------------------------------------------------------------       -------------------------------------------------------------------
------------------------------------------------------------------------------------------------------------------------------       -------------------------------------------------------------------
------------------------------------------------------------------------------------------------------------------------------       -------------------------------------------------------------------
------------------------------------------------------------------------------------------------------------------------------       -------------------------------------------------------------------
------------------------------------------------------------------------------------------------------------------------------       -------------------------------------------------------------------
------------------------------------------------------------------------------------------------------------------------------       -------------------------------------------------------------------
------------------------------------------------------------------------------------------------------------------------------       -------------------------------------------------------------------
------------------------------------------------------------------------------------------------------------------------------       -------------------------------------------------------------------
------------------------------------------------------------------------------------------------------------------------------       -------------------------------------------------------------------
--------------------------------------------------------------------------------------------------------------Tt--------------       ---------------------------------------Tt--------------------------
--------------------------------------------------------------------------------------------------------------tt--------------       ---------------------------------------tt--------------------------
-----------------------G---------------Tt--------------------------------------K------------------%%%%%%%%-G--tt--------------       -----------K---------------------------tt--------------------------
--------------------%%%%------%%%%%----tt------------------22S----------------%%%%--%%%%----------||||||||%%G%tt%%%%%---------       -----%%%%%%%%--G---------------------K-tt--------------------------
--------------------||||------|||||--G-tt---------------------%%%%%----%%%%%--||||--||||----------|||||||||%%%%%%%%||S2--%%%%%       -----||||||||%%%%%----------------%%%%%%%%%%----------------------%
--------------------||||------|||||-%%%%%%%%------------------|||||----|||||--||||--||||----------|||||||||||||||||||----|||||       -----|||||||||||||----------------||||||||||-------------------%%%%
XXXXXXXXXXXXXXXXXXXX||||------|||||X||||||||XXXXXXXXXXXXXXXXXX|||||----|||||XX||||--||||XXXXXXXXXXXXXXXXXXXXXXXXXXXXXXXXXXXXXX       XXXXX||||||||XXXXXXXXXXXXXXXXXXXXXXXXXXXXXXXXXXXXXXXXXXXXXXXXXX||||