--------------------------------------------------------------------------------------------------------------------------------------------------------------------------------------------------------
--------------------------------------------------------------------------------------------------------------------------------------------------------------------------------------------------------
--------------------------------------------------------------------------------------------------------------------------------------------------------------------------------------------------------
--------------------------------------------------------------------------------------------------------------------------------------------------------------------------------------------------------
--------------------------------------------------------------------------------------------------------------------------------------------------------------------------------------------------------
--------------------------------------------------------------------------------------------------------------------------------------------------------------------------------------------------------
--------------------------------------------------------------------------------------------------------------------------------------------------------------------------------------------------------
--------------------------------------------------------------------------------------------------------------------------------------------------------------------------------------------------------
--------------------------------------------------Tt-------------------------------------------------------------TTt------------------------------------------------------------------------------------
--------------------------------------------------tt-------------------------------------------------------------ttt------------------------------------------------------------------------------------
---------------------G----------------------------tt-------------------------------------------------------------ttt------------------------------------------------------------------------------------
----------------22SSCS------------------------%%%%%%%%%------%%%%%%%%%-----------------------------------K--%%%%%%tt%%-G----------F--------------------------Tt-----------------------------------------
------------------------------------%%%%%%%%%-|||||||||------|||||||||--------------------------------%%%%%-|%%%%%%%%%%%----------%--------%%%%%--%%%%-------tt-----------K-----------------------------
------------------------------------|||||||||-||||%%%%|------|||||||||------------U2UU----------------|||||-||||||||||||----------|--------|||||--||||-------tt---------C2CCU2-----------%%%-------F----
------------------------------------|||||||||-|||||||||------|||||||||--------------------------------|||||-||||||||||||------%%%-|--------|||||--||||----%%%%%%%%%%---------------------|||------- ----
XXXXXXXXXXXXXXXXXXXXXXXXXXXXXXXXXXXX|||||||||XXXXX||||XXXXXXXXXXXXXXXXXXXXXXXXXXXXXXXXXXXXXXXXXXXXXXXX|||||XXXXXXXXXXXXXXXXXXX|||XXXXXXXXXX|||||--||||XXXX||||||||||XXXXXXXXXXXXXXXXXXXXX|||XXXXXXXXXXXX