- ------------------------- ----------------------------------------------------------------------------------------------------------------------------------------------------------------------------
- ------------------------------------------------------------ -----------------------------------------------------------------------------------------------------------------------------------------
--------------------------- ----------------------------------------------------------------------------------------------------------------------------------------------------------------------------
------------------------------------------------------------------------------------------------------ -------------------------------------------------------------------------------------------------
--------------------------------------------------------------------------- ------------------------------------------------------U---------------------------------------------------------------------
-------------------------------------------------------------------------------- ---------------------------------------------- ------------------------------------------------------------------------
---------------------------------------------------------- -------------------------------------------------- -- %  %  %----------------% %%%---------------------------------------- ------------------
------------------------------------------------------------------------------------------------ ---------------||||||||--------------ggggggkkr--------------------------------------- -----------------
---------------------------------------------------------------------------------------- ------------------g----|||||||g----%% %%%  %%--|||||----------------k-------k----------------------------------
--------------------------------------------------- -g----------g-----------------SC 2CSCUCC--    % %%%%%%------||||||||----||||||||||--|||||-- %% %%%%% %%%----------------------- ---------------- ---
---------------------------------------S2C----------------------------------------------------||||||||||||----%% % %%%  %%% ||||||||||--|||||--|||||||||||||  %% %     %%%-----%% %%--------------------
- -----------------------------------ggggggg----------------------------- -CSS2CU-------------||||||||||||----|||||||||||||||||||||||| %   %%%%|||||||||||||||||||||||||||-----|||| --------------------
------- ---------------------------r----------------------------------------------------------||||||||||||----||||||||||||||||||||||||||||||||||||||||||||||||||||||||||||---  % %% %-------------------
----------- -------------% % %%% %  --------%%%%% %%---------tt-------------------------------||||||||||||----|||||||||||||||||||||||| ||||||||||||||||||||| |||||||||||||---||||||||-------------------
------  %%%--------------|||||||||||--------||||||||---------tt-------------------------------|||||||||||| ---||||||||||||||||||||||||||||||||||||||||||||||||||||||||||||---||||||||----------------- -
 XXXXX|||||X XXXX X X XXX||||||||||| XX X  X||||||| ---XX XX X XXXX XXXXXXX       X XXXX X  XX||||||||||||----||||||||||||||||||||||||||||||||||||||||||||||||||||||||||||---||||||||XX XXXX  X  X XXFXX