---------------------------------------- ----------------------- ----------------------------------------------------------------------- ------- --------------------------------------  ---------------
---------- ---------------------------------------------------------------------------------------------------------------------------------------------------------------------------------------------
------------------------------------------------------------------------------------------- ------------------------------------------------------------------------------------------------------------
-------------------------------------- -- ----------- --------------------------------------------------------------------------------------------------------------------------------------------------
---------------------------------------------------------------------------------- ---------------------------------------------------------------------------------------------------------------------
---------------------------------------------------------------- ---------------------------------------------------------------------------------------------------------------------------- ----------
--------------------------------------------------------------------------------------------------------------------------------------------------------------------------------------------------------
----------------------------------------- --------------------------------------------------------------------------------------------------------------------------------------------------- - --------
--------------------- ---------------------------------------------- -----------------------------------------------------------------------------------------------------------------------------------
--------------------------------------------tt-------------------------------------------------------------------------------------------------------------------------------------- -------------------
----------- --------------------------------tt----------------------%%%%------------------ ---------------------------------------------------------------------------- ------- -- ---------------------
----------------------------- --------- ----tt----------------------||||--------------------------------------------------------------------------------------------------------------------------------
------------------------------------------%%%%%%%------------%%--%%-||||----y---------------- ------------------%%%%--%%%%-------- ---------------------------------------------------------------------
----------%%%%%--%%%%%------------------k-|||||||----Tt------||--||%%%%%%%%%%%%%---- ---%%%%%---%%%%%%%%%---%%%%||||--||||-------------------- ---------------------------------------------------------
----------|||||--|||||%%---%%----%%%%%%%%%|||||||----tt------||--||||||||||| |||--------|||||---|||||||||--         --||||- --------------------------------------- ------- ----------------------------
 XX XXXX X|||||--|||||||---||XXXX||||||||| ||||||XXXXXXXXXXXX||--|||||||| ||||||XXXXXX X|||||---|||||||||---|| |||||--||||XXXXXX XX---XXXX XXXX XXXF X XXXX XXXXXXXXXX  XXXX XXXXXXXXXXXXX XXXXXXXXX X X