--------------------------------------------------------------------------------------------------------------------------------------------------------------------------------------------------------
--------------------------------------------------------------------------------------------------------------------------------------------------------------------------------------------------------
--------------------------------------------------------------------------------------------------------------------------------------------------------------------------------------------------------
--------------------------------------------------------------------------------------------------------------------------------------------------------------------------------------------------------
--------------------------------------------------------------------------------------------------------------------------------------------------------------------------------------------------------
--------------------------------------------------------------------------------------------------------------------------------------------------------UCSSS--%%%%%%%%%%%------------------------------
---------------------------------------------------------------------------------------------------------------------------------------------------------------|||||||||||--SSSCSC----------------------
--------------------------------------------------------------------------------------------------------------------------------------------------USSCC--------|||||||||||------------------------------
----------------------------------------------------------g--------g--------------U------------------------gg-----g--------------------------------------------|||||||||||-g--g-------------------------
---------------------------------------gkggkgkkk------------------------------------------CC2------------------------------------------------------------------|||||||||||------------------------------
-------------------------------------r--|||||||----------------------------------------------------------------------------------------------------------------|||||||||||%%%%%%%%%%--------------------
-------------------------%%%%%%%%%%%%%--|||||||-%%%%%%%%%-----------------------------kgggggggg------------------------------------%%%-----%%%%%%%%%%%%--------|||||||||||||||||||||--------------------
-------------------------|||||||||||||--|||||||-|||||||||-----------------%%%%%%%%%%%%---------------------------------------------|||-----||||||||||||--------|||||||||||||||||||||--------------------
-------------------------|||||||||||||%%%%%%%%%%|||||||||-----------------||||||||||||---------%%%%%%%%%%%-------------------------|%%%%%--||||||||||||--------|||||||||||||||||||||-----%%%%%%%%%    %%
------%%%%%--------------||||||||||||||||||||||||||||||||-----%%%%%%%%%%%%||||||||||||---------|||||||||||-----%%%%%%%%%%%%%%------||||||--||||||||||||--------|||||||||||||||||||||-----|||||||||||| ||
XXXXXX|||||XXXXXXXXXXXXXX||||||||||||||||||||||||||||||||-----||||||||||||||||||||||||XXXXXXXXX|||||||||||-----||||||||||||||-----XXXXXXXXX||||||||||||XXXXXXXX|||||||||||||||||||||-----|||||||||||||||