-------------------------------------------------------------------------------------------------------------------------------      -------------------------------------------------------------------
-------------------------------------------------------------------------------------------------------------------------------      -------------------------------------------------------------------
-------------------------------------------------------------------------------------------------------------------------------      -------------------------------------------------------------------
-------------------------------------------------------------------------------------------------------------------------------      -------------------------------------------------------------------
-------------------------------------------------------------------------------------------------------------------------------      -------------------------------------------------------------------
-------------------------------------------------------------------------------------------------------------------------------      -------------------------------------------------------------------
-------------------------------------------------------------------------------------------------------------------------------      -------------------------------------------------------------------
-------------------------------------------------------------------------------------------------------------------------------      -------------------------------------------------------------------
-----------------------------------------Tt------------------------------------------------------------------------------------      -------------------------------------------------------------------
-----------------------------------------tt--------Tt--------------------------------------------------------------------------      -------------------------------------------------------------------
-----------------------------------------tt--G-----tt--------------------------------------------------------------------------      ------------------------------------------------------K------------
-------------------------------------%%%%%%%%%-----tt-G-------------------------------------------------------------Tt---------      %%%----------------------------------------------%%%%K%------------
------------------G------------------|||||||||-%%%%%%%%%------------------------------------------------------------tt---------      |||----------------------------------------------||%%%%G-----------
------------------%%%%-%%%%%%%%%%%---|||||||||-|||||||||---%%%--%%%%--------GK-G------------------------------%%%%%%tt%%--K----      |||----------------------------------------------||||||%%%%%%%-----
------------------||||-|||||||||||-%%%||||||||-|||||||||---|||--||||--------%%%%%-----------------------------|%%%%%%%%%%%%----      |||---------%%%---%%%%----%%%%-------------------|||||||||||||-----
XXXXXXXXXXXXXXXXXX||||X|||||||||||X|||XXXXXXXXX|||||||||XXX|||--||||XXXXXXXX|||||XXXXXXXXXXXXXXXXXXXXXXXXXXXXXX||||||||||||XXXX      XXXXXXXXXXXX|||XXX||||----||||XXXXXXXXXXXXXXXXXXXXX||||XX|||||-----