-------------------------------------------------------------------------------------------------------------------------------------------------------------- -----------------------------------------
--------------------------------------------------------------------------------------------------------------------------------------------------------------------------------------------------------
------ --------------------- ---------------------------------------------------------------------------------------------------------------------------------------------------------------------------
--------------------------------------------------------------------- --------------------------------------------------------------------------------- ------------------------------------------------
- -------- ---------------------- ----- ----------------------------------------------------------------------------------------------------------------------------------- ----------------------------
------------------------------------------------------------------------ -------------------- ----------------------------------------------------------------------------------------------------------
-------------------------------------------------------------------------------- --------------     ----------------------------------------------------------------------------------------------- ----
----------------------------------------------------------------------------------- --------------------------------------------------------------------------------------------------------------------
---------------- ---------------------------------------------- ------------------------------------------------------------------------------------------------------------------ ------------- -------
-------------------------------------------------------------------------------------------------------------------- ------------------- -------------------------------------------------- ------------
----------------------------------------------------------------------G--------------------Tt------ ----------------------------------------G-G---------------------------------------------------------
-------------------- ------------%%%%-----------------K--G-----------%%%%%%%%-- -----------tt-------------------------------------F-------U2CCU------------------- --K--------------------------- ------
---------------------------------||||---------%%%%----%%%%%-----K----||||||||- ------------tt-------------------------------------%-------------------------%%%------%%%%-------------------------------
---------------------------------||| ---------||||----|||||--%%%%%%%%%%%%||||----------%%%%%%%%%----------------------K-------K---|----------------- -------|||------||||-------------------------------
---------------------------------||||---------||||----|||||--||||||||||||||||----------|||||||||-------------------%%%%%------%%%%|-------------------------|||------||||-------------------------------
 XXXXXXXXXXXXXXXXXXXXXXXXXXXXX XXXXXXXXXXXXXXX||||----|||||XX||||||||||||XXXXXXXXXXXXXXXXXXXXXXXXXXXXXXXXXXXXXXXXXX|||||------||||XXXXXXXXXXXXXXXXXXXXXXXXXX|||------||||XXXXXXXXXXXXXXXXXXXXXXXXXXXXXXX