--------------------------------------------------------------------------------------------------------------------------------------------------------------------------------------------------------
--------------------------------------------------------------------------------------------------------------------------------------------------------------------------------------------------------
--------------------------------------------------------------------------------------------------------------------------------------------------------------------------------------------------------
--------------------------------------------------------------------------------------------------------------------------------------------------------------------------------------------------------
--------------------------------------------------------------------------------------------------------------------------------------------------------------------------------------------------------
--------------------------------------------------------------------------------------------------------------------------------------------------------------------------------------------------------
--------------------------------------------------------------------------------------------------------------------------------------------------------------------------------------------------------
--------------------------------------------------------------------------------------------------------------------------------------------------------------------------------------------------------
--------------------------------------------------------------------------------------------------------------------------------------------------------------------------------------------------------
--------------------------------------------------------------------------------------------------------------------------------------------------------------------------------------------------------
---------------------------------------------------------------------------------------------------------------------------------------------------------------------------------G------Tt--------------
----------------------------------------------------------------------------------------------------------------%%%%-------------- -------------G%%%%%%%%%---------------------%%%%%%%%%tt--------------
-------------K------------------%%%%------%%%%%-----------------------------------------------------------------||||----------K---%----K-------%%%%|||||||---%%%%%%%%%---------|||||||||tt-----------G--
--------S222CU------------------||||------|||||-------------------------------%%%--%%%--------------------------||||---%%%%%--%%%%|-%%%%%%%%%%%|||||||||||---|||||||||---------||||%%%%%%%%%%-------  UU
--------------------------------||||------|||||------------------%%%%----%%%%%|||--|||----------%%%%%------%%%%%||||---|||||--|||||-||||||||||||||||||||||---|||||||||%%%%%%%%%%%||||||||||||-----------
XXXXXXXXXXXXXXXXXXXXXXXXXXXXXXXX||||------|||||XXXXXXXXXXXXXXXXXX||||----||||||||--|||XXXXXXXXXX|||||------|||||XXXXXXX|||||--||||XXXXXXXXXXXXX||||XXXXXXXXXXXXXXXXXXX|||||||||||XX||||||||||XXXXX    XX