-------------------------------------------- -----------------------------------------------------------------------------------------------------------------------------------------------------------
--------------------------------------------------------------- ----------------------------------------------------------------------------------------------------------------------------------------
------------------------------------------------------------ ----------------------- -------------------------------------------------------------------------------------------------------------------
------------------------ ------- -----------------------------------------------------------------------------------------------------------------------------------------------------------------------
------------- -------------------------------------------------------------------------------------------------------------------------------------------------------- ---------------------------------
-------------------------- --------------------- ------------------- -------------------------------------------------------------------------------------------------------- --------------------------
----------------------------------------------------------------------------- ---------------------- - ---------------------------------------------- ------------------------------------------------- 
----------------------------------------------------------------------------------------------------------------------------------------------- ------------------------------------------------ -------
--------------------------------------------------------------- ------------ --------- ------------------------------------------------- -------------------- ------------------------------------------
---------------------------------------------------------------------------g-------g----------------------------------------U -- -----------------------------------------------------------------------
------------------------------------------------------------------------------------------------------------------------------------------------------g--g------- %%% %%%%%%%%----%%%%%%%%%-------------
----------------------------------------------------gkkggkgkkggg---------------------------------------% %%% %%%%% -------------ggggkggggggg --------------------|||||||||||||----| |||||||-------------
--------- ----------------------------------------r--||||||||| ----- ----------------------------- t---||||||||||||---------------||||||||------------% %%%%%%% %|||||||||||||----|||||||||-------------
----------------------- --gg---%%%% g-%%%%%%%% %%%%-- |||||||||-%% %%%% % -----%%%%% %------------tt---||||||||||||--- %%%%%%%  --||||||||--%  %%%%%% ||||||||||||||||||||||||----|||||||||-------------
-- ---% % %----- ------- ------|||||--|||||||||||||--||||||||||-||||||||||-----|||||||------------tt---||||||||||||---|||||||||| -||||||||--||||||||||||||||||||||||||||||||||-- -|||||||||%%%%% %%%%F %
 XX XX|||||XX XXXXXX X XX---- XX XXXXX||| ||||||||| XX XX XXXXX ||||||||||--- XXXX  XXXXX----XX XXXX XX||||||||||||---|||||||||| XXXXX XXXXX||||||||||||||||||||||||||| ||||||----|||||||||||||||||||X||