--------------------------------------------------------------------------------------------------------------------------------------------------------------------------------------------------------
--------------------------------------------------------------------------------------------------------------------------------------------------------------------------------------------------------
--------------------------------------------------------------------------------------------------------------------------------------------------------------------------------------------------------
--------------------------------------------------------------------------------------------------------------------------------------------------------------------------------------------------------
--------------------------------------------------------------------------------------------------------------------------------------------------------------------------------------------------------
--------------------------------------------------------------------------------------------------------------------------------------------------------------------------------------------------------
--------------------------------------------------------------------------------------------------------------------------------------------------------------------------------------------------------
------------Tt------------------------------------------------------------------------------------------------------------------------------------------------------------------------------------------
------------tt------------------------------------------------------------------------------------Tt----------------------------------------------------------------------------------------------------
------------tt------------------------------------------------------------------------------------tt----------------------------------------------------------------------------------------------------
------------tt-G----------------------------------------------------Tt----------------------------tt---------------------------K------------------------------------------------------------------------
---------%%%%%%%%%%-------------------------------KK----------------tt-------------UU2C----------Gtt----------------K--------%%%%- ---------------------------------------------------------------------
---------||||||||||-----------------------%%%%%%%%%%%%%%------%%%%%%%%%-K--------------------%%%%%%%%%%----------%%%%%%%%%%%-||||-%-------------------------------------------------------------%%   ---
---------||||||||||-----------------------||||||||||||||------||%%%%%%%%%%-------------------||||||||||----------|||||||||||-||||-|---------------------------K------K----------------------%%%-|||||---
---------||||||%%%%%----------------------||||||||||||||------||||||||||||-------------------||||||||||----------|||||||||||-||||-|-------------------------%%%----%%%%%%-------------------|||-|||||---
XXXXXXXXXXXXXXX|||||XXXXXXXXXXXXXXXXXXXXXX||||||||||||||XXXXXXXXXXXXXXXXXXXXXXXXXXXXXXXXXXXXX||||||||||XXXXXXXXXXXXXXXXXXXXXXXXXXXXXXXXXXXXXXXXXXXXXXXXXXXXX|||XXXX||||||XXXXXXXXXXXXXXXXXXXXXXX|||||---