--------------------------------------------------------------------------------------------------------------------------------------------------------------------------------------------------------
--------------------------------------------------------------------------------------------------------------------------------------------------------------------------------------------------------
--------------------------------------------------------------------------------------------------------------------------------------------------------------------------------------------------------
--------------------------------------------------------------------------------------------------------------------------------------------------------------------------------------------------------
--------------------------------------------------------------------------------------------------------------------------------------------------------------------------------------------------------
--------------------------------------------------------------------------------------------------------------------------------------------------------------------------------------------------------
--------------------------------------------------------------------------------------------------------------------------------------------------------------------------------------------------------
--------------------------------------------------------------------------------------------------------------------------------------------------------------------------------------------------------
--------------------------------------------------------------------------------------------------------------------------------------------------------------------------------------------------------
--------------------------------------------------------------------------------------------------------------------------------------------------------------------------------------------------------
--------------------------------------------------------GG-------------------------------------------------------------------------------------------------------------------------------------------F--
--------------------------------------------------------%%%%-----------------------------------------K------------------%%%-------F--------------SUCS-------2C2US----------------Tt----------------K- --
--------------------------------------------------------|||KK--------------------------------%%%----%%%%%-------%%%%%---|||-------%----------------%%%%%%%%%%--------------------tt------%%%------%%%%--
----------------------------------%%%%%%%%%%------------||%%%%%%--------------CUS2US2--------|||----|||||-------|||||---|%%%%%%%%%%---G------------||||||||||--------%%%%%-------tt------|||------||||--
----------------------------------||||||||||------------||||||||-----------------------------|||----|||||-------|||||---|||||||||||--%%%%--%%%%%---||||||||||--------|||||----%%%%%%%%---|||------||||--
XXXXXXXXXXXXXXXXXXXXXXXXXXXXXXXXXX||||||||||XXXXXXXXXXXXXXXXXXXXXXXXXXXXXXXXXXXXXXXXXXXXXXXXX|||----|||||XXXXXXXXXXXXXXXX||||||||||XX||||--|||||XXXXXXXXXXXXXXXXXXXXXXXXXXXXXX||||||||XXX|||------||||XX