------------------ --------------------- ---------------------------------------------------------- ----------- ------------------------------------------------------ -- ------------------------------
----------------------------------------------------------------------- --------------------------------------------------------------------------------------------------------------------------------
--------------------------------------------------------------------------------------------------------------- - --------------- -- ---------------------------------------------- --------------------
---------------------------------------- ----------- ---------------------------------------------------------------------------------------------------------------------------------------------------
--------------------------- ----------------------------------------------------------------------------------------------------------------------------------------- -------------- -------------------
----------------------------------------------------------------------------------------------------------- ---------------------------------------------------------------- ---------------------------
------------------------------------- --------------- ----------------- -------- ------------------------------------------------------------------ --------------------------------------------- ------
---------------------------------------------------------------- ----------------------- ----- ---------------------------------------------------------------------------------------------------------
--------------------------------------------------------------------------------------------------------g--- ---------------gg---g----------------------------------------------------------------------
------------- -------------------------------------- -----------------------------------g-------------- -------------------------------------- -------- ------------------------------------------------
-----------------------------------------g---------------U---------------------------------------tt----%%%%%%%%%%%%%%%%%%%%-------------------------------------- --------------------------------------
-------------------------------------------------------------kkgggggkggggkg----------------------tt----||||||||||||||||||||-----------------------------------------------------S2S2SSS-----------------
-- --- ----------- ----------------------------------------- --%%%%%%%%%%------------------------tt----||||||||||| ||||||||-----%%%%%%%%-----------%%%%%%%%%%%%%------%%%%%%----------------------------
--------------------------g----g---g-g-------------------------||||||||||--%%%%%%%% %%% ---%%%%%%%%% %%||||||||||||||||||||-----||||||||----gg---- |  ||||||||||------||||||---r----r---k-- ------------
------%% %%------------------------------------------%%%%%%%%--||||||||||--|||||||||| |----||||||||||||||||||||||||||||||||-----||||||||-- -------- | ||||||||||------||||||----------------------------
 X    |||||X  XXXX XXXXXX--- XX XX    X   --XXX X XXX||||||||     X XX X X ||||||||||||----||||||||||||||||||||||||||||||||-----||||||||---X X X XX|| ||||||||||----XXX  X  XX  XX X     X X X XX X XF X