--------------------------------------------------------------------------------------------------------------------------------------------------------------------------------------------------------
--------------------------------------------------------------------------------------------------------------------------------------------------------------------------------------------------------
--------------------------------------------------------------------------------------------------------------------------------------------------------------------------------------------------------
--------------------------------------------------------------------------------------------------------------------------------------------------------------------------------------------------------
--------------------------------------------------------------------------------------------------------------------------------------------------------------------------------------------------------
--------------------------------------------------------------------------------------------------------------------------------------------------------------------------------------------------------
--------------------------------------------------------------------------------------------------------------------------------------------------------------------------------------------------------
--------------------------------------------------------------------------------------------------------------------------------------------------------------------------------------------------------
--------------------------------------------------------------------------------------------------------------------------------------------------------------------------------------------------------
--------------------------------------------------------------------------------------------------------------------------------------------------------------------------------------------------------
-------------------------------------------------------------------------------------------------------------------------------------KK-----------------------------------------------------------------
-------------------------------------------------------------------------------K--------------------Tt-------K-G------------------ CS2SSU---------------------------------------------K-----------------
-------------------------------------------------------------------------%%%%--%%%------------------tt-------%%%%--%%%%%---%%%%%--%--------------------------------------%%%%%%%%---%%%%%%%%------------
----------------------%%%%%%%%%%----------------------------------K------||||--|||------------------tt-------||||--|||||---|||||%%%---S%%%%%%%%%-------------------------||||||||---||||||||--CSS2  ----
----------------------||||||||||------%%%-----%%%-------%%%%----%%%%-----||||--|||---------------%%%%%%%%%%--||||--|||||---||||||||----|||||||||---%%%%------%%%---------||||||||---||||||||------------
XXXXXXXXXXXXXXXXXXXXXX||||||||||XXXXXX|||-----|||XXXXXXX||||----||||XXXXX||||--|||XXXXXXXXXXXXXXX||||||||||XX||||--|||||XXXXXXXXXXXXXXXXXXXXXXXXXXX||||------|||XXXXXXXXX||||||||XXXXXXXXXXXXXXXXX    XX