--------------------------------------------------------------------------------------------------------------------------------------------------------------------------------------------------------
--------------------------------------------------------------------------------------------------------------------------------------------------------------------------------------------------------
--------------------------------------------------------------------------------------------------------------------------------------------------------------------------------------------------------
--------------------------------------------------------------------------------------------------------------------------------------------------------------------------------------------------------
--------------------------------------------------------------------------------------------------------------------------------------------------------------------------------------------------------
--------------------------------------------------------------------------------------------------------------------------------------------------------------------------------------------------------
--------------------------------------------------------------------------------------------------------------------------------------------------------------------------------------------------------
--------------------------------------------------------------------------------------------------------------------------------------------------------------------------------------------------------
--------------------------------------------------------------------------------------------------------------------------------------------------------------------------------------------------------
--------------------------------------Tt---------------------------------------------------------Tt-----------------------------------------------------------------------------------------------------
---------------TtG--------------------tt-------------------------G-------------------------------tt-----------------------------------------------------------------------G-----------------------------
---------------tt%%%%-----------------tt------------------------US-------------------------------tt-G-G--------------------------- ------------------------------------2CUCUCU--------------------------
---------------tt|K||---------%%%%%%--tt---------%%%%%-----%%%%%--------G---G-G-----------G---%%%%%%%%%---------------------------%----------------------------------------------------------------   %%
-----------%%%%%%%%%%%--------||||||%%%%%%%------|||||-----|||||----%%%%%%%%%%%---%%%%%%%%%%--|||||||||---------------------------|----------------------------------------------------------------|||||
-----------|||||||||||--------|||||||||||||------|||||-----|||||----|||||||||||---||||||||||--|||||||||----------------------%%%%%%%%%-------------------------------------------------------------|||||
XXXXXXXXXXX|||||||||||XXXXXXXX||||||XXXXXXXXXXXXX|||||-----|||||XXXX|||||||||||XXX||||||||||XX|||||||||XXXXXXXXXXXXXXXXXXXXXX|||||||||XXXXXXXXXXXXXXXXXXXXXXXXXXXXXXXXXXXXXXXXXXXXXXXXXXXXXXXXXXXX    XX