--------------------------------------------------------------------------------------------------------------------------------------------------------------------------------------------------------
--------------------------------------------------------------------------------------------------------------------------------------------------------------------------------------------------------
--------------------------------------------------------------------------------------------------------------------------------------------------------------------------------------------------------
--------------------------------------------------------------------------------------------------------------------------------------------------------------------------------------------------------
--------------------------------------------------------------------------------------------------------------------------------------------------------------------------------------------------------
--------------------------------------------------------------------------------------------------------------------------------------------------------------------------------------------------------
--------------------------------------------------------------------------------------------------------------------------------------------------------------------------------------------------------
--------------------------------------------------------------------------------------------------------------------------------------------------------------------------------------------------------
--------------------------------------------------------------------------------------------------------------------------------------------------------------------------------------------------------
--------------------------------------------------------------------------------------------------------------------------------------------------------------------------------------------------------
----------------------------------------------------------------------------------K--------------------------------------------------------------------Tt-----------------------------------------------
--------------------------------------------------------------------------------%%%%%%%%%%-------------------------------------K-- --------------------tt--%%%%-%%%%-%%%%-------------------------------
----------------------------------------%%%%%-----%%%---------------------------||||||||%%%%%%%%%%-------G-------------------2UC--%--------------------tt--|%%%%%%%%%%|||------G------------------------
-----------------------------%%%%%------|||||-----|||---------------------------||||||||||||||||||------%%%%%%%%%-----------------%%%%---%%%%----------tt-K|||||||||||SS%%%%%%%%%%-------------UUU  ---%
---------%%%%------%%%%%-----|||||------|||||-----|||---------------------------||||||||||||||||||------|||||||||%%%----%%%%%-----||||---||||-------%%%%%%%%%%||||||||||||||||||||---------------------|
XXXXXXXXX||||------|||||XXXXX|||||XXXXXX|||||-----|||XXXXXXXXXXXXXXXXXXXXXXXXXXXXXXXXXXX||||||||||XXXXXX||||||||||||----|||||XXXXX||||---||||XXXXXXX||||||||||XXXXXXXXXX||||||||||XXXXXXXXXXXXXXXX    X|