--------------------------------------------------------------------------------------------------------------------------------------------------------------------------------------------------------
--------------------------------------------------------------------------------------------------------------------------------------------------------------------------------------------------------
--------------------------------------------------------------------------------------------------------------------------------------------------------------------------------------------------------
--------------------------------------------------------------------------------------------------------------------------------------------------------------------------------------------------------
--------------------------------------------------------------------------------------------------------------------------------------------------------------------------------------------------------
--------------------------------------------------------------------------------------------------------------------------------------------------------------------------------------------------------
--------------------------------------------------------------------------------------------------------------------------------------------------------------------------------------------------------
--------------------------------------------------------------------------------------------------------------------------------------------------------------------------------------------------------
-------------------------------------------------------------------------------------------------------------------------------------------------------------------------------------k--r-----k---------
--------------------------------------------------------------------------------------------------------------------------------------------------------------------------------------------------------
------------------------------------------------------------------------------------------------------------------------------------------------------------------------------------%%%%%%%%%%%%%%    %%
-------------------------------%%%%%%-----------------------------------------------------CSCCUC22--------------------------------------------------ggggggggkkr---------------------||||||||||||||||| ||
-------------------------------||||||--------------g--g----------g--------------%%%%%%----------------------------------------------------------------------------------%%%%%%%%%%%%||||||||||||||||||||
-------------------------------||||||-------------------------------------------||||||----------------------------g----gg---------g---------------r------------%%%%%%%%%||||||||||||||||||||||||||||||||
------%%%%%--------------------||||||--------------%%%%%%%%%%---%%%%%%%%%%%%%%--||||||---------------------------------------------------%%%%%%%%%%------------|||||||||||||||||||||||||||||||||||||||||
XXXXXX|||||XXXXXXXXXXXXXX----XXXXXXXXXX-----XXX----||||||||||---||||||||||||||XXXXXXXXXXXXXXXXXXXXXXXXXXXXXXXXXXX---XXXXXXXXXXXXXXXXXXXXX||||||||||XXXXXXXXXXXX|||||||||||||||||||||||||||||||||||||||||