--------------------------------------------------------------------------------------------------------------------------------------------------------------------------------------------------------
--------------------------------------------------------------------------------------------------------------------------------------------------------------------------------------------------------
--------------------------------------------------------------------------------------------------------------------------------------------------------------------------------------------------------
--------------------------------------------------------------------------------------------------------------------------------------------------------------------------------------------------------
--------------------------------------------------------------------------------------------------------------------------------------------------------------------------------------------------------
--------------------------------------------------------------------------------------------------------------------------------------------------------------------------------------------------------
--------------------------------------------------------------------------------------------------------------------------------------------------------------------------------------------------------
--------------------------------------------------------------------------------------------------------------------------------------------------------------------------------------------------------
------------------------------------------------------------------------------------------------S-CSSS2-------------------------------------------------------------------------------------------------
--------------------------------------------------------------------------------------------------------------------------------------------------------------------------------------------------------
-------------------------------------------------------------------------------#--#--------------%----------#---#---------------------------------------------------------------------------------------
----------------#--#----------------------------------------------------------##--##-----#--#----|r--------##---##--------------------------------------------------------------------------------------
---------------##--##------------------%%%-------------------%%%%%%%---------###--###--%%%--%%%%%%%%%%%%--###---###-------------------------------------------------------------------------------------
-------------%%%%--%%%%----------------|||-------%%---%%%%%%%|||||||-----k-%%%%%--%%%%%|||--||||||||||||%%%%%---%%%%%%%%%--%%%%----------------%%%%%%%% %%%%%%%%%%%%%%%%%%%%%%%%%%%%%%%%%%%%%%%%%%    %%
-------------||||--||||%%%---%%%--k-G--|||-----r-||---||||||||||||||%%%%%%%|||||--||||||||--|||||||||||||||||---|||||||||--||||---------#---#--||||||||%||||||||||||||||||||||||||||||||||||||||||||||||
XXXXXXXXXXXXX||||--|||||||---|||XXXXXXXXXXXXXXXXX||---||||||||||||||||||||||||||--||||||||--|||||||||||||||||---|||||||||--||||XX---XXXXX---XXX|||||||||||||||||||||||||||||||||||||||||||||||||||||||||