---------------------- ------------------------------------------------------------------------------------------------------------------- ------------------- - ---------------------------------------
-------------------------------------------------------------------------------------------------------------------------------------------------------------------------------------------------- -----
----------------------------------------------------------------------------- --------------------------------------------------------------------------------------------------------------------------
- ------------------ ---------------------------------------------------------------------------------------------------------------------------------------------------- ------------------------------
---------------------------------------------------------------------------------------------------------------------------------------- ---------------------------------------------------------------
-------------------------------------------------------------------------------------------------------------- ------------------------------------ ----------------------------------------------------
----------------------------------- ---------------------------------------------------- ---------------------------------------------------------- ----------------- --------------------------------- 
--------------------------------------------------------------------------------------------------------------------------------------------------- ----------------------------------------------------
----- ---------------------------------------------------------------------- ------------------------------------------------------------------- -- ----------------------------------------------------
------------------------------------------------------------------------------------------------------------------------------Tt------------------- ------------------ ---------------------------------
------------------------------------------------------------------------------------------------------------------------------tt- -------- G------- ----------------------------------------------------
-------------------------------------------------------------------------------------------------- ----------------G----------tt--F--------%%%%---- --------------------------------- ------------------
--------K---------------------------------------------------------%%%%%----G-----------G----------G-------------- %%%%--------tt- %--------||||---- -------------- -------- U2----------------K---------
------%   %----%% %-----------------------------------------------%%%%%% % %---------%%% %------%%%%%------------|||||----%% %%%% %%-------%%||--- ----------- % %----- %%% ----G-- ----KG-%% %------%%%
-- ---|||||----||||--%%%%----%%%  -----------------%%%%------%%% %||||||||||%%   ----|||||------|||||------------|||||----||||||||||------- |||---------------||||-----|||||--%%%-----% %%-||||------|||
 XXXXX|||||----||||XX||||----|||||XXXXXXXXXXXXXXXXX||||------|||||XXXXXXXXXX|||||XXXX|||||------|||||XXXXXXXXXXXX|||||XXXXXXXXXXXXXXXXXXXXXXXXXXXXXXXXXXXXXXXX||||-----|||||XX|||-----||||X||||------|||