--------------------------------------------------------------------------------------------------------------------------------------------------------------------------------------------------------
-------------------- ------------------- ------------------------------------------- -------------------------------------------------------------------------------------------------------------------
----------------------------------------------------------------------- ------- ------------------------------------------------------------------------------------------------------------------------
------------------------------------------------- ------------------------------ -----------------------------------------------------------------------------------------------------------------------
--------------------------------------------------------------------------------------------------------------------------------------------------------------------------------------------------------
----------------------------------------------------------------------- ------------- -------------------------------------------------------- ---------------------------------------------------------
-------------------------------------------------- ---------------------- -------------------------------------------------------- ---------------------------------------------------------------------
- ----------------- ------------------------------------------------------------------------------------------------------------- ------------------------------------------------------ ---------------
----------------- ---------------------------------------------------------------------------------------------------------------------------------------------------------------------- ---------------
----------------------------------------------------------------------------------------------------------------------------------------------------------------------------------Tt--------------------
------------------------------------------------------------------------------ ------------ --------------------------------------------------------------------------------------tt----------------Tt--
------------%%%%%%%%%%----------------------------CS-----------GK-----K---------------------KK---------------------------------F-- ------------------------------------------ -%%%Tt----------------tt--
------------||||||||||-------------------------------------- -%%%%---%%%-G--------C2CS2--%%%%%--------------------------------- %%%%%%%%----G------ -----%%%--K----G--------- -|||tt----------------tt-K
------------||||||||||----------- ----------------------------||||---|||U2C2-------------|||||------%%%------------------------|||||||||---%%%-----------||%%%% %%%%--SSC------%%%%%%%%%%--------%%%%%%%
------------||||||||||-- ---%%%%-----%%%-----%%%%%%-----------||||---|||-----------------|||||------|||---------- -------------|||||||||---|||------ ----|||||||||||-----------||| ||||||--------|||||||
 XXXXXXXXXXXXXXXXXXXXXXXXX X|||| ----|||XXXXX||||||XXXXXXXXXXX||||---|||XXXXXXXXXXXXXXXXXXXXXXXXXXXXXXXXXXXXXXXXXXXXXXXXXXXXXXX|||||||||XXX|||X XXXXXXXXXXX||||||||        XXXXXXXXXXXXXXXXXXXXXX|||||||