--------------------------------------------------------------------------------------------------------------------------------------------------------------------------------------------------------
--------------------------------------------------------------------------------------------------------------------------------------------------------------------------------------------------------
--------------------------------------------------------------------------------------------------------------------------------------------------------------------------------------------------------
--------------------------------------------------------------------------------------------------------------------------------------------------------------------------------------------------------
--------------------------------------------------------------------------------------------------------------------------------------------------------------------------------------------------------
--------------------------------------------------------------------------------------------------------------------------------------------------------------------------------------------------------
--------------------------------------------------------------------------------------------------------------------------------------------------------------------------------------------------------
------------------------------------------------------------------------------------------------------%% %%%--------------------------------------------------------------------------------------------
------------------------------------------------------------------------------------------------------||||||----g------g--------------------------------------------------------------------------------
---------------------------------------------------------------------------------CCUCSS--%% %%%%%-----||||||--------------------------------------------------------------------------------------------
-----------------------------------------------------------------------------------------||||||||-----||||||---%%%% %%% %%% ------------------%%%% ---------%%%%% -----%%%%%%%%----% %%%%%%%%%%%%%%%%F  
----------------------------------ggkkggkg--------------------------------2  SSS---------||||||||---%%%%%% %%%%|||||||||||||------------------|||||---------||||||-----||||||||----|||||||||||||||||| ||
--------------------------------r--||||||------------------------------------------------||||||||---||||||||||||||||||||||||----kr------r---%%%%%%%% -----% %%%%%%%%%--||||||||----|||||||||||||||||||||
------------------------- %%%%%%%--||||||-%    %%%% ----%%%% % %%%%----------------------||||||||---||||||||||||||||||||||||----------------|||||||||-----|||||||||||--||||||||----|||||||||||||||||||||
------%%%%%--------------||||||||--||||||-||||||||||----|||||||||||----------------------||||||||---||||||||||||||||||||||||---%    %% %%%% |||||||||-----|||||||||||%%%%%%%%%%%%%%|||||||||||||||||||||
 X  XX|||||XXXXXXXXX XXXX||||||||X XXXXXXX||||||||||----|||||||||||XXXXXX X XXX XXXXXXXXX||||||||---||||||||||||||||||||||||---||||||||||||||||||||||-----||||||||||||||||||||||||||||||||||||||||||||||