--------------------------------------------------------------------------------------------------------------------------------------------------------------------------------------------------------
--------------------------------------------------------------------------------------------------------------------------------------------------------------------------------------------------------
--------------------------------------------------------------------------------------------------------------------------------------------------------------------------------------------------------
--------------------------------------------------------------------------------------------------------------------------------------------------------------------------------------------------------
--------------------------------------------------------------------------------------------------------------------------------------------------------------------------------------------------------
--------------------------------------------------------------------------------------------------------------------------------------------------------------------------------------------------------
--------------------------------------------------------------------------------------------------------------------------------------------------------------------------------------------------------
--------------------------------------------------------------------------------------------------------------------------------------------------------------------------------------------------------
--------------------------------------------------------------------------------------------------------------------------------------------------------------------------Tt----------------------------
--------------------------------------------------------------------------------------------------------------------------------------------------------------------------tt----------------------------
-----------------------Tt-------------------------------------------------------------------------Tt----------------------------------------------------Tt----------------tt-------------G--------------
-----------------------tt-------------------------------------------------------------------------tt------------------------------F---------------------tt----K-----------tt-------2C2CUSS-------------K
-----------------------tt%G%%%%%%%-%-------------------------------------G------------------------tt---K--------------------------%---------------------tt--G%%%%------%%%%%%%%%--%%%%%--------------%%%
------------------%%%%%%%%%%|||%%%%%%%%------------------------%%%%------%%%-------G--K--------%%%%%%%%%%-------------------------|------------------%%%%%%%%%%||------|||||||||K-|||||--------------F||
------------------|||||||||||||||||||||------------------------||||------|||--%%%--%%%%--------||||||||||-------------------------|------------------||||||||||||--%%%-||||||||%%%%%%||-------------- ||
XXXXXXXXXXXXXXXXXXXXXXXXXXXXXXX||||||||XXXXXXXXXXXXXXXXXXXXXXXX||||------|||XX|||--||||XXXXXXXX||||||||||XXXXXXXXXXXXXXXXXXXXXXXXXXXXXXXXXXXXXXXXXXXXXXXXXXXXXXXXXX|||XXXXXXXXX||||||XXXXXXXXXXXXXXXXXXX