--------------------------------------------------------------------------------------------------------------------------------------------------------------------------------------------------------
--------------------------------------------------------------------------------------------------------------------------------------------------------------------------------------------------------
--------------------------------------------------------------------------------------------------------------------------------------------------------------------------------------------------------
--------------------------------------------------------------------------------------------------------------------------------------------------------------------------------------------------------
--------------------------------------------------------------------------------------------------------------------------------------------------------------------------------------------------------
------------------------------------------------------------------------------------------------------------------------------------------------2SCC----------------------------------------------------
-----------------------------------------------------------------------------------------------------------------------------------------------ggkgkgg--------------------USC---------------------------
---------------------------------------------------------------------------------------------------------------------------------------------r----------------------------------------------------------
---------------------------------------------------------------------------------------------------------------------------------%%%%%%%%%%%%%--------%%%%%%%%%---------g-----g-g-----------------------
--------------------------------------------------------------------------------SSSC---------------------------------------------|||||||||||||--------|||||||||-----------------------------------------
---------------------------------------------------------------------------------------------------------------------------------|||||||||||||%%%%%%%%|||||||||%%%%%%%%%%%%%%%%---%%%%%%%%%%%-----------
----------------------------------------------------------------------------------------------------kggkggggkgg----------%%%%%%%%||||||||||||||||||||||||||||||||||||||||||||||---|||||||||||-----------
---------------------------------------------%%%%%-----------------------------------------------------------------------||||||||||||||||||||||||||||||||||||||||||||||||||||||---|||||||||||-----------
------------------------------g--------------|||||--------g-----------g-------%%%%%%%%------------r------------%%%%%%%%%%||||||||||||||||||||||||||||||||||||||||||||||||||||||---|||||||||||-----------
------%%%%%----------------------------------|||||----------------------------||||||||----%%%%%%%%%------------||||||||||||||||||||||||||||||||||||||||||||||||||||||||||||||||---|||||||||||%%%%%    %%
XXXXXX|||||XXXXXXXXXXXXXX----XXXXXXXXXXX---XXXXXXXXX-----XXXXXXXXXXXXXX-----XXXXXXXXXXXXXX|||||||||XXXXXXXXXXXX||||||||||||||||||||||||||||||||||||||||||||||||||||||||||||||||---||||||||||||||||||| ||