--------------------------------------------------------------------------------------------------------------------------------------------------------------------------------------------------------
--------------------------------------------------------------------------------------------------------------------------------------------------------------------------------------------------------
--------------------------------------------------------------------------------------------------------------------------------------------------------------------------------------------------------
--------------------------------------------------------------------------------------------------------------------------------------------------------------------------------------------------------
--------------------------------------------------------------------------------------------------------------------------------------------------------------------------------------------------------
--------------------------------------------------------------------------------------------------------------------------------------------------------------------------------------------------------
--------------------------------------------------------------------------------------------------------------------------------------------------------------------------------------------------------
--------------------------------------------------------------------------------------------------------------------------------------------------------------------------------------------------------
--------------------------------------------------------------------------------------------------------------------------------------------------------------------------------------------------------
--------------------------------------------------------------------------------------------------------------------------------------------------------------------------------------------------------
-------------------------------------------------------------------------------------------------------------Tt-------------------------------------------------------------------------------------  --
----------G--------------------------------%%Tt%%------------------------------------------------------------tt------------------- --------------------------------G----KG--------------------------  --
--------%%%%%------------------------------%%tt%%%%%%-------------K------------------------------------------tt-------------------%---------K-------------------%%%%%%%%%%%%-----------------------G  --
--------|||||------------------------------||tt||||||----%%%%%%%%%%--------------------------------------%%%%tt%%%%---------------|%%%%%22USS2S-----------------||||||||||||---------------------%    %%
--------|||||----------------%%%%%%%%%%-%%%%%%%%%%%%|----||||||||||--------%%%--%%%%----------%%%%%%%%%%-%%%%%%%%%%%--------------||||||------------------------|%%%%||||%%%-%%%%------%%%%%-----|||||||
XXXXXXXXXXXXXXXXXXXXXXXXXXXXX||||||||||X||||||||||||XXXXX||||||||||XXXXXXXX|||--||||XXXXXXXXXX||||||||||X|||||||||||XXXXXXXXXXXXXXX|||||XXXXXXXXXXXXXXXXXXXXXXXXX|||||||||||X||||------|||||XXXXX|||||||