--------------------------------------------------------------------------------------------------------------------------------------------------------------------------------------------------------
--------------------------------------------------------------------------------------------------------------------------------------------------------------------------------------------------------
--------------------------------------------------------------------------------------------------------------------------------------------------------------------------------------------------------
--------------------------------------------------------------------------------------------------------------------------------------------------------------------------------------------------------
--------------------------------------------------------------------------------------------------------------------------------------------------------------------------------------------------------
--------------------------------------------------------------------------------------------------------------------------------------------------------------------------------------------------------
--------------------------------------------------------------------------------------------------------------------------------------------------------------------------------------------------------
--------------------------------------------------------------------------------------------------------------------------------------------------------------------------------------------------------
--------------------------------------------------------------------------------------------------------------------------------------------------------------------------------------------------------
---------------------------------------------------------------------------------------------------------------------------------------------------------------------------Tt---------------------------
---------------------------------------------------------------------------------------------------------------------------------------------------------------------------tt---------------------------
----------------------------------------------------------------------------------------------------------------------------------F----------------------------------------tt---------------------------
-------------G-------------------------------------------%%%-----%%%%-------------------------------------------------------------%-------------------------------------%%%%%%%%%%---UU-----------------
-------%%%%%%%%------------------------------------------|||-----||||-------------------------------------------------------------|----------------------------%%%%%%---||||||||||---------------K----F-
-------||||||||--------------------------------%%%--%%%%-|||-----||||---------------------------------------------------%%%%%---%%%-------------%%%%-----%%%%--||||||---||||||||||------%%%%%%%%%%---- -
XXXXXXX||||||||XXXXXXXXXXXXXXXXXXXXXXXXXXXXXXXX|||--||||X|||-----||||XXXXXXXXXXXXXXXXXXXXXXXXXXXXXXXXXXXXXXXXXXXXXXXXXXX|||||---|||XXXXXXXXXXXXX||||-----||||XX||||||XXXXXXXXXXXXXXXXXXX||||||||||XXXXXX