--------------------------------------------------------------------------------------------------------------------------------------------------------------------------------------------------------
--------------------------------------------------------------------------------------------------------------------------------------------------------------------------------------------------------
--------------------------------------------------------------------------------------------------------------------------------------------------------------------------------------------------------
--------------------------------------------------------------------------------------------------------------------------------------------------------------------------------------------------------
--------------------------------------------------------------------------------------------------------------------------------------------------------------------------------------------------------
--------------------------------------------------------------------------------------------------------------------------------------------------------------------------------------------------------
--------------------------------------------------------------------------------------------------------------------------------------------------------------------------------------------------------
--------------------------------------------------------------------------------------SS----------------------------------------------------------------------------------------------------------------
----------------------------------------------------------------------------------------------------------------------------gg--------------------------------------------------------------------------
--------------------------------------------------------------------------------------------------------------------------------------------------------SSSUCC22S--%%%%%%%%%%------------S2U22S---------
---------------------------------U---------------------------------%%%%%%%%----------------------------------------------------------------------------------------||||||||||%%%%%%%%%%-----------------
-------------------------------------kkkkkgkggkgggg----------------||||||||----------%%%%%---------------ggggggg---------------------------------USSSSC------------||||||||||||||||||||----------%    %%
---------------------------------------%%%%%%%%%%------------------||||||||----------|||||----------------%%%%%----------------------------------------------------||||||||||||||||||||----------|||| ||
--------------------------g------------||||||||||--%%%%%%%%%-----%%%%%%%%%%%%%%------|||||-------------g--|||||-%%%%%%%%%%%---%%%%%%%%%%%%%%-----------------------||||||||||||||||||||%%%%%%%%%%|||||||
------%%%%%-----------------%%%%%%%%%--||||||||||--|||||||||-----||||||||||||||------|||||--%%%%%%%%%%%%--|||||-|||||||||||---||||||||||||||-----------------------|||||||||||||||||||||||||||||||||||||
XXXXXX|||||XXXXXXXXXXXXXX---|||||||||XXXXXXXXXXXXXX|||||||||-----||||||||||||||----XXXXXXXXX||||||||||||XXXXXXXX|||||||||||---||||||||||||||XXXXXXXXXXXXXXXXXXXXXXX|||||||||||||||||||||||||||||||||||||