--------------------------------------------------------------------------------------------------------------------------------------------------------------------------------------------------------
--------------------------------------------------------------------------------------------------------------------------------------------------------------------------------------------------------
--------------------------------------------------------------------------------------------------------------------------------------------------------------------------------------------------------
--------------------------------------------------------------------------------------------------------------------------------------------------------------------------------------------------------
--------------------------------------------------------------------------------------------------------------------------------------------------------------------------------------------------------
--------------------------------------------------------------------------------------------------------------------------------------------------------------------------------------------------------
--------------------------------------------------------------------------------------------------------------------------------------------------------------------------------------------------------
--------------------------------------------------------------------------------------------------------------------------------------------------------------------------------------------------------
--------------------------------------------------------------------------------------------------------------------------------------------------------Tt----------------------------------------------
-------------------------------------------------------------------------------------------------------------------------------------------T -----------tt----------------------------------------------
--------------------------------------------------------------------------------------------------------------------Tt---------------------tt--------G--tt----------------------------------------------
--------------------------------------------------------------------------------------K---------%%% %%%%%%%%-G------t ------------F-------- t------%%%%% %%%%%----------------------------------------SU
------%%%%%--------------------------G-------%%%%%%%%%----------G------------ % %%----%%%-------|||||||||||| C22----tt------------ -------- t------|||||||||||------ %%%------%%%---222C2C--------------
------|||||%%%%----% %%%------------U C  SS--|||||||||-%%%%----- % %---------|||||----|||---%% -||||||||||||-------Ktt--K---------|-----%%%%%%%%%%-|||||||| C SSS---||||------|||---------S----G--------
------|||||||||----|||||---------------------|||||||||-||||-----||||---------|||||----|||---|||-||||||||||||-----%%%%%%%%%--------|-----||||||||||-|||||||||||------||||------|||----------%%%%%---%%%--
 XXXXXXXXXX||||----|||||X XXXXXXXXXXXXXXXXXXX|||||||||X||||-----||||XXXXXXXXX|||||----|||XXXXXX XXXXXXXXXXXXXXX X|||||||||XXX XXXXXXX XXXXXXXXXXXX X XXXXXXXXXXXXXXX||||------|||X X XXXXXX|||||---|||XX