--------------------------------------------------------------------------------------------------------------------------------------------------------------------------------------------------------
--------------------------------------------------------------------------------------------------------------------------------------------------------------------------------------------------------
--------------------------------------------------------------------------------------------------------------------------------------------------------------------------------------------------------
--------------------------------------------------------------------------------------------------------------------------------------------------------------------------------------------------------
--------------------------------------------------------------------------------------------------------------------------------------------------------------------------------------------------------
--------------------------------------------------------------------------------------------------------------------------------------------------------------------------------------------------------
--------------------------------------------------------------------------------------------------------------------------------------------------------------------------------------------------------
--------------------------------------------------------------------------------------------------------------------------------------------------------------------------------------------------------
--------------------------------------------------------------------------------------------------------------------------------------------------------------------------------------------------------
----------------------------------------------------------------------------Tt----------------------------------------------------------------------------------------------------------Tt--------------
----------------------------------------------------------------------------tt-------------------------------------------------------------------------------------------Tt-------------tt--------------
----------------------------------------------------------------------------tt----------------------------------------------------F--------------------%-%%%%%%%%%%------tt-----------G-tt-------------%
-----------------------USCCC2-----------------------------------------CS----tt-------%%%%--%%%------------------------------------%----------------%%%%%%%%%%%|||||------tt----------%%%%%%%%%%--------|
--------%%%%%%%%%----------------------%%%%--%%%%-----%%%%%%------------%%%%%%%%%%%--||||--|||---------------U2CU2---------%%%%%--|-%%%%%----------||||||||||||||||------tt-%%%%-----||||||||||-F------|
--------|||||||||----------------------||||--||||-----||||||------------|||||||||||--||||--|||-----------------------------|||||--|-|||||----------||||||||||||||||-%%%%%%%%%%%%-----||||||||||- ------|
XXXXXXXXXXXXXXXXXXXXXXXXXXXXXXXXXXXXXXX||||--||||XXXXXXXXXXXXXXXXXXXXXXX|||||||||||XX||||--|||XXXXXXXXXXXXXXXXXXXXXXXXXXXXX|||||--|-|||||XXXXXXXXXX|||||||||||XXXXXX||||||||||||XXXXX||||||||||XXXXXXXXX