--------------------------------------------------------------------------------------------------------------------------------------------------------------------------------------------------------
--------------------------------------------------------------------------------------------------------------------------------------------------------------------------------------------------------
--------------------------------------------------------------------------------------------------------------------------------------------------------------------------------------------------------
--------------------------------------------------------------------------------------------------------------------------------------------------------------------------------------------------------
--------------------------------------------------------------------------------------------------------------------------------------------------------------------------------------------------------
--------------------------------------------------------------------------------------------------------------------------------------------------------------------------------------------------------
--------------------------------------------------------------------------------------------------------------------------------------------------------------------------------------------------------
--------------------------------------------------------------------------------------------------------------------------------------------------------------------------------------------------------
---------------------------------------------------------------------------------------------------------------------------------------------------------------------g----------------------------------
--------------------------------------------------------------------------------------------------------------------------------------------------------------------------------------------------------
-----------------------------------U--------------------------------------------------------------------------------------------------------------------------------------------------------------------
---------------------------------------gkgkggkkgkkgg--------------------------------%%%%%%%---------------------------------------ggggggg-------------%%%%%%%%%%%%%%------------------%%%%%%%-----------
-----------------------------------------%%%%%%%%%----------------------------------|||||||---------------g----------g----------r--|||||--------------||||||||||||||------------------|||||||-----------
-----------------------------------------|||||||||--%%%%%%%%%%------g--------------%%%|||||---------------------------%%%%%%%%%%%--|||||-%%%%%%%%%%%%%||||||||||||||------------------|||||||-----------
------%%%%%--------------%%%%%%%%%%%%%%--|||||||||--||||||||||---------------------||||||||---------------%%%%%%%%%%%%|||||||||||--|||||-|||||||||||||||||||||||||||-----%%%%%%%%%%%%%%%%%%%%%%%%-------
XXXXXX|||||XXXXXXXXXXXXXX||||||||||||||XXXXXXXXXXXXX||||||||||-----XXXXXXXXXXXX---XXXXXXXXXXXX-----XXX----|||||||||||||||||||||||XXXXXXXX|||||||||||||||||||||||||||-----||||||||||||||||||||||||X    XX