-------------------------------------------------------------------------------------------------------------------------------        -----------------------------------------------------------------
-------------------------------------------------------------------------------------------------------------------------------        -----------------------------------------------------------------
-------------------------------------------------------------------------------------------------------------------------------        -----------------------------------------------------------------
-------------------------------------------------------------------------------------------------------------------------------        -----------------------------------------------------------------
-------------------------------------------------------------------------------------------------------------------------------        -----------------------------------------------------------------
-------------------------------------------------------------------------------------------------------------------------------        -----------------------------------------------------------------
-------------------------------------------------------------------------------------------------------------------------------        -----------------------------------------------------------------
-------------------------------------------------------------------------------------------------------------------------------        -----------------------------------------------------------------
-------------------------------------------------------------Tt----------------------------------------------------------------        -----------------------------------------------------------------
-------------------------------------------------------------tt----------------------------------------------------------------        -----------------------------------------------------------------
-------------------------------------------------------------tt----------------------------------------------------------------        ---------------------------------------G-------------------------
-------------------------------------------------------------tt-----------------------------------------------G--G%%%%%%%%-%%%-        ------------------------------%%%%%%%Tt%%---------%%%%%%%%%---%%-
----------------%%%--%%%%---------------------------------%%%%%%%%%------------------------------------------U2U22||||%%%%%%%%%        -------------------%%%%%%%%---|||||||tt||---------|||||||||---||-
----------------|||--||||----------------%%%%%------%%%---|||||||||------------%%%----%%%----------%%%%-----------|||||||||||||        %%%%%%-------------||||||||---||||%%%%%%%%%%------|||||||||---||-
----------------|||--||||----------------|||||------|||---|||||||||------------|||----|||----------||||-----------|||||||||||||        ||||||-------------||||||||---||||||||||||||------|%%%|||||%%%%%%
XXXXXXXXXXXXXXXX|||--||||XXXXXXXXXXXXXXXX|||||------|||XXXXXXXXXXXXXXXXXXXXXXXX|||----|||XXXXXXXXXXXXXXXXXXXXXXXXXXXXX|||||||||        ||||||XXXXXXXXXXXXX||||||||XXXXXXXXXXXXXXXXXXXXXXXX|||XXXXX||||||