--------------------------------------------------------------------------------------------------------------------------------------------------------------------------------------------------------
--------------------------------------------------------------------------------------------------------------------------------------------------------------------------------------------------------
--------------------------------------------------------------------------------------------------------------------------------------------------------------------------------------------------------
--------------------------------------------------------------------------------------------------------------------------------------------------------------------------------------------------------
--------------------------------------------------------------------------------------------------------------------------------------------------------------------------------------------------------
--------------------------------------------------------------------------------------------------------------------------------------------------------------------------------------------------------
--------------------------------------------------------------------------------------------------------------------------------------------------------------------------------------------------------
--------------------------------------------------------------------------------------------------------------------------------------------------------------------------------------------------------
----------------------------------------S22SS--------------------------------------------------------------------g--------------------------------------------------------------------------------------
-------------------------------------------------Tt-----Tt------------------------------------------------------%%%-------------------------------------------------------------------------------------
---------------------------------------%---------tt--tt-tt------------------------------------------------------|||-------------------------------------------------------------------------------------
---------------------------------tt----|---------tt--tt-tt------------------------------------------------------|||-------------------------------------------------------------------------------------
---------------------------------tt---%%%%%%%%%%%%%%%%%%%%%%---------------------------------------------------g|||-------------------------------------------------------------------------------------
---------------%%--%%--------%%%%%%%--||||||||||||||||||||||---------------------#---#----------------------%%%%%%%%%%%%%%%-----------------------------------------------------------------------------
---------------||--||--#--#--|||||||%%||||||||||||||||||||||%%%%--%%%%--#--#----##---##--%%%--%%%%%%%---%%%%|||||||||||||||----------------%%%%%%%% %%%%%%%%%%%%%%%%%%%%%%%%%%%%%%%%%%%%%%%%%%%%%%    %%
XXXXXXXXXXXXXXX||--||XXX--XXX|||||||||||||||||||||||||||||||||||--||||XXX--XXXXXXX---XXXX|||--|||||||---|||||||||||||||||||XX--XXXXXX--XXXX||||||||X||||||||||||||||||||||||||||||||||||||||||||||||||||