--------------------------------------------------------------------------------------------------------------------------------------------------------------------------------------------------------
--------------------------------------------------------------------------------------------------------------------------------------------------------------------------------------------------------
--------------------------------------------------------------------------------------------------------------------------------------------------------------------------------------------------------
--------------------------------------------------------------------------------------------------------------------------------------------------------------------------------------------------------
--------------------------------------------------------------------------------------------------------------------------------------------------------------------------------------------------------
--------------------------------------------------------------------------------------------------------------------------------------------------------------------------------------------------------
--------------------------------------------------------------------------------------------------------------------------------------------------------------------------------------------------------
--------------------------------------------------------------------------------------------------------------------------------------------------------------------------------------------------------
--------------------------------------------------------------------------------------------------------------------------------------------------------------------------------------------------------
--------------------------------------------------------------------------------------------------------------------------------------------------------------------------------------------------------
---------------------------------------------------------------------------------------------------------------------------------------------K-K--------------------------------------------------------
-----------------------%%% Tt% %% -------------Tt----------------KG--------------------------------------------------------------- --F%%%%%%%% %--------------------------------------------------------
--------%   ---- %%%%--||||tt|||||-------------tt---------  %---% %%%-- %  -------K-----------------------------------------------%--|||||||||||----------------------- %%%%---% %%---- %% ----- % -----
--------||||----|||||--|||| t||K||-------------t ---------|||---|||||--|||| % % %% %-------%%% %--%% %%-----------------------%%%-|--||||||||||%% %-------%% %%----- %%|||||---||||----||||-----|||--G--
--------||||----|||||-%  %% %  %% --------% %%%%%%%%%-----|||---|||||--|||||||||||||-------|||||--|||||-----------------------|||-|--||||||||||||||-------|||||-----||||||||---||||----||||-----|||--%% 
  XXX XX||||----|||||X||||||||||||X XXXXXX||||||||||| XXX |||---|||||XX|||||||||||||XXXXXXX|||||--|||||XXXXXX XXXXXXXXXXXXX XX|||XXXXXX  XXXXXX||||X XX XX|||||-----||||||||---||||XXXX||||-----|||XX|||