--------------------------------------------------------------------------------------------------------------------------------------------------------------------------------------------------------
--------------------------------------------------------------------------------------------------------------------------------------------------------------------------------------------------------
--------------------------------------------------------------------------------------------------------------------------------------------------------------------------------------------------------
--------------------------------------------------------------------------------------------------------------------------------------------------------------------------------------------------------
--------------------------------------------------------------------------------------------------------------------------------------------------------------------------------------------------------
--------------------------------------------------------------------------------------------------------------------------------------------------------------------------------------------------------
--------------------------------------------------------------------------------------------------------------------------------------------------------------------------------------------------------
--------------------------------------------------------------------------------------------------------------------------------------------------------------------------------------------------------
----------------------------------------------------------------------------------g--------r------------------------------------------------------------------------------------------------------------
--------------------------------------------------------SSCSSSUSC2CC-%%%%%%%%%--------------------------------------------------------------------------------------------------------------------------
---------------------------------------------------------------------|||||||||---%%%%%%%%%%%------------------------------------------------------------------------------------------------------------
---------------------------------------------------2C2SU-------------|||||||||---|||||||||||------k--k-------------------------tt------------------rr--------k------------------------------------------
---------------------------------------------------------------------|||||||||---|||||||||||-----------------------------------tt-----------------------------%%%%%%%%%%%-------------------------------
---------------------------------------------------------------------|||||||||---|||||||||||-----%%%%%%%%%%%%%%----------------tt-----------------------------|||||||||||--------------k----------------
------%%%%%----------------------------------------------------------|||||||||---|||||||||||-----||||||||||||||------------%%%%%%%%%--------------------------|||||||||||-------------------------------
XXXXXX|||||XXXXXXXXXXXXXX----XXXXXXXXXXXXXXXXXXXXXXXXXXXXXXXXXXXXXXXX|||||||||---|||||||||||-----||||||||||||||-----XXX----|||||||||----XXXXXXXXXX----XXXXXXXX|||||||||||---XXXXXXXXX----XXXXXXXXX    XX