------------------------------------------------------------------------------------------------------------------------------      --------------------------------------------------------------------
------------------------------------------------------------------------------------------------------------------------------      --------------------------------------------------------------------
------------------------------------------------------------------------------------------------------------------------------      --------------------------------------------------------------------
------------------------------------------------------------------------------------------------------------------------------      --------------------------------------------------------------------
------------------------------------------------------------------------------------------------------------------------------      --------------------------------------------------------------------
------------------------------------------------------------------------------------------------------------------------------      --------------------------------------------------------------------
------------------------------------------------------------------------------------------------------------------------------      --------------------------------------------------------------------
------------------------------------------------------------------------------------------------------------------------------      --------------------------------------------------------------------
------------------------------------------------------------------------------------------------------------------------------      --------------------------------------------------------------------
------------------------------------------------------------------------------------------------------------------------------      --------------------------------------------------------------------
------------------------------------------------------------------------------------------------------------------------------      --------------------------------------------------------------------
-------------SS-------CSSS2------%-%%%%%%---------------------G---------------------------------------------------%%%%%-------      --------------------------------------%%%%%%%%%%--------------------
------------------------------%%%%%%%%%%|--%%%%%%%%%%%%%%%%%%%%%-----------------------------%%%%%%%%%%-----------|||||-------      -----------------------%%%%--%%%------||||||||||--------------------
-----------------2SCCS%%%%----|||||||||||--|||||||||||||||||||||-----------------------------||||||||||2UC--------|||||-------      -----------------------||||--|||%%%%%%%%%%%|||||------------K-------
----------------------||||----|||||||||||--|||||||||||||||||||||------%%%%%--%%%%%-----------||||||||||-----------|%%%%%%%%%%-      -----------------------||||--|||||||||||||||||||----%%%-----%%%%%---
XXXXXXXXXXXXXXXXXXXXXXXXXXXXXX||||||||||XXXXXXXXXXXXXXXXXXXXXXXXXXXXXX|||||--|||||XXXXXXXXXXX||||||||||XXXXXXXXXXXX||||||||||X      XXXXXXXXXXXXXXXXXXXXXXX||||--|||XXXXXXXXXXXXXXXXXXXX|||-----|||||XXX