--------------------------------------------------------------------------------------------------------------------------------------------------------------------------------------------------------
--------------------------------------------------------------------------------------------------------------------------------------------------------------------------------------------------------
--------------------------------------------------------------------------------------------------------------------------------------------------------------------------------------------------------
--------------------------------------------------------------------------------------------------------------------------------------------------------------------------------------------------------
--------------------------------------------------------------------------------------------------------------------------------------------------------------------------------------------------------
--------------------------------------------------------------------------------------------------------------------------------------------------------------------------------------------------------
--------------------------------------------------------------------------------------------------------------------------------------------------------------------------------------------------------
------------------------------------------------------CCS-----------------------------------------------------------------------------------------------------------------------------------------------
-----------------------------------------------------------------------------------------------------------------------------------------------------------------SCCSU2CC2----k-------k-----------------
---------------------------------------------------------------------------------------U--------------------------------------------------------------------------------------------------CSUSCSC-------
-----------------------------------------------------------------------------------------------------------------------------------------------------------------------------%%%%%%%%%%------------   %%
-----------------------------------------------------%%%%%%--------------------------------kggkkggkkggg-----------------------------------------------%%%%%%%%%--------------||||||||||------------|| ||
-------------------------------%%%%%-----------------||||||----------------------------------||||||||---------------------------g-g-----g-----%%%%%%%%|||||||||%%%%%%%%%%%%%%||||||||||------------|||||
-------------------------------|||||------g----------||||||-------g--gg------%%%%%%%%%%%%%%--||||||||--%%%%%%%%%-----%%%%%%%%%%---------------|||||||||||||||||||||||||||||||||||||||||%%%%%%%%%%% |||||
------%%%%%--------------------|||||-----------------||||||------------------||||||||||||||--||||||||--|||||||||-----||||||||||---------------||||||||||||||||||||||||||||||||||||||||||||||||||||||||||
XXXXXX|||||XXXXXXXXXXXXXX----XXXXXXXXX---XXXXXXXXXXXXXXXXXXXXX---XXXXXXXXXXXX||||||||||||||XXXXXXXXXXXX|||||||||-----||||||||||---XXXXXXXXXXXX||||||||||||||||||||||||||||||||||||||||||||||||||||||||||