--------------------------------------------------------------------------------------------------------------------------------------------------------------------------------------------------------
--------------------------------------------------------------------------------------------------------------------------------------------------------------------------------------------------------
--------------------------------------------------------------------------------------------------------------------------------------------------------------------------------------------------------
--------------------------------------------------------------------------------------------------------------------------------------------------------------------------------------------------------
--------------------------------------------------------------------------------------------------------------------------------------------------------------------------------------------------------
--------------------------------------------------------------------------------------------------------------------------------------------------------------------------------------------------------
--------------------------------------------------------------------------------------------------------------------------------------------------------------------------------------------------------
-----------------------------------------------------------Tt-------------------------------------------------------------------------------------------------------------------------------------------
---------------------------------------------------------Tttt-----------------------------------------------------------------------------------------------------------------------Tt------------------
---------------------------------------------------------tttt----------------------------------------------------------------------------Tt------------------Tt---------------------tt------------------
---------------------------------------------------------tttt----------------------------------------------------------------------------tt------------------tt--------------------Gtt------------------
--------U2C22U----------------------------------------%%%%%%%%%%%%----------C22-------------G-------------------------------------F------tt------------------tt------------------%%%%%%%%%--------------
------------------------------------------------------%%%%%%%%%%||-----------------------UUCC----%%%%--%%%------%%%%%%%%%%--------%----K-tt-----------------Ktt------------------|||||||||--------------
------------------------------%%%%%--%%%%%--%%%-------||||||||||||-------------------------------||||--|||------||||||||||------S2U2%%%%%%%%%%------------%%%%%%%%--%%%%%%%%%%---|||||||||------------F-
------------------------------|||||--|||||--|||-------||||||||||||-------------------------------||||--|||------||||||||||----------||||||||||------------||||||||--||||||||||---|||||||||-%%%%------- -
XXXXXXXXXXXXXXXXXXXXXXXXXXXXXX|||||XX|||||--|||XXXXXXXXXXXXXXXXXXXXXXXXXXXXXXXXXXXXXXXXXXXXXXXXXX||||--|||XXXXXXXXXXXXXXXXXXXXXXXXXXXXXXXXXXXXXXXXXXXXXXXX||||||||XX||||||||||XXXXXXXXXXXXX||||XXXXXXXXX