--------------------------------------------------------------------------------------------------------------------------------------------------------------------------------------------------------
--------------------------------------------------------------------------------------------------------------------------------------------------------------------------------------------------------
--------------------------------------------------------------------------------------------------------------------------------------------------------------------------------------------------------
--------------------------------------------------------------------------------------------------------------------------------------------------------------------------------------------------------
--------------------------------------------------------------------------------------------------------------------------------------------------------------------------------------------------------
--------------------------------------------------------------------------------------------------------------------------------------------------------------------------------------------------------
--------------------------------------------------------------------------------------------------------------------------------------------------------------------------------------------------------
--------------------------------------------------------------------------------------------------------------------------------------------------------------------------------------------------------
--------------------------------------------------------------------------------------------------------------------------------------------------------------------------------------------------------
----------------------------------------------------------------------------------------------------------------------------------------------------Tt--------------------------------------------------
-------------------------------------------------Tt-----------------------------------------------G-------------------------------------------------tt--------------------------------------------------
----------------------K-------------------%%%%%--tt----%%%%%%%---------------------------%%%%%%%%%%%------------------------------F-----------------tt--------------------------------------------------
----------------------%%%-----%%%---------|||K|G-tt----|||||||---------------------------|||||||||||------------------------------%-----------------tt---------K-------------------------KK-------------
----------------------|||-----|||---------|||%%%%tt%%%%%%%%%||---------------------------|||||||||||--%%%----%%%%%----------------|--------------%%%%%%%%%%-%%%%%%-----K---------------S2222------------
--------------%%%%%%--|||-----|||---------||||%%%%%%%%%|||||||---------------------------|||||||||||--|||----|||||----------------|--------------||||||||||-||||||---%%%----------------------------%%%%
  X XX  XX    ||||||XX|||-----|||XX X   XX    |||||||||X   XXX  XX         X X X    X   X      X XXXXX|||----|||||    XX X  XX X X X  XXXXX XXXX  XXX     XX  X   XX |||X   X   X  X XX X   X X     ||||