--------------------------------------------------------------------------------------------------------------------------------------------------------------------------------------------------------
--------------------------------------------------------------------------------------------------------------------------------------------------------------------------------------------------------
--------------------------------------------------------------------------------------------------------------------------------------------------------------------------------------------------------
--------------------------------------------------------------------------------------------------------------------------------------------------------------------------------------------------------
--------------------------------------------------------------------------------------------------------------------------------------------------------------------------------------------------------
--------------------------------------------------------------------------------------------------------------------------------------------------------------------------------------------------------
--------------------------------------------------------------------------------------------------------------------------------------------------------------------------------------------------------
-------------------------------------------------------------------------------------------------------------------------------------------Tt-----------------------------------------------------------
-------------------------------------------------------------------------------------------------------------------------------------------tt-----------------------------------------------------------
-------------------------------------------------------------------------------------------------------------------------------------------tt-----------------------------------------------------------
-------------------------------------------K-----------------------------------------------------------------------------------------------tt-----------------------------------------------------------
-------------------------------------%%%%%%%%------------------------------------------------------------------------------%%%%%-- ----%%%%%%%%%%---------------------------------------------------K---
---------------------------K---------||||||||---------------------------------------------------------------------------K--|||||--%--G-||G|||||||----------------------------------------------%%%-   --
------SUCU222-%%%%%%%%%%U2UU---------||||||||----------SS-----------------------------------G--------G--------------%%%%%--|||||--|--CC2CU2||||||------------------------G---------------------|||------
--------------||||||||||-------------||||||||-----------------------------------------------%%%%---%%%%%------------|||||--|||||--|----||||||%%%%%%---------------------%%%%%%-----------------|||------
XXXXXXXXXXXXXX||||||||||XXXXXXXXXXXXXXXXXXXXXXXXXXXXXXXXXXXXXXXXXXXXXXXXXXXXXXXXXXXXXXXXXXXX||||---|||||XXXXXXXXXXXXXXXXXXXXXXXXXXXXXXXXXXXXX||||||XXXXXXXXXXXXXXXXXXXXX||||||XXXXXXXXXXXXXXXXXXXX    XX