--------------------------------------------------------------------------------------------------------------------------------------------------------------------------------------------------------
--------------------------------------------------------------------------------------------------------------------------------------------------------------------------------------------------------
--------------------------------------------------------------------------------------------------------------------------------------------------------------------------------------------------------
--------------------------------------------------------------------------------------------------------------------------------------------------------------------------------------------------------
--------------------------------------------------------------------------------------------------------------------------------------------------------------------------------------------------------
--------------------------------------------------------------------------------------------------------------------------------------------------------------------------------------------------------
--------------------------------------------------------------------------------------------------------------------------------------------------------------------------------------------------------
--------------------------------------------------------------------------------------------------------------------------------------------------------------------------------------------------------
------------------------------------------Tt-------------------------------------------------------------------------------------------------------------------------------------------------------  ---
------------Tt----------------------------tt-------------------------------------------------------------------------------------------------------------------------------------------------------  ---
------------tt---------Tt-----------------tt-------------------------------------------------------------------------------------------------------------------------------------------------------  ---
------------tt----S----tt-----K--------%-%%%%%%%---------------%%%%%%%%%%%%-------------------------------------------------K--G-- -----------------SUUCSCC-------------S-----------------G-G------  ---
-------%%%%%%%%%%%-----tt----UCU2C2---G|%%%%%%||----------G----||%%%%%%%%%|---------------------------%%%%----%%%%%---------%%%%%%%%%%%%%------------------UCSS2UC----------------------%%%%%--%%%    %%
-------|||||||||||-%%%%%%%%%%------%%%%%||||||||%%%%------%%%--||||||||||||---------------------------||||----|||||---------|||||||||||||--------------------%%%%%%%%%-----------------U|||||S-|||||||||
-------|||||||||||-||||||||||------|||||||||||||||||------|||--||||||||||||----%%%%%----%%%%----------||||----|||||%%%%--%%%|||||||||||||--------------------|||||||||---%%%%-----%%%%--|||||--|||||||||
XXXXXXX|||||||||||X||||||||||XXXXXXXXXXX||||||XX||||------|||XXXX|||||||||XXXXX|||||----||||XXXXXXXXXX||||----|||||||||--|||XXXXXXXXXXXXXXXXXXXXXXXXXXXXXXXXXXXXXXXXXXXXX||||-----||||XXXXXXXXX|||||||||