--------------------------------------------------------------------------------------------------------------------------------------------------------------------------------------------------------
--------------------------------------------------------------------------------------------------------------------------------------------------------------------------------------------------------
--------------------------------------------------------------------------------------------------------------------------------------------------------------------------------------------------------
--------------------------------------------------------------------------------------------------------------------------------------------------------------------------------------------------------
--------------------------------------------------------------------------------------------------------------------------------------------------------------------------------------------------------
--------------------------------------------------------------------------------------------------------------------------------------------------------------------------------------------------------
--------------------------------------------------------------------------------------------------------------------------------------------------------------------------------------------------------
-------------------------------------------------------------------------------------------------------------------------------U------------------------------------------------------------------------
--------------------------------------------------------------------------------------------------------------------------------------2S2---------------------------------------------------------------
--------------------------------------------------------------------------------------------------------------------------------------------------------------------------------------------------------
-----------------------------------------------------------------------------------------------------------------------------------gggggggkk------------------------------------------------------------
----------------------------g--------------------------------------------------kggkkggkggggg-------------------------%%%%%%%%%%%%%%---------------------------------------------------------------------
-------------------------------%%%%%%---------------------------------------------------------------------%%%%%%%%%%%||||||||||||||---------%%%%%%%%%%%%----%%%%%%%%%%%%%%------------------------------
-------------------------------||||||-------------------%%%%%%---------------r--------------%%%%%%%%%%%%%%|||||||||||||||||||||||||---------||||||||||||----||||||||||||||--%%%%%%----------------------
------%%%%%-------------------XXX||||-------------------||||||---%%%%%%%%%%%%%--------------|||||||||||||||||||||||||||||||||||||||%%%%%%%%%||||||||||||----||||||||||||||--||||||-------------%%%    %%
XXXXXX|||||XXXXXXXXXXXXXX----XXXXXXXXXXX---XXXXXXXX---XXXXXXXXXXX|||||||||||||XXXXXXXXXXXXXX||||||||||||||||||||||||||||||||||||||||||||||||||||||||||||----||||||||||||||XXXXXXXXXXXXXXXXXXXXX|||||| ||