--------------------------------------------------------------------------------------------------------------------------------------------------------------------------------------------------------
--------------------------------------------------------------------------------------------------------------------------------------------------------------------------------------------------------
--------------------------------------------------------------------------------------------------------------------------------------------------------------------------------------------------------
--------------------------------------------------------------------------------------------------------------------------------------------------------------------------------------------------------
--------------------------------------------------------------------------------------------------------------------------------------------------------------------------------------------------------
--------------------------------------------------------------------------------------------------------------------------------------------------------------------------------------------------------
---------------------------------------------------------------------------------------------------------------------------------------------------------------------------------22C-----SSSSCCCS-------
-------------------------------------------------------------------------------------------------------------------------------------------------------gkgkkgkgkgr--------------------------------------
-----------------------------------------------------------------------------------------------------------------------------------------------------r--|||||||||---------------------------------------
------------------------------------------------------------------------------------------------------------------------------------------%%%%%%%%%%%%--|||||||||-%%%%%%%%%%%%--------------------------
------------------------------------------------------------------------------------------------------------------------------------------||||||||||||--|||||||||-||||||||||||%%%%%%%%%%%%%%%%%%%%    %%
--------------------------------------------------------------------------------------22S22-----------------------------------------------||||||||||||%%%%%%%%%%%%||||||||||||||||||||||||||||||||||| ||
-----------------------------------------------------------%%%------------------------------------------------g---------------------------||||||||||||||||||||||||||||||||||||||||||||||||||||||||||||||
--------------------------g--g-----------------------------|||----%%%%%%%%%%-ggg--------------g-----g------------------------%%%%%%%%%%%%%||||||||||||||||||||||||||||||||||||||||||||||||||||||||||||||
------%%%%%------------------------------------------------|||----||||||||||-------------------------------------------------|||||||||||||||||||||||||||||||||||||||||||||||||||||||||||||||||||||||||||
XXXXXX|||||XXXXXXXXXXXXXX----XXXXXXXXX-----XXXXXXXXXXX-----|||----||||||||||XXXXXXXXXXXXXXXXX---XXXXXXXXXXX----XXXXXXXXXXXXXX|||||||||||||||||||||||||||||||||||||||||||||||||||||||||||||||||||||||||||