----------------------- --------------------------------------------------------------------------------------------------------------------------------------------------------------------- ----------
--------------------------------------------------------------------------------------------------------------------------------------------------------------------------------------------------------
-------------------------------------- --- -------------------------------------------------------------------------------------------------------------- ----------------------------------------------
------------------------------------------------------------------------- ------------------------------------------------------------------------------------------------------------------------------
--------------------------------------------------------------------------------------- ----------------------------------------------------------------------------------------------------------------
----------------------------------------------------------------------------------------------------------------------------------------- --------------------------------------------------------------
---------------------------------------------------- -------------------------- ------------------------- ----------------------------------------------------------------------------- ----------------
---------- ------- ---------------------------------------- --------------------------------------------------U-----------------------------tt----------------------------------------------------------
--------------------------------------------------------------------------------------------------------------------------------------------tt----------------  ----------------------------------------
------------------------------------------------------------ -------------------------------------------------------%%%%%%%-----------------tt----------------------------------------------------------
-------------- ---- -------------------------------------------------------------------------- -------------------           ----------%%%%%%%%%%----%% %%%%%--------          -------------------------
-----------------------------------------------------------------------        --------------------------%%%%%%%%%--|||||||------------||||||||||----||||||||-----------------%%%--------S2CS2CCSC------
------------------------------------------------------------------------%%%%%%---------------%%%%%%%%%%%%|||||||||--|||||||--%%%%%%%%%%||||||||||- --||||||||-----------------|%%%%%%-------------------
-------------------------- ------------- ---%%%%%%%%----------------- --||||||-%%%%%%%%%%%%%%|||||||||||||||||||||--|||||||--||||||||||||||||||||----||||||||--------------  -|||||||-------------------
------%%%%%---------------------------------||||||||----%%%%%%%%%%%%%%--||||||-|||||||||||||||||||||||||||||||||||%%%%%%%%%%%||||||||||||||||||||----||||||||----%%%%%%%%%----|||||||-------------------
XXXXXX|||||XXXXXXXXXXXXXX----XXXXXXXXXX---XXXXXXXXXXXXXX||||||||||||||XXXXXXXXX||||||||||||||||||||||||||||||||||||||||||||||||||||||||||||||||||----||||||||----|||||||||---XXXXXXXXXXXXXXXXXXXXXXX  XX