----------------------------------------------------------------------------------------- --------------------------------------------------------- -------------------------------------------------- -
---------------------------------------------------------------------------------------------------------------------------------------------- ------- --------------------------------- ---------------
--------------------------------------------------------------------------------------------------------------------------------------------------------          -------------------- -----------------
---------------------------------------------- ----------------------- ---------------------------------------------------------------------------------------------------------------------------------
------------------------------------------------------------------------------------------------------------------------------------------------------------------------ ---- --------------------------
 --------------------- ---------------------------------------------------------------------------------------------------------------------------------------------------------------------------------
----------------------------------------------------------------------------------------------------------------------------------------------------- ----------------------------- --------------------
-------------------------------------------------------------------------------------------------------------------------------------------------------------------------- -- --------------------------
------------------------ -------------- -------------------------------------------------------------------------------------------------------------------------------------- -------------------------
--------------------------------------------------- t------- t----------------- ------------------------------------------------------------------------------------------------------------------------
---------- ---------------------------------------- t-------tt--------------------- ----------------------------------------------------------------------------------- t-------------------------------
------------------------ t------------ ------------tt-------tt------------------------------------------------------------------F  --- %%------------------------------tt-----------S 2---------%%%%----
------------- ----------tt-------------------------tt-- ----tt- -------%%%----%% %%------- --------- ------- ---------------------%---|||------------%%% %----%%%-- ---tt- -----%%% % ----------|%%%% %%
------------%%%% -------tt----------------------%%%% %%%%%%%% %%%%-----|||----|||||------%%%------% %-----SSS2--------------------|---|||------------|||||----|||-% %%% %%%%%%--||||||----------||||||||
------------|||||---%%%%%%%%%% -%%%%----%%%-----||||||||||| ||||||-----|||----|||||------|||------|||-----------------------------|---|||------------|||||----|||-||||||||||||--||||||----------||||||||
  X  XXXXXXX|||||X X||||||||||| ||||----|||X  XXXX X XX X XX XXXXXX  XX|||----|||||  XX X|||------|||X  XXXXX  X XXXXX  X  XXXXX XX XX XXXXX  X X XXX ||||----||| XX XXXXX XXX XX XXX X  X     XX|||||||