--------------------------------------------------------------------------------------------------------------------------------------------------------------------------------------------------------
--------------------------------------------------------------------------------------------------------------------------------------------------------------------------------------------------------
--------------------------------------------------------------------------------------------------------------------------------------------------------------------------------------------------------
--------------------------------------------------------------------------------------------------------------------------------------------------------------------------------------------------------
--------------------------------------------------------------------------------------------------------------------------------------------------------------------------------------------------------
--------------------------------------------------------------------------------------------------------------------------------------------------------------------------------------------------------
--------------------------------------------------------------------------------------------------------------------------------------------------------------------------------------------------------
--------------------------------------------------------------------------------------------------------------------------------------------------------------------------------------------------------
--------------------------------------------------------------------------------------------------------------------------------------------------------------------------------------------------------
--------------------------------------------------------------------------------------------------------------------------------------------------------------------------------------------------------
--------------------------------------------------------------------------------------------------------------------------------------------------------------------------------------------------------
-------------------------------------------------------------------------------------------------------------%%%-%------S2S-------F-----------------------------22S-------------------------------------
-------------------------------------------------------------------------------------------------------------|||-%%%%%%%%%%----%%%%%%%%%%%%-----------------------------------------------%%%%----------
--------------G----------------%%%%------%%%%%--%%%%%%%%%%%-----K--------------------------------------------%%%%%%%%%%||||----||||||||||||--------------------SSU2U------%%%%%%%%--------||||-----F----
------------%%%%%-----%%%------||||------|||||--|||||||||||--%%%%---%%%%----------------%%%%%--%%%%----------||||||||||||||----||||||||||||-------%%%%%%------------%%%%%%%%%%%|||--------||||----- ----
XXXXXXXXXXXX|||||-----|||XXXXXX||||------|||||XXXXXXXX|||||XX||||---||||XXXXXXXXXXXXXXXX|||||--||||XXXXXXXXXX||||||||||XXXXXXXXXXXXXXXXXXXXXXXXXXX||||||XXXXXXXXXXXX|||||||||||XXXXXXXXXXX||||XXXXXXXXXX