--------------------------------------------------------------------------------------------------------------------------------------------------------------------------------------------------------
--------------------------------------------------------------------------------------------------------------------------------------------------------------------------------------------------------
--------------------------------------------------------------------------------------------------------------------------------------------------------------------------------------------------------
--------------------------------------------------------------------------------------------------------------------------------------------------------------------------------------------------------
--------------------------------------------------------------------------------------------------------------------------------------------------------------------------------------------------------
--------------------------------------------------------------------------------------------------------------------------------------------------------------------------------------------------------
--------------------------------------------------------------------------------------------------------------------------------------------------------------------------------------------------------
--------------------------------------------------------------------------------------------------------------------------------------------------------------------------------------------------------
--------------------------------------------------------------------------------------------------------------------------------------------------------------------------------------------------------
--------------------------------------------------------------------------------------------------------------------------------------------------------------------------------------------------------
----------------Tt------K-G-------------------------------------------------------------------------------------------------------------------------------------------------------Tt--------------------
----------------tt-----%%%%%-------------%%%%%%-----------------------------------------------------------------------------------F--------------------------------%%%------------tt--------------------
----------------tt---K-|||||UC2SS--------||||||---------------------%%%%------K---------------------22--%%%%----------------------%-------------------------G------|||------------tt--G-----------------
-------------%%%%%%%%%%|||||-------------||||||----GG---------------||%%%%%%%%%%%------%%%%---%%%%------||||----------------------|------------------------%%%%%%%%|||-------%%%%%%%%%%----K--------K---
-------------|||||||||||||||-------------||||||----%%%------%%%%----|||||||||||||------||||---||||------||||-----------%%%%%%%%---|------------------------||||||||%%%-------||||||||||-%%%%%---%%%%%---
 XXXX  X XX X||||||||||XXXX XXXXXXX XX  XX  XXXXXX |||------|||| XX XXX XXXX XXXXX  X X||||---||||XXXXXXXX XX XXXXXXXXX||||||||XX  XX XXX XXXXX X XXXX   XXXX XXXXX|||XXXXXX |||||||||| |||||---|||||X X