--------------------------------------------------------------------------------------------------------------------------------------------------------------------------------------------------------
--------------------------------------------------------------------------------------------------------------------------------------------------------------------------------------------------------
--------------------------------------------------------------------------------------------------------------------------------------------------------------------------------------------------------
--------------------------------------------------------------------------------------------------------------------------------------------------------------------------------------------------------
--------------------------------------------------------------------------------------------------------------------------------------------------------------------------------------------------------
--------------------------------------------------------------------------------------------------------------------------------------------------------------------------------------------------------
--------------------------------------------------------------------------------------------------------------------------------------------------------------------------------------------------------
--------------------------------------------------------------------------------------------------------------------------------------------------------------------------------------------------------
----------------------------------------------------------------------------------------CSCS------------------------------------------------------------------------------------------------------------
---------------------------------------------------------------CCSCCCSS---------------------------------------------------#---#--------#--#-------------------------------------------------------------
--------------------------------------tt-----------tt--------------------------------------------------------------------##---##------##--##------------------------------------------------------------
--------------------------------------tt-----------tt----tt---------------------------y-r-y--k--------------------------###---###----###--###-----------------------------------------------------------
---------------tt----------------%%%%-tt----%%%%%%-tt----tt-----y-------------------%%%%%%%%%%%----#---#--------------%%%%%---%%%%%%%%%%--%%%%%---------------------------------------------------------
---------------tt---%%%%%%-------||||%%%%%%%||||||%%%%%%%%%%%%%%%%%%%%%%------------|||||||||||---##---##-------------|||||---||||||||||--|||||%%%%%%%% %%%%%%%%%%%%%%%%%%%%%%%%%%%%%%%%%%%%%%%%%%    %%
-------------%%%%%%%||||||-------|||||||||||||||||||||||||||||||||||||||------------|||||||||||--###---###--%%%%--%%%%|||||---||||||||||--|||||||||||||%||||||||||||||||||||||||||||||||||||||||||||||||
XXXXXXXXXXXXX|||||||||||||XX---XX|||||||||||||||||||||||||||||||||||||||XXXXX--XXXXX|||||||||||XXXXX---XXXXX||||--|||||||||---||||||||||--||||||||||||||||||||||||||||||||||||||||||||||||||||||||||||||