--------------------------------------------------------------------------------------------------------------------------------------------------------------------------------------------------------
--------------------------------------------------------------------------------------------------------------------------------------------------------------------------------------------------------
--------------------------------------------------------------------------------------------------------------------------------------------------------------------------------------------------------
--------------------------------------------------------------------------------------------------------------------------------------------------------------------------------------------------------
--------------------------------------------------------------------------------------------------------------------------------------------------------------------------------------------------------
--------------------------------------------------------------------------------------------------------------------------------------------------------------------------------------------------------
--------------------------------------------------------------------------------------------------------------------------------------------------------------------------------------------------------
--------------------------------------------------------------------------------------------------------------------------------------------------------------------------------------------------------
---------------------------------yg---------------------------------------------------------------------------------------------------------------------------------------------------------------------
-----------------------------%%%%%%--------------------------------------------tt-------------------------------------------------#--#------------------------------------------------------------------
----------------#--#---------||||||------------------------------------Tt--Tt--tt------------------------------------------------##--##-----------------------------------------------------------------
---------------##--##--------||||||----------------------rg------------tt--tt--tt---SSS-----------------------------------------###--###----------------------------------------------------------------
--------------###--###-------||||||---%%---%%-------%%%%%%%%----------%%%%%%%%%%%%%-------------------------------------------%%%%%--%%%%%--------------------------------------------------------------
------------%%%%%--%%%%%%%%%%%%%%%%%%%||---||-------||||||||----------|||||||||||||-------------------------------------------|||||--|||||%%%%%%%% %%%%%%%%%%%%%%%%%%%%%%%%%%%%%%%%%%%%%%%%%%%%%%%    %%
------------|||||--|||||||||||||||||||||---||-------||||||||----------|||||||||||||-r-----------------%%%%%---%%%%%%%%%%-r--r-|||||--|||||||||||||%|||||||||||||||||||||||||||||||||||||||||||||||||||||
XXXXXXXXXXXX|||||--|||||||||||||||||||||---||XX---XX||||||||XXX--XXXXX|||||||||||||XXXXXXXXX---XXXXXXX|||||---||||||||||XXXXXX|||||--|||||||||||||||||||||||||||||||||||||||||||||||||||||||||||||||||||