--------------------------------------------------------------------------------------------------------------------------------------------------------------------------------------------------------
--------------------------------------------------------------------------------------------------------------------------------------------------------------------------------------------------------
--------------------------------------------------------------------------------------------------------------------------------------------------------------------------------------------------------
--------------------------------------------------------------------------------------------------------------------------------------------------------------------------------------------------------
--------------------------------------------------------------------------------------------------------------------------------------------------------------------------------------------------------
--------------------------------------------------------------------------------------------------------------------------------------------------------------------------------------------------------
--------------------------------------------------------------------------------------------------------------------------------------------------------------------------------------------------------
--------------------------------------------------------------------------------------------------------------------------------------------------------------------------------------------------------
--------------------------------------------------------------------------------------------------------------------------------------------------------------------------------------------------------
----------------------------------------------------Tt--------------------------------------------------------------------Tt----------------------------------------------------------------------------
----------------------------------------------------tt-----------------------------------------G--------------------------tt----------------------------------------------------------------------------
----------------------------------------------------tt-----------------------G---------------%%%%%%%%%%%----------%%%%----tt---%%% %%%%%%--------------------------------------------------------------K
-------------------------------%%%---%%%------------tt%%%--------------UCCUSCU---------------|||||||||||CSCS------|||%%%%%%%%%%%||%||||||------------------G------G-----------------%%%%---%%%%%%%    %%
-------------------------------|||---|||---------%%%%%%%%------------------------------------|||||||||||----------|||||||||||||||||||||||---------------%%%%%-----%%%%-------%%%----||||---|||||||||||||
-------------------------------|||---|||---------||||||||------------------------------------|||%%%||%%%----------||||||||||||||||%%%%%||--%%%%%--%%%%%-|||||-----||||-------|||----||||---|||||||||||||
XXXXXXXXXXXXXXXXXXXXXXXXXXXXXXX|||---|||XXXXXXXXX||||||||XXXXXXXXXXXXXXXXXXXXXXXXXXXXXXXXXXXXXXX||||||||XXXXXXXXXXXXX|||||||||||XX|||||XXXX|||||--|||||X|||||-----||||XXXXXXX|||XXXX||||---|||||||||||||