-------------------------------------------------- --------------------------------------------------------------------------- -------------------- -------- ------------------ ------------------------
--------- --------- ----------------- ---------------------------------------------------------------- -------------------------------------------------------------------------------------------------
--------------------------------------------------------------------------------------------------------------------------------- ----------------------------------------------------------- ----------
--------------------------------------------------------------------------------------------------------------------------------------------------------------------------------------------------------
--------------------------------------------------------------------------- ------------------------------------------------------------------------------------- --------------------------------------
-------------------------------------------------------------------------------- ---------------- ------------------------------------------------------------------------------------------------------
--------------------------------------------------------------------------------------------------------------------------------------------------------------------------------------------------------
--------------------------------------------------------------------------------------------------------------------------------------------------------------------------------------------------------
------------------- -- ---------------------------------------------------------------------------------------------------------r------------------------------------------------------------------ ----
--------------------------------------------------------------CC--------------------------------------------------------- ----%%%%%%--------------------------------------- ----------------------------
------------ ----------SC2SSC-----------------------------------------SSS---- ------------------------------------------------||||||------------------------------------------ --- ---------------------
------------------------------------------ ------------------%----------------------------------------------------------------||||||g-------------------------------------------------------------------
---------------#--#------------------------------------------|-r-------------------------------------------------------------%%%%%%%%%%%%%%%%%%%%% %%%%%%%%%%%%%%%%%%%%%%%%%%%%%% %%%%%%%%%%%%%%%%%%%%%%
------------- ##--##--------g-------------#---#------------%%%%%%%-K-------Y---------------------------%%%--%%%--------------|||||||||||||||||||||%||||||||||||||||||||||||||||||||||| |||||||||||||||||
------------%%%%--%%%%%%%%%% %%%%%%%%%%%%%%---%%%----------|||||||%% %%%%%%%% -------- ----------------| |--|||-------------- ||||||||||||||||||||||||||||||||||||||||||||||||||||||||||||||||||||||||||
XXXXXXXXXXXX||||--|||||||||||||||||||||||||---|||XXXX--XXXX|||||||||||||||| |XXXXXXXXX--XXXXXXXXX--XXXX|||--|||XX--XXXXX--XXX||||||||||||||||||||||||||||||||||||||||||||||| |||||||||||||||||||||||||||