--------------------------------------------------------------------------------------------------------------------------------------------------------------------------------------------------------
--------------------------------------------------------------------------------------------------------------------------------------------------------------------------------------------------------
--------------------------------------------------------------------------------------------------------------------------------------------------------------------------------------------------------
--------------------------------------------------------------------------------------------------------------------------------------------------------------------------------------------------------
--------------------------------------------------------------------------------------------------------------------------------------------------------------------------------------------------------
--------------------------------------------------------------------------------------------------------------------------------------------------------------------------------------------------------
--------------------------------------------------------------------------------------------------------------------------------------------------------------------------------------------------------
--------------------------------------------------------------------------------------------------------------------------------------------------------------------------------------------------------
-----------------------------------------------------------Tt------------------------------------------------------------------------------------------------------------------------------------Tt-----
-----------------------------------------------------------tt------------------------------------------------------------------------------------------------------------------------------------tt-----
-----------------------------------------------------------tt-------------------------------------------Tt---------------------------------------------------------------------------------------tt-----
-----------------------------------------------------------tt--G-------------------K--------------------tt------------------------F----------------------------------------------------------G---tt-G-K-
--------------------------------------------------------%%%%%%%%%%%%%------------%%%--------------------tt------------------------%-----------------GG-------%%%%------%%%%%----------------%%%%%%%%%%%-
--------------------------------------------------------|||||||||||||------------|||-----G------------K-tt--G---------------------|--------%%%-----%%%%%-----||||------|||||----------------|||||||||||-
--------------------------------------------------------|||||||||||||------------|||----%%%%%------%%%%%%%%%%---------------------|--------|||-----|||||-----||||------|||||----------------|||||||||||-
 XX XXXX  XXXXXXX XXXXXXXXX XX XXXXXXX  X XXXX XX XXXX  XXXX  X X ||| XXXXXXXXX X XX  XX|||||XX XXX||||||||||XXXXXXXX XX  X   XXX XXXX  X X|||-----|||||XXX X||||------||||| XXX   XXX XXX  XXXX  XX XX 