--------------------------------------------------------------------------------------------------------------------------------------------------------------------------------------------------------
--------------------------------------------------------------------------------------------------------------------------------------------------------------------------------------------------------
--------------------------------------------------------------------------------------------------------------------------------------------------------------------------------------------------------
--------------------------------------------------------------------------------------------------------------------------------------------------------------------------------------------------------
--------------------------------------------------------------------------------------------------------------------------------------------------------------------------------------------------------
--------------------------------------------------------------------------------------------------------------------------------------------------------------------------------------------------------
--------------------------------------------------------------------------------------------------------------------------------------------------------------------------------------------------------
--------------------------------------------------------------------------------------------------------------------------------------------------------------------------------------------------------
--------------------------------------------------------------------------------------------------------------------------------------------------------------------------------------------------------
----------------------------------------------  ---------------------------------------------------------------#---#------------------------------------------------------------------------------------
--------------------------------------------% %%%------------------------------ -- ---------------------------##---##-----------------------------------------------------------------------------------
------------------------------ -------------|||||-----------------------------%%%%%--------------------------###---###-------------------#---#----------------------------------------------------------
----------------------------%%% ------------|||||-----------------------------|||||----------------------%%%%%%%---%%%%%------% --- %--- #---##---------------------------------------------------------
--------------------------- | ||----------%%% %||-----------------------------|||||---%%%--   %%%%---%% %|||||||---|||||%%--%%||---||-- ##---###--------------------------------------------------------
-----------------------%%%%% %%%%%%%--%%- ||| ||| --------%%%% --%%%% --------|| ||---|||--|||||||---|||||||||||---|||||||--||||---||%% %%---%%%%%%%%  %%%F%% %%%%%%%%% %%%%%% %%%%%%%%%%%%%%%%%%%%%%%%%
 XX XXXXXXXXXX XXXXX XX|||||||||||||--||XXXXXXXXXXXXXXXXXX|||||--|||||X XXXX X XXXXX X|||--|||||||---|||||||||||---|||||||--||||---|||||||---||||||||||||| |||||||||||||||||||||||||||||||||||||||||||||