--------------------------------------------------------------------------------------------------------------------------------------------------------------------------------------------------------
--------------------------------------------------------------------------------------------------------------------------------------------------------------------------------------------------------
--------------------------------------------------------------------------------------------------------------------------------------------------------------------------------------------------------
--------------------------------------------------------------------------------------------------------------------------------------------------------------------------------------------------------
--------------------------------------------------------------------------------------------------------------------------------------------------------------------------------------------------------
--------------------------------------------------------------------------------------------------------------------------------------------------------------------------------------------------------
--------------------------------------------------------------------------------------------------------------------------------------------------------------------------------------------------------
--------------------------------------------------------------------------------------------------------------------------------------------------------------------------------------------------------
-----------------------------------------------------------------------------------------------------------------------------Tt-------------------------------------------------------------------------
------------------------------------------------------Tt---------------------------------------------------------------------tt-------------------------------------------------------------------------
------------------------------------------------------tt---------------------------------------------------------------------tt-----------Tt------------------------------------------------------------
------------------------------------------------------tt----------------------------------------------------------Tt------%%Tt%%%%F-------tt-------------------------------------------------Tt---------
---------------------USSCU22--------------------------tt-----------------2C2U-------------------------------------tt------||tt||||%-------tt------------------------------G------------------tt---F-----
---------------G----------------------------------%%%%%%%%%%%UUUCC2-----------%%%------%%%%-----------------------tt----%%%%%%%%%%%----%%%%%%%%%--------------%%%-----%%%%%%%%%%%%%%---------tt--- -----
--------%%%%%--%%%--------------%%%%%---%%%%------|||||||||||-----------------|||------||||----%%%%%----%%%%%%%%%%%%%%%-|||||||||||----|||||||||--------------|||-----||||||||||||||-----%%%%%%%%%%-----
XXXXXXXX|||||--|||XXXXXXXXXXXXXX|||||---||||XXXXXX|||||||||||XXXXXXXXXXXXXXXXX|||------||||XXXX|||||----|||||||||||||||XXXXXXXXXXXXXXXXXXXXXXXXXXXXXXXXXXXXXXX|||-----|||XXXXXXXXXXXXXXXX||||||||||XXXXX