--------------------------------------------------------------------------------------------------------------------------------------------------------------------------------------------------------
--------------------------------------------------------------------------------------------------------------------------------------------------------------------------------------------------------
--------------------------------------------------------------------------------------------------------------------------------------------------------------------------------------------------------
 -------------------------------------------------------------------------------------------------------- -------- -------------------------------------------------------------------------------------
----------------------------------------------------------------------------------------------------------------------------------------------------------------------------- --------------------------
-------------------------------------------------------- ------------------------------------------------------------------- ---------------------------------------   ---------------------------------
--------------------------------------------------------------------------------------------------------------------------------------------------------------------------------------------------------
---------------------------------------------------------------------------- ---------------------------- ----------------------------------------------------------------------------------------------
-------------------------------------------------------------------------------------------------------------------------------------------------------------------------------------- -----------------
------------------------------------------------------T ----------------------------------------------------------------- ------------------------------------------------------------------------------
------------------- ------------- --------------------tt---------------------------------------------------------------------------G-------------- ------T ---------T ------K------------------- -------
------------------------------------------------------tt---------------G---------------------------------------------------------GFUS G------------------t ---------tt--SUUCSS---------------G-- CU-----
-------------------------------------------------%% %%K%%-%%--%%%%%%% %%%------------------------------SSUS--- ----------UC2-----%% % %------------------tt--------- t-------------% %%%%%%%%%----------
---------- %%----%%%%%-----------%%%%%-----%%%---||||%%%%%%%%%|||||||||||------------------------- ------------------------------||||||-------K----------t -G---% %%%%%%%----------|||||||||||----------
----------|||----|||||-----------|||||-----|||---||||||||||||||||||||||||--%%% % -----%%%% ----------------% %%----%%%-----------|||||| ----%% %-- %%%% %%%%%%%%|||||||||----------| |||||||||----------
 X X XX XX|||----|||||X  X  XX XX|||||-- --|||  XXXXX X     X |||||||||||  |||||------|||||   XXXX XXX  X X||||----||| X    XX    XXXX   XX ||||--|||||||||||||| X  XXX  X X  X X XX  X XX   XXXXX   X X