--------------------------------------------------------------------------------------------------------------------------------------------------------------------------------------------------------
--------------------------------------------------------------------------------------------------------------------------------------------------------------------------------------------------------
--------------------------------------------------------------------------------------------------------------------------------------------------------------------------------------------------------
--------------------------------------------------------------------------------------------------------------------------------------------------------------------------------------------------------
--------------------------------------------------------------------------------------------------------------------------------------------------------------------------------------------------------
--------------------------------------------------------------------------------------------------------------------------------------------------------------------------------------------------------
--------------------------------------------------------------------------------------------------------------------------------------------------------------------------------------------------------
--------------------------------------------------------------------------------------------------------------------------------------------------------------------------------------------------------
---------------------------------------------------------------------------SS---------------------g-----------------------------------------------------------------------------------------------------
-------------------------------------------------------------------------ggkgkgg------------------------------------------------------%%%%%%%%------%%%%%%%---------------------------------------------
-----------------------------------------------------------------------r--------------------------------------------------------------||||||||------|||||||---------------------------------------------
-------------------------------------------------------------%%%%%%%%%%%--------%%%%%%%%%%%%%%-------%%%%%------------------g-----r---||||||||----%%%%%%%%%%%%%-kk-------k------------------------------
--------------------------------%%%%%%-----------------------|||||||||||--------||||||||||||||-------|||||------gg----g---------------||||||||----|||||||||||||------------------tt---------------------
--------------------------g-g--g||||||-----------------------|||||||||||%%%%%%%%||||||||||||||-----%%%%%%%%-----------------%%%%%%%%%%%%%%%%%%%%%%|||||||||||||%%%%%%%%%%%%%%----tt------------%%%    %%
------%%%%%---------------------|XXXXX-------%%%----%%%%%%%%%|||||||||||||||||||||||||||||||||-----||||||||----%%%%%%%%%%%%%|||||||||||||||||||||||||||||||||||||||||||||||||----tt--%%%%%%%%%%|||||| ||
XXXXXX|||||XXXXXXXXXXXXXX-----XXXXXXXXXX-----|||----||||||||||||||||||||||||||||||||||||||||||-----||||||||----||||||||||||||||||||||||||||||||||||||||||||||||||||||||||||||XXXXXXXX|||||||||||||||||||