--------------------------------------------------------------------------------------------------------------------------------------------------------------------------------------------------------
--------------------------------------------------------------------------------------------------------------------------------------------------------------------------------------------------------
--------------------------------------------------------------------------------------------------------------------------------------------------------------------------------------------------------
--------------------------------------------------------------------------------------------------------------------------------------------------------------------------------------------------------
--------------------------------------------------------------------------------------------------------------------------------------------------------------------------------------------------------
--------------------------------------------------------------------------------------------------------------------------------------------------------------------------------------------------------
--------------------------------------------------------------------------------------------------------------------------------------------------------------------------------------------------------
--------------------------------------------------------------------------------------------------------------------------------------------------------------------------------------------------------
--------------------------------------------------------------------------------------------------------------------------------------------------------------------------------------------------------
------------------------------------------------------------------------------------------------------------------------------------------------------------------Tt------------------------------------
-----------------------------------------------------Tt---------------------------------------------------------------------------------------------Tt------------tt------------------------------------
-----------------------------------------------------tt----------K-----%%%%----------------------------------%%%%%---------------- -----------------tt--G---------tt------------------------------------
-------------------KK--------------------------------tt---------%%%%%-%%%||----------------------------------|||||----------------%---%%%%%%%%%-----tt%%%%%-------tt--G------------------------------G--
------------------%%%%%%%%%%%---------------------%%%%%%%%%-----|||||-|||||----------%%%%%-------------------|||||---G------K-----|---|||||||||--%%%%%%%%||--%%%%%%%%%%%%-----------K-----------UC -- %%
------%%%%%%%%%%--|||||||||||---------------------|||||||||-----|||||-|||||----------|||||-------------------|||||-%%%%%%-%%%-----|---|||||||||--||||||||||--||||||||||||--------%%%%%---%%%%--------|||
XXXXXX||||||||||XXXXXXXXXXXXXXXXXXXXXXXXXXXXXXXXXX|||||||||XXXXX|||||XXXXXXXXXXXXXXXXXXXXXXXXXXXXXXXXXXXXXXXXXXXXXX||||||X|||XXXXXXXXX|||||||||XX||||||||XXXXXXXXXXXXXXXXXXXXXXXX|||||---||||XXXXX   |||