--------------------------------------------------------------------------------------------------------------------------------------------------------------------------------------------------------
--------------------------------------------------------------------------------------------------------------------------------------------------------------------------------------------------------
--------------------------------------------------------------------------------------------------------------------------------------------------------------------------------------------------------
--------------------------------------------------------------------------------------------------------------------------------------------------------------------------------------------------------
--------------------------------------------------------------------------------------------------------------------------------------------------------------------------------------------------------
--------------------------------------------------------------------------------------------------------------------------------------------------------------------------------------------------------
--------------------------------------------------------------------------------------------------------------------------------------------------------------------------------------------------------
------------------------------------------------------------------------------------------------------------------------------------------------%%%%%%%-------------------------------------------------
-------------------------------------------------------------g-----%%%%%%%%--------------------------------CSS---------------g--r-r-------------|||||||-------------------------------------------------
--------------------------------------2CU2SSCSS-%%%%%%%%%%%%-------||||||||------------------------------kggkggkg-------------------------------|||||||------------r------------------------------------
------------------------------------------------||||||||||||-------||||||||------------tt--------------r----------------------------------------|||||||-------------------------------------------------
--------------------------------UCCSSS----------||||||||||||-------||||||||------------Tt---%%%%%%%%%%%%---------%%%%%%%%%%%-----------tt-----%%%%%%%%%%%%-------%%%%%%%--------------------------------
------------------------------------------------||||||||||||-----%%%%%%%%%%%%%%-g------ttg--||||||||||||---------|||||||||||-----------tt-----||||||||||||-------|||||||--------------------------------
------------------------------------------------||||||||||||-----||||||||||||||---%%%%%%%%%%||||||||||||%%%%%%%%%|||||||||||-----------tt-----||||||||||||-------|||||||------%%%%%%%-------------------
------%%%%%-------------------------------------||||||||||||-----||||||||||||||---||||||||||||||||||||||||||||||||||||||||||-----%%%%%%%%%%%%%||||||||||||-------|||||||------|||||||-------------------
XXXXXX|||||XXXXXXXXXXXXXXXXXXXXXXXXXXXXXXXXXXXXX||||||||||||-----||||||||||||||---||||||||||||||||||||||||||||||||||||||||||-----|||||||||||||||||||||||||-----XXXXXXXXXXXXXXXXXXXXXXXXXXXXXXXXXXX    XX