-----------------------------------------------------------------------------------------------------------------------------------------------        -------------------------------------------------
-----------------------------------------------------------------------------------------------------------------------------------------------        -------------------------------------------------
-----------------------------------------------------------------------------------------------------------------------------------------------        -------------------------------------------------
-----------------------------------------------------------------------------------------------------------------------------------------------        -------------------------------------------------
-----------------------------------------------------------------------------------------------------------------------------------------------        -------------------------------------------------
-----------------%%%%--------------------------------------------------------------------------------------------------------------------------        -------------------------------------------------
-----------------||||--------------------------------------------------------------------------------------------------------------------------        -------------------------------------------------
-----------------||||----------------y---y-----------------------------------------------------------------------------------------------------        -------------------------------------------------
-----------------||||y---------------%%%%%%%---------------------------------------------------------------------------------------------------        -------------------------------------------------
-----------------|%%%%%--------------|||||||---------------------------------------------------------------------tt----------------------------        -------------------------------------------------
-----------------||||||--------------|||||||---------------------------------------------------------------------tt--Tt------------------------        -------------------------------------------------
--------------%%%%%%|||------g-K-r---|||||||----------------#--#-------------------------------------------------tt--tt------------------------        -------------------------------------------------
--------------|||||||||---%%%%%%%%%--||||||%%%-------------##--##------------%%%%%%%--------------------------%%%%%%%%%%---------%%%%--%%%%----        -------------------------------------------------
--------------|||||||||---|||||||||--|||||||||------------###--###--%%%---%%%|||||||%%%%%---------------------||||||||||%%%---%%%||||--||||----        -------------------------------------------------
--------------|||y|||k|---|||||||||--|||||||g|--%%%%--%%%%%%%--%%%%%|||---|||||||||||||||---------------------|||||||||||||---|||||||--||||%%%%        %%%%%%%%%%%%%%%%%%%%%%%%%%%%%%%%%%%%%%%%%%%%%%%%%
XXXXXXXXXXXXXXXXXXXXXXXXXX|||||||||XXXXXXXXXXXXX||||--|||||||--||||||||---|||||||||||||||XX--XXXXX--XXXXXXXXXX|||||||||||||---|||||||--||||||||        |||||||||||||||||||||||||||||||||||||||||||||||||