--------------------------------------------------------------------------------------------------------------------------------------------------------------------------------------------------------
--------------------------------------------------------------------------------------------------------------------------------------------------------------------------------------------------------
--------------------------------------------------------------------------------------------------------------------------------------------------------------------------------------------------------
--------------------------------------------------------------------------------------------------------------------------------------------------------------------------------------------------------
--------------------------------------------------------------------------------------------------------------------------------------------------------------------------------------------------------
--------------------------------------------------------------------------------------------------------------------------------------------------------------------------------------------------------
--------------------------------------------------------------------------------------------------------------------------------------------------------------------------------------------------------
--------------------------------------------------------------------------------------------------------------------------------------------------------------------------------------------------------
---------------------------------------------------Tt---------------------------------------------------------------------------------------------------------------------------------------------------
---------------------------------------------------tt-----------------------Tt--------------------------------------------------------------------------Tt----------------------------------------------
---------------------------------------------------tt-----------------------tt--------------------------------------------------------------------------tt----------------------------------------------
-------CUU2S-----------G---------------------------tt----------%%%%%%-----G-tt---------------------------------------------------- -------------------G-tt----------------------------------------------
--------------------U2S2-----------G-----------K%%%%%%%%%%-----||||||----%%%%%%%%------------K----G--------C22U-------------------%-----------------%%%%%%%%%%---------------------------UCCSC---------G
---------------------------------%%%%%------%%%%||||||||||-%%%%||||||----||||||||------------US%%%%---%%%%%-----------------------|-----------------||||||||||--------------------------------------- %%
---------------------------------|||||------||||||||||||||-||||||||||----||||||||--------------||||---|||||-----------------------|-----------------||||||||||---------------------------------------|||
XXXXXXXXXXXXXXXXXXXXXXXXXXXXXXXXX|||||------||||||||||||||X||||XXXXXXXXXX||||||||XXXXXXXXXXXXXX||||---|||||XXXXXXXXXXXXXXXXXXXXXXXXXXXXXXXXXXXXXXXXXXXXXXXXXXXXXXXXXXXXXXXXXXXXXXXXXXXXXXXXXXXXXXX   |||