--------------------------------------------------------------------------------------------------------------------------------------------------------------------------------------------------------
--------------------------------------------------------------------------------------------------------------------------------------------------------------------------------------------------------
--------------------------------------------------------------------------------------------------------------------------------------------------------------------------------------------------------
--------------------------------------------------------------------------------------------------------------------------------------------------------------------------------------------------------
--------------------------------------------------------------------------------------------------------------------------------------------------------------------------------------------------------
--------------------------------------------------------------------------------------------------------------------------------------------------------------------------------------------------------
--------------------------------------------------------------------------------------------------------------------------------------------------------------------------------------------------------
---------------------------------------------------------------------------------------------------------------------------------------ggkgrkr----------------------------------------------------------
-------------------------------------------------------------------------------------------------------------------------------------r--|||||----------------------------------------%%%%%--------------
-----------------------------------------------------------------------------------------------------------------g-g--g----%%%%%%%%%%%--|||||-%%%%%%%%%%-----------------------------|||||--------------
---------------------------------------------------------------------------------------------------------------------------|||||||||||--|||||-||||||||||%%%%%%%%%%%%%%%%%%%%%%%%-----|%%%%--------------
--------------------------g---g--------------------------------------U---ggggkkgggggggg-------------------------%%%%%%%%%%%|||||||||||%%%%%%%%||||||||||||||||||||||||||||||||||---%%%%%%%%-------------
--------------------------------------------g-----g-------------------------------------------------------------||||||||||||||||||||||||||||||||||||||||||||||||||||||||||||||||---||||||||-------------
------------------------------------------------%%%%%%%----g---------------%%%%%%%%%%--%%%%%%%%%%-----%%%%%%%%%%||||||||||||||||||||||||||||||||||||||||||||||||||||||||||||||||---||||||||-------------
------%%%%%-------------------------------------|||||||--------------------||||||||||--||||||||||-----||||||||||||||||||||||||||||||||||||||||||||||||||||||||||||||||||||||||||---||||||||-------------
XXXXXX|||||XXXXXXXXXXXXXX----XXXXXXXXXXXXXX---XXXXXXXXXXXX-----XXXXXXXXXXXXXXXXXXXXXXXX||||||||||-----||||||||||||||||||||||||||||||||||||||||||||||||||||||||||||||||||||||||||---||||||||XXXXXXX    XX