--------------------------------------------------------------------------------------------------------------------------------------------------------------------------------------------------------
--------------------------------------------------------------------------------------------------------------------------------------------------------------------------------------------------------
--------------------------------------------------------------------------------------------------------------------------------------------------------------------------------------------------------
--------------------------------------------------------------------------------------------------------------------------------------------------------------------------------------------------------
--------------------------------------------------------------------------------------------------------------------------------------------------------------------------------------------------------
--------------------------------------------------------------------------------------------------------------------------------------------------------------------------------------------------------
--------------------------------------------------------------------------------------------------------------------------------------------------------------------------------------------------------
--------------------------------------------------------------------------------------------------------------------------------------------------------------------------------------------------------
--------------------------------------------------------------------------------------------------------------------------------------------------------------------------------------------------------
--------------------------------------------------------------------------------------------------------------------------------------------------------------------------------------------------------
----------------------------------------------KG-K--------------------------------------------------------------------------------------------------------Tt--------------------------Tt----------------
---------------------------------------------Tt%%%%%%%%--------------------------------------%%% ---------------------------------F-----------------------tt--------------G-----------tt----------------
-----------------------S2SS2-----------------tt||||||||-%%%---%%%----------------------------||||-------%%------------------------%-----------------------tt--------------%%%%--------tt----K---------K-
---------------------------------------------tt||K|||||-|||---|||----------------------------||||-------||------G-----------------% %%%%% % %%------------ t--------------||||----%%%%%%%%%%%---------%%
----------------------------%% %-----%% %%%% %%%%%%||||-|||---|||------%%%------%%%%%--------||||------%%% %%%%%%-----------------||||||||||||-------%% % %%%%%-----------||||----|||||||||||---------||
 XXXXXXXXXXXXXXXXX XXXXXXXXX||||-----||||||||||||||X XXX|||---|||XXXXX |||------|||||XX XXXXXX XXXXXXX ||||||||||XXXXXXXXXXXXXX  X||||||||||||XXXX XX||||||||||XXXXXXXXXXX||||  XXXXX X XXXXXXXXXXXXXX||