--------------------------------------------------------------------------------------------------------------------------------------------------------------------------------------------------------
--------------------------------------------------------------------------------------------------------------------------------------------------------------------------------------------------------
--------------------------------------------------------------------------------------------------------------------------------------------------------------------------------------------------------
--------------------------------------------------------------------------------------------------------------------------------------------------------------------------------------------------------
--------------------------------------------------------------------------------------------------------------------------------------------------------------------------------------------------------
--------------------------------------------------------------------------------------------------------------------------------------------------------------------------------------------------------
--------------------------------------------------------------------------------------------------------------------------------------------------------------------------------222SC2S2C---------------
--------------------------------------------------------------------------------------------------------------------------------------------------------------------------------------------------------
----------------------------------------------------------------------------------------------------------------------------------------------------------------------------------------g---------------
--------------------------g-----------------------------------------------------------------------------g--g-----g-------------------------U------------------------------------------------------------
--------------------------------g------------------------------------------------------------------------------------------------------------------------------------%%%%%%%%%%%%%%%%%%%%%%-------------
-------------------------------------------------------------------------------gggkggggkgk-----------------------------------------------------ggggkggkgk------------||||||||||||||||||||||-------------
------------------------------%%%%%----------------------%%%%%%-----------------%%%%%%%%%-------------------%%%%%%%------------------------------||||||--------------||||||||||||||||||||||%%%%%%%    %%
-----------------------------%%%|||--------gg--------gg--||||||--------------r--|||||||||-%%%%%%%%%%%%%----%%%%||||---%%%%%%%%%-----%%%%%%%%%%%--||||||--%%%%%%%%%%%%|||||||||||||||||||||||||||||||| ||
------%%%%%------------------||||||----------------------||||||---%%%%%%%%%%%%--|||||||||-|||||||||||||----||||||||---|||||||||-----|||||||||||--||||||--|||||||||||||||||||||||||||||||||||||||||||||||
XXXXXX|||||XXXXXXXXXXXXXX---XXXXXXXXX-----XXXXXXXX-----XXXXXXXXXXX||||||||||||XXXXXXXXXXXX|||||||||||||---XXXXXXXXXXXX|||||||||-----|||||||||||XXXXXXXXXX|||||||||||||||||||||||||||||||||||||||||||||||