--------------------------------------------------------------------------------------------------------------------------------------------------------------------------------------------------------
--------------------------------------------------------------------------------------------------------------------------------------------------------------------------------------------------------
--------------------------------------------------------------------------------------------------------------------------------------------------------------------------------------------------------
--------------------------------------------------------------------------------------------------------------------------------------------------------------------------------------------------------
--------------------------------------------------------------------------------------------------------------------------------------------------------------------------------------------------------
--------------------------------------------------------------------------------------------------------------------------------------------------------------------------------------------------------
--------------------------------------------------------------------------------------------------------------------------------------------------------------------------------------------------------
--------------------------------------------------------------------------------------------------------------------------------------------------------------------------------------------------------
--------------------------------------------------------------------------------------------------------------------------------------------------------------------------------------------------------
--------------------------------------------------------------------------------------------------------------------------------------------------------------------------------------------------------
----------------------------------------------------------------------------Tt---------------------Tt---------Tt------------Tt--------------------------------------------------------------------------
--------------------------------------------------------------------%%%%----tt---------------------tt-------G-tt------------tt---- ---------------------------------------------------------------------
--------------K--------------------------------------------K--------||||----tt-----------G---------tt-----%%%%%t----G-------tt----%--------%%%----%%%---%%%-------------------------------------------K-
-------------%%%---------------%%%%%-----------------%%%%%%%%%%-----||||----tt---G---%%%%%----%%%%%%%%%%%-|%%%%%%%%%%--%%%%%%%%%%-|--------|||----|||---|||-----------------------------------------  %%
-------------|||---------------|||||-----------------||||||||||-----|||%%%%%%%%%%%---|||||----|||||||||||-|||||||||||--||||||||||-|--------|||----|||---|||-----------%%%%%-----%%%-----------------||||
XXXXXXXXXXXXX|||XXXXXXXXXXXXXXX|||||XXXXXXXXXXXXXXXXXXXXXXXXXXXXXXXXXXX|||||||||||XXXXXXXXXXXX|||||||||||XXXXXXXXXXXXXXXXXXXXXXXXXXXXXXXXXXXXXXXXX|||---|||XXXXXXXXXXX|||||-----|||XXXXXXXXXXXXXXX  ||||