--------------------------------------------------------------------------------------------------------------------------------------------------------------------------------------------------------
--------------------------------------------------------------------------------------------------------------------------------------------------------------------------------------------------------
--------------------------------------------------------------------------------------------------------------------------------------------------------------------------------------------------------
--------------------------------------------------------------------------------------------------------------------------------------------------------------------------------------------------------
--------------------------------------------------------------------------------------------------------------------------------------------------------------------------------------------------------
--------------------------------------------------------------------------------------------------------------------------------------------------------------------------------------------------------
--------------------------------------------------------------------------------------------------------------------------------------------------------------------------------------------------------
--------------------------------------------------------------------------------------------------------------------------------------------------------------------------------------------------------
-------------------------------U------------------------------------------------------------------------------------------------------------k-----------------------------------------------------------
---------------------------------------------------------g---------------------%%%%%%%------------------------------------------------------------------------------------------------------------------
-------------------------------------%%%%%%%-----------------------------------|||||||---------------------------------------------------------------------------------------------------------%%%    %%
-----------------------------------gkggkgggggg-------------------g---r---------|||||||----------------------------------CS------------------------%%%%%%%----------------SSSCSS--%%%%%%%%%%%%%%|||||| ||
-------------------------%%%%%%%%%%--|||||||-----------------------------------|||||||---------------------------------------%%%%%%%%%%%%%%-------|||||||------------------------|||||||||||||||||||||||
-------------------------||||||||||--|||||||--%%%%%%%%%%----%%%%%%%%%%%%%%---%%%%%%%%%%%%%-----------------k---rr%%%---------||||||||||||||-----%%%%%%%%%%%%-----%%%%%-----------|||||||||||||||||||||||
------%%%%%--------------||||||||||--|||||||--||||||||||----||||||||||||||---|||||||||||||---%%%%%%%%%%%%%-----|||||---------||||||||||||||-----||||||||||||-----|||||-----------|||||||||||||||||||||||
XXXXXX|||||XXXXXXXXXXXXXX||||||||||XXXXXXXXXXX||||||||||----||||||||||||||---|||||||||||||---|||||||||||||---XXXXXXXXXXXXXXXX||||||||||||||-----||||||||||||---XXXXXXXXXXXXXXXXXX|||||||||||||||||||||||