--------------------------------------------------------------------------------------------------------------------------------------------------------------------------------------------------------
--------------------------------------------------------------------------------------------------------------------------------------------------------------------------------------------------------
--------------------------------------------------------------------------------------------------------------------------------------------------------------------------------------------------------
--------------------------------------------------------------------------------------------------------------------------------------------------------------------------------------------------------
--------------------------------------------------------------------------------------------------------------------------------------------------------------------------------------------------------
--------------------------------------------------------------------------------------------------------------------------------------------------------------------------------------------------------
------------------------------------------------------------------------------------------------------------------------------CSCSCSCUSS--%%%%%%%%%%%%%%------------------------------------------------
------------------------------------------------------------------------------------------------------------------------------------------||||||||||||||------------------------------------------------
------------------------------------------------------------------------------------------------------------------------SSUCC-------------||||||||||||||-------------------SSS--------------------------
----------------------------------------------------------------------------------SCSS2---------------------------------------------------||||||||||||||--------------------------2SS-------------------
--------------------------------------------------------------------------------gggggkrrk----------------k--------------------------------||||||||||||||----%%%%%%%%%%%%--------------------------------
------------------------------------------------------------------------------r-----------------------------------------------------------||||||||||||||----||||||||||||----------------%%%%%%%%%%    %%
---------------------------------tt---------%%%%%%---------------%%%%%%%%%%%%%%----------%%%%%%%%%%-----%%%%%%%%%%%%%%%%%%%%%-------------||||||||||||||----||||||||||||%%%%%%%%--------||||||||||||| ||
---------------------------------tt---------||||||---gg-----g----||||||||||||||----------||||||||||-----|||||||||||||||||||||%%%%%%%%%%%%%||||||||||||||----||||||||||||||||||||%%%%%%%%||||||||||||||||
------%%%%%----------------------tt---------||||||---------------||||||||||||||%%%%%%%%%%||||||||||-----||||||||||||||||||||||||||||||||||||||||||||||||----||||||||||||||||||||||||||||||||||||||||||||
XXXXXX|||||XXXXXXXXXXXXXX---XXXXXXXXXXX---XXXXXXXXXX----XXXXXXXXX||||||||||||||||||||||||||||||||||-----||||||||||||||||||||||||||||||||||||||||||||||||----||||||||||||||||||||||||||||||||||||||||||||