--------------------------------------------------------------------------------------------------------------------------------------------------------------------------------------------------------
--------------------------------------------------------------------------------------------------------------------------------------------------------------------------------------------------------
--------------------------------------------------------------------------------------------------------------------------------------------------------------------------------------------------------
--------------------------------------------------------------------------------------------------------------------------------------------------------------------------------------------------------
--------------------------------------------------------------------------------------------------------------------------------------------------------------------------------------------------------
--------------------------------------------------------------------------------------------------------------------------------------------------------------------------------------------------------
--------------------------------------------------------------------------------------------------------------------------------------------------------------------------------------------------------
-------------------------------------------------Tt-----------------------------------------------------------------------------------------------------------------------------------------------------
-------------------------------------------------tt-----------------------------------------------------------------------------------------------------------------------------------------------------
-------------------------------------------------tt-----------------------------------------------------------------------------------------------------------------------------------------------------
-------------------------------------------------tt-----------------------------------------------------------------------------------------------------------------------------------------------------
----------------------------------------------%%%%%%%%%-----------------G------%%%%%%-%%%%--K-------------------------------------F----------K----------------------------------------------------------
-------------------%%%%%------%%%----%%%------|||||||||-CC22S-%%%%---%%%%%-----|||K||-||||--%%%%%------%%%---G--------------------%---------U2CUUCS--K--------K----2U2UU--G-----------------------%%%%%-
-------------------|||||------|||----|||------|||||||||-------||||---|||||-----||%%%%%%%%%--|||||------|||%%%%%---%%%%------------|-----------%%%---%%%%--%%%%%---------%%%%----%%%-------------F-|||||-
-------------------|||||------|||----|||------|||||||||-------||||---|||||-----|||||||||||--|||||------||||||||---||||------------|-----------|||---||||--|||||---------||||----|||------------- -|||||-
XXXXXXXXXXXXXXXXXXX|||||------|||XXXXXXXXXXXXXXXXXXXXXXXXXXXXX||||---|||||XXXXXXXXXXXXXXXXXX|||||------||||||||---||||XXXXXXXXXXXXXXXXXXXXXXXXXXXXXX||||--|||||XXXXXXXXX||||----|||XXXXXXXXXXXXXXX|||||X