--------------------------------------------------------------------------------------------------------------------------------------------------------------------------------------------------------
--------------------------------------------------------------------------------------------------------------------------------------------------------------------------------------------------------
--------------------------------------------------------------------------------------------------------------------------------------------------------------------------------------------------------
--------------------------------------------------------------------------------------------------------------------------------------------------------------------------------------------------------
--------------------------------------------------------------------------------------------------------------------------------------------------------------------------------------------------------
--------------------------------------------------------------------------------------------------------------------------------------------------------------------------------------------------------
--------------------------------------------------------------------------------------------------------------------------------------------------------------------------------------------------------
--------------------------------------------------------------------------------------------------------------------------------------------------------------------------------------------------------
--------------------------------------------------------------------------------------------------------------------------------------------------------------------------------------------------------
----------------------------------------------------------------------------------------Tt--------------------------------------------------------------------------------------------------------------
----------------------------------------------------------------------------------------tt--------------------------------------------------------------------------------------------------------------
---------------------------------------------------------G----------K------K------------tt--------------------C-------------------F---------------------------------------------------------------------
-----------%%%%%%%%%%%----------G-----G-------------%%%%-%%%%%---%%%%%----2UCS-%%%%---G-tt--G-------------------------K-----------%----G%%%-------------------------------------------------------------
-----------|||||||||||-%%%%%--%%%%--%%%------%%%----||||-|||||---|||||2--------||||--%%%%%%%%------------------%%%%%--%%%%------%%%%%%%%%||-------%%%%%---------------------------------------------%F%%
-----------|||||||||||-|||||--||||--|||------|||----||||-|||||---|||||---------||||--||||||||------------------|||||--||||------|||||||||||-%%%%%%|||||---------------------------------------------| ||
XXXXXXXXXXXXXXXXXXXXXXX|||||--||||XX|||------|||XXXX||||X|||||---|||||XXXXXXXXX||||XX||||||||XXXXXXXXXXXXXXXXXX|||||--||||XXXXXX|||||||||XXX||||||XXXXXXXXXXXXXXXXXXXXXXXXXXXXXXXXXXXXXXXXXXXXXXXXXXXXXX