--------------------------------------------------------------------------------------------------------------------------------------------------------------------------------------------------------
--------------------------------------------------------------------------------------------------------------------------------------------------------------------------------------------------------
--------------------------------------------------------------------------------------------------------------------------------------------------------------------------------------------------------
--------------------------------------------------------------------------------------------------------------------------------------------------------------------------------------------------------
--------------------------------------------------------------------------------------------------------------------------------------------------------------------------------------------------------
--------------------------------------------------------------------------------------------------------------------------------------------------------------------------------------------------------
--------------------------------------------------------------------------------------------------------------------------------------------------------------------------------------------------------
--------------------------------------------------------------------------------------------------------------------------------------------------------------------------------------------------------
--------------------------------------------------------------------------------------------------------------------------------------------------------------------------------------------------------
--------------------------------------------------------------Tt---------------Tt-------------------------------------------------------------Tt--------------------------------------------------------
--------------------------------------------------------------tt---------------tt-----------Tt-G-------------------------------Tt-------------tt--------------------------------------------------------
--------------------------%%%%%%%%%%%-------------------------tt-------%%%%%%%%Tt-----------tt%%%%%%%%%------------------------tt- -----------tt-------G------------------------------------------------
-------------------------%%%%%%%%||||-------------------------tt-------||||||||tt-----------tt|||||||||----%%%%%%%%%%%---------tt-%-----------tt-----SUUU-----------------------------------------------
-------------------------||||||||||||--------------------%%%%%%%%%%%%--|||%%%%%%%%%%%%--%%%%%%%%%||||||----|||||||||||-----%%K%tt%%%%----%%%%%%%%%%%-------CU-------------------------------------------
--------------%%%---%%%--||||||||||||%%%%------%%%%%--%%%||||||||||||--|||||||||||||||--|||||||||||||||----|||||||||||----%%%%%%%%%%%----|||||||||||------------------------------------------------  %%
XXXXXXXXXXXXXX|||---|||XXXXXXXXXXXXXX||||XXXXXX|||||--|||||||||||||||XXXXXXXXXXXXXXXXXXX|||||||||XXXXXXXXXX|||||||||||XXXX|||||||||||XXXXXXXXXXXXXXXXXXXXXXXXXXXXXXXXXXXXXXXXXXXXXXXXXXXXXXXXXXXXX  ||||