--------------------------------------------------------------------------------------------------------------------------------------------------------------------------------------------------------
--------------------------------------------------------------------------------------------------------------------------------------------------------------------------------------------------------
--------------------------------------------------------------------------------------------------------------------------------------------------------------------------------------------------------
--------------------------------------------------------------------------------------------------------------------------------------------------------------------------------------------------------
--------------------------------------------------------------------------------------------------------------------------------------------------------------------------------------------------------
--------------------------------------------------------------------------------------------------------------------------------------------------------------------------------------------------------
--------------------------------------------------------------------------------------------------------------------------------------------------------------------------------------------------------
--------------------------------------------------------------------------------------------------------------------------------------------------------------------------------------------------------
--------------------------------------------------------------------------------------------------------------------------------------------------------------------------------------------------------
------------------------------------------------------------------------------------------------Tt------------------------------------------------------------------------------------------------------
------------------------------------------------------------------------------------------------tt-------------------------------K--------------------------------------------G-------------------------
-----------------------------------------------------------K------------------------------------tt--------------------------SU2222 -------------------------------------------%%%%%%--------------------
------------------------------------------------%%%%------%%%%------------------------------%%%%%%%%%%----------------------------%-------------------------------------------||||||----------------G---
------------------------------------------------||||------||||------------------------------||||||||||----------------------------|-------%%%%%%%%%---------------------------||||||---------%%%%%    %-
----------------%%%----%%%%---------------------||||------||||------------------------------||||||||||----------------------------|-------|||||||||---------------------------||||||---------||||||||||-
XXXXXXXXXXXXXXXX|||----||||XXXXXXXXXXXXXXXXXXXXX||||------||||XXXXXXXXXXXXXXXXXXXXXXXXXXXXXXXXXXXXXXXXXXXXXXXXXXXXXXXXXXXXXXXXXXXXXXXXXXXX|||||||||XXXXXXXXXXXXXXXXXXXXXXXXXXXXXXXXXXXXXXXXXX||||||||||X