--------------------------------------------------------------------------------------------------------------------------------------------------------------------------------------------------------
--------------------------------------------------------------------------------------------------------------------------------------------------------------------------------------------------------
--------------------------------------------------------------------------------------------------------------------------------------------------------------------------------------------------------
--------------------------------------------------------------------------------------------------------------------------------------------------------------------------------------------------------
--------------------------------------------------------------------------------------------------------------------------------------------------------------------------------------------------------
--------------------------------------------------------------------------------------------------------------------------------------------------------------------------------------------------------
--------------------------------------------------------------------------------------------------------------------------------------------------------------------------------------------------------
--------------------------------------------------------------------------------------------------------------------------------------------------------------------------------------------------------
-----------------------------------------------Tt------------------------------------------------------------------------------------------------------------------------------------------------------T
-----------------------------------------------tt------------------------------------------------------------------------------------------------------------------------------------------------------t
-----------------------------------------------tt------------------------------------------------------------------------------------------------------------------------------------------------------t
--------C2-------------G----------------------- t-----------------------------%%%---------G----------% %%%%%%%--------------------F-----U22S ----- t------------------------------------G------%%%%%-KKt
--------------------%%%%% %% %%%%%%%-- %%-%%% %%%%%%---% %%%------------------||%%  %%%%%%%----------|||||||||--------------------%---------------tt------------------------- %%%% %%%%  C-----||||%% %%
--------------------||||||||||||||||--|||-||||||||||---|||||------------------|||||||||||||G---------|||||||||--------------------|%%%%%%% %---GK- t-------------------------|||||||||||-------|||||||||
--------------------||||||||||||||||--|||-||||||||||---|||||------------------||||||||||||%% %%%%%%%-|||||||||--------------------||||||||||-%%%%%%%%%%----------------------|||||||||||-------|||||||||
 XXXX XX X  XX XX X ||||||||||||||||--|||X XXXXXX XXXXX XXXXXX  XXXXXXXX XXXXXX XXXXXXXXX ||||||||||XXX  X XXXXXXXXXXX XXX  X XXXXXX XX XXXXX||||||||||XXXXXXXXXXX XXXXXXXXXX||||||||||| XXXXXXXXXX  XXX