--------------------------------------------------------------------------------------------------------------------------------------------------------------------------------------------------------
--------------------------------------------------------------------------------------------------------------------------------------------------------------------------------------------------------
--------------------------------------------------------------------------------------------------------------------------------------------------------------------------------------------------------
--------------------------------------------------------------------------------------------------------------------------------------------------------------------------------------------------------
--------------------------------------------------------------------------------------------------------------------------------------------------------------------------------------------------------
--------------------------------------------------------------------------------------------------------------------------------------------------------------------------------------------------------
--------------------------------------------------------------------------------------------------------------------------------------------------------------------------------------------------------
--------------------------------------------------------------------------------------------------------------------------------------------------------------------------------------------------------
--------------------------------------------------------------------------------------------------------------------------------------------------------------------------------------------------------
--------------------------------------------------------------------------------------------------------2SCSS2----------------------------------------------------------------------%%%%%---------------
-------------------------------------------------------------------------------------------------------gggkgkggkg----------%%%%%%%%%%%%%%-------------------------r---------r-------|||||--%%%%%%%    %%
-----------------------------------------------------------------------------------------------------r---------------------||||||||||||||-------------------------------------------|||||--|||||||||| ||
--------------------------------%%%%%%%-----------%%%%%%%------------------g-----g--g----%%%%%%%%%%%%%-----------%%%%%%%%%%||||||||||||||-gg-------r-------------%%%%%%%%%%%%%%---%%%%%%%%%|||||||||||||
--------------------------g-----|||||||-----------|||||||--------------------------------|||||||||||||-----------||||||||||||||||||||||||------------%%%%%%%%%%%%||||||||||||||---||||||||||||||||||||||
------%%%%%---------------------|||||||-----------|||||||--------------------------------|||||||||||||%%%%%%%%%%%||||||||||||||||||||||||%%%%%%%%%%%%||||||||||||||||||||||||||---||||||||||||||||||||||
XXXXXX|||||XXXXXXXXXXXXXX-----XXXXXXXXXXXXX-----XXXXXXXXXXXX---XXXXXXXXXXX----XXXXXXXXXXX||||||||||||||||||||||||||||||||||||||||||||||||||||||||||||||||||||||||||||||||||||||---||||||||||||||||||||||