--------------------------------------------------------------------------------------------------------------------------------------------------------------------------------------------------------
--------------------------------------------------------------------------------------------------------------------------------------------------------------------------------------------------------
--------------------------------------------------------------------------------------------------------------------------------------------------------------------------------------------------------
--------------------------------------------------------------------------------------------------------------------------------------------------------------------------------------------------------
--------------------------------------------------------------------------------------------------------------------------------------------------------------------------------------------------------
--------------------------------------------------------------------------------------------------------------------------------------------------------------------------------------------------------
--------------------------------------------------------------------------------------------------------------------------------------------------------------------------------------------------------
------------------------Tt------------------------------------------------------------------------------------------------------------------------------------------------------------------------------
------------------------tt------------------------------------------------------------------------------------------------------------------------------------------------------------------------------
------------------------tt--------Tt--------------------------------------------------------------Tt----------------------------------------------------------------------------------------------------
------------------------tt--------tt------------------------------------------Tt------------------tt----------------------------------------------------------------------------K-----------------------
--------------------%%%%%%%%%%----tt--------------------K---------------------tt---------------GG-tt-------------------G---------- ------G--------------------------------------%%%---------------------
--------------------||||||||||----tt----------------US2US---------------------tt--------G-----%%%%%%%%%%------K-------U2C---------%----%%%-----------------------------%%%---%%%%%|---------------------
--------------------|||||||||CC%%%%%%%%---------------------------------------tt---KCU22S-----||||||||||-----%%%%-----------2S2SS-|----|||----------------------------%%%%%%%||||||---------CS%%%--   --
--------------------||||||||||-||||||||------------------------------------%%%%%%%%%----------||||||||||-----||||-----------------|----|||-------------%%%%%%%%%%-----|||||||||||||-----------|||--|||--
XXXXXXXXXXXXXXXXXXXXXXXXXXXXXXX||||||||XXXXXXXXXXXXXXXXXXXXXXXXXXXXXXXXXXXX|||||||||XXXXXXXXXXXXXXXXXXXXXXXXX||||XXXXXXXXXXXXXXXXXXXXXXXXXXXXXXXXXXXXXX||||||||||XXXXXXXXXXXX|||||XXXXXXXXXXXX|||--|||XX