--------------------------------------------------------------------------------------------------------------------------------------------------------------------------------------------------------
--------------------------------------------------------------------------------------------------------------------------------------------------------------------------------------------------------
--------------------------------------------------------------------------------------------------------------------------------------------------------------------------------------------------------
--------------------------------------------------------------------------------------------------------------------------------------------------------------------------------------------------------
--------------------------------------------------------------------------------------------------------------------------------------------------------------------------------------------------------
--------------------------------------------------------------------------------------------------------------------------------------------------------------------------------------------------------
--------------------------------------------------------------------------------------------------------------------------------------------------------------------------------------------------------
--------------------------------------------------------------------------------------------------------------------------------------------------------------------------------------------------------
-----------Tt-------------------------------------------------------------------------------------------------------------------------------------------------------------------------------------------
-----------tt-------------------------------------------------------------------------------------------------------------------------------------------------------------------------------------------
-----------tt-----------Tt-------------------------------------------------------------------------------------------------G-------------------------------G--------------------------------------------
------%%%%%%%%%---------tt-------------------------------------------------------G---------------------------------------%%%------ ------------------%%%%%%%%%------------------------------------  ----
------|||||||||---------tt-------------------------%%%-----%%%--------%%%%%------%%%%-------CU---------------------------|||--UUC2SS-----------------||||||||%%%%%%%%%-----%%%%%--%%%---------------- %%
------||||%%%%%%%%%%%---tt---G---------------------|||-----|||--------|||||------||||---------------------------%%%%%%%%%%%%-----------------------G-|||||||||||||||||-----|||||--|||----------------|||
------|||||||||||||%%%%%%%%%%%%--------------------|||-----|||--------|||||------||||---------------------------||||||||||||-------------%%%-----%%%%|||||||||||||||||-----|||||--|||----------------|||
XXXXXXXXXXXXXXXXXXX||||||||||||XXXXXXXXXXXXXXXXXXXX|||-----|||XXXXXXXX|||||------||||XXXXXXXXXXXXXXXXXXXXXXXXXXX||||||||||||XXXXXXXXXXXXX|||-----||||XXXXXXXX|||||||||XXXXXXXXXXXX|||XXXXXXXXXXXXX   |||