--------------------------------------------------------------------------------------------------------------------------------------------------------------------------------------------------------
--------------------------------------------------------------------------------------------------------------------------------------------------------------------------------------------------------
--------------------------------------------------------------------------------------------------------------------------------------------------------------------------------------------------------
--------------------------------------------------------------------------------------------------------------------------------------------------------------------------------------------------------
--------------------------------------------------------------------------------------------------------------------------------------------------------------------------------------------------------
--------------------------------------------------------------------------------------------------------------------------------------------------------------------------------------------------------
--------------------------------------------------------------------------------------------------------------------------------------------------------------------------------------------------------
--------------------------------------------------------------------------------------------------------------------------------------------------------------------------------------------------------
--------------------------------------------------------------------------------------------------------------------------------------------------------------------------------------------------------
-----------------------Tt-------------------------------------------------------------------------------------------------------------------------------------------------------------------------------
-----------------------tt-------------------------------------------------------------------------------------------------------------------------------------------------------------------------------
----------------------Ktt-G-----------------------C222S-------------------------USCUU2-------------------------------------------- -------------KGK-------G---------------------------------------------
--------------------%%%%%%%%%%%%%%%%%%%%------------------------------------------------------------------------------------------%-------------%%%------%%%%-----------G-------------------------------
-----------%%%%%%---||||||||||||||||||||----------------------------%%%%%%%%%%%%-------------------2S-----------------------------|-------------|||------||||----------%%%K%%--G-K----------------------
-----------||||||---||||||||||||||||||||----------------------------||||||||||||--------------------------------------------------|%%%%%%-------|||------||||----%%%%%%%%%%%|%%%%%%---------------------
XXXXXXXXXXX||||||XXXXXXXXXXXX|||||||||||XXXXXXXXXXXXXXXXXXXXXXXXXXXX||||||||||||XXXXXXXXXXXXXXXXXXXXXXXXXXXXXXXXXXXXXXXXXXXXXXXXXXX||||||XXXXXXX|||------||||XXXX|||||||||||X||||||XXXXXXXXXXXXXXX    XX