--------------------------------------------------------------------------------------------------------------------------------------------------------------------------------------------------------
--------------------------------------------------------------------------------------------------------------------------------------------------------------------------------------------------------
--------------------------------------------------------------------------------------------------------------------------------------------------------------------------------------------------------
--------------------------------------------------------------------------------------------------------------------------------------------------------------------------------------------------------
--------------------------------------------------------------------------------------------------------------------------------------------------------------------------------------------------------
--------------------------------------------------------------------------------------------------------------------------------------------------------------------------------------------------------
-------------------------------------------------------------------%%%%%-------------------------------------------------------------------------22S----------------------------------------------------
-------------------------------------------------------------------|||||--------------------------------------------------------------------------------------------------------------------------------
-------------------------------------------------------------------|||||-----------------------------------------------------------------------------------%%%%%%%---k--r-------------------------------
----------------------------------UCS2CSSCSCS--%%%%%%%%%%%%%-------|||||-----------------------------------------------------------------------------------|||||||--------------------------------------
----------k------------------------------------|||||||||||||-----%%%%%%%%-----------------------------------------------------------------------%%%%%%-----|%%%%%|----------%%%%%-----------------------
-------------------------------CU--------------|||||||||||||-----||||||||-------------------------------------------------------k---------------||||||-----|||||||----------|||||-----------------------
-----------------------------------------------|||||||||||||-----||||||||------------------------------------------%%%%%%%%---------------------||||||---%%%%%%%%%%%%-------|||||-----------------------
-----------------------------------------------|||||||||||||-----||||||||-------------k-----r----------------------||||||||------------------k--||||||---||||||||||||-----%%%%%%%%----------------------
------%%%%%------------------------------------|||||||||||||-----||||||||-----%%%----------------------------------||||||||-------------------%%%%%%%%%%%||||||||||||-----||||||||----------------------
XXXXXX|||||XXXXXXXXXXXXXXXXXXXXXXXXXXXXXXXXXXXX|||||||||||||-----||||||||-----|||----XXXXXXXXXXXXXXXXXXXXXXXX----XXXXXXXXXXXXXX---XXXXXXXXXXXX|||||||||||||||||||||||-----||||||||XXXXXXXXXXXXXXXX    XX