--------------------------------------------------------------------------------------------------------------------------------------------------------------------------------------------------------
--------------------------------------------------------------------------------------------------------------------------------------------------------------------------------------------------------
--------------------------------------------------------------------------------------------------------------------------------------------------------------------------------------------------------
--------------------------------------------------------------------------------------------------------------------------------------------------------------------------------------------------------
--------------------------------------------------------------------------------------------------------------------------------------------------------------------------------------------------------
--------------------------------------------------------------------------------------------------------------------------------------------------------------------------------------------------------
--------------------------------------------------------------------------------------------------------------------------------------------------------------------------------------------------------
--------------------------------------------------------------------------------------------------------------------------------------------------------------------------------------------------------
---------------Tt---------------------------------------------------------------------------------------------------------------------------------------------------------------------------------------
---------------tt------------------------------------------------------------------------------------------------------------------------------------------------------------------------Tt-Tt----------
---------------tt---------------------------------------------------------------------------------------------------------------Tt--------------------------------------Tt---------------tt-tt----------
------------USSSt--------------------CS2U----------------------G-G----K---------------------------------------------------------ttF-----%%%%%%%%%-----%%Tt%%%%%%%%%-----tt-----------%%%%%%%Tt%%--------
----------%%%%K%%%-%---------%%%--%%%-----------------------CSUC%%%---%%%%-----------------------------------------%%%--%%%-----G%%-----|||||||||-----||tt||||||%%%%-%%%tt%%%%%%%%---|%%%%%%tt%|--------
----------|||%%%%%%%%%%%----%|||%%|||-%%%----------------------C|||---||||-%%%%------------%%%%--------------------|||--|||----%||%%%%%%|||||||||--%%%||tt|||||||||%%|||%%||||||||U2SS|||%%%%%%%%-----F-
----------||||||||||||||----|||||||||-|||-----------------------|||---||||-||||---%%%--%%%%||||----%%%%%------%%%%%|||--|||%%%%%||%%%%|||||||||||--%%%%%%%%%%%%|||||||||||||||||||---||||||||||||----- -
XXXXXXXXXXXXXXXXXXXXXXXXXXXX|||||||||X|||XXXXXXXXXXXXXXXXXXXXXXX|||---||||X||||XXX|||--||||||||XXXX|||||------||||||||--||||||||||||||XXXXXXXXXXXXX||||||||||||XXXX|||||||||||XXXXXXXXXXXXXXXXXXXXXXXXXX