--------------------------------------------------------- ------ -------------------- --------- -------------------------------------------- ----------------------------------------------- -------- --
-------------------------------------------------------------------- --------------------------------------------- --------------------- -------------------------------- --- --------------------------
------------------------ -- ---------- ----- ---------------------------------------------------------- --------------------------------- ----------------------------------------------------------- --
------------------------------------------------------ -------------------------------------------------------------------------------------------------------------------------------  ----------------
- ------  ----------------------------- -------------------------------------------------------------------------------------------------------------------------------------------------- -------------
---------------------------------------------------------------------------------- ---------------------------------------------------------------------------------------------------------- ----------
----------------------------------------------------- --- ------------------ ---------------------------------- - --------------------- ----------------- -------------------------- -------------------
--------------- ------- ---- ------ --------------------- ------------------------------- -- ------------------  ---------------------------------------------------------- ------- --------------------
----------------------------- -----CSSCSS----- ------  ----------- -------------------------------- ----------- -2S CC- -----------------------  ---------------------------------- --------------------
---------------------------------------------- ----------------------------------------------- --- -----tt----- ------ -------------------------------------------------- --------- ---------- ---------
--------------%%%%%---------------- ------------ ------------------------------------- -----------------tt----- %-------------------------- --------------------------------------- --------------------
--------------| |||--------- ------- --------------------------- ---------------#---#-------------------tt----- |--k- -------------------------------------------- ---------------- --------------------
--------------|||||----%% --%%%%%%%%%%%% %--- ---#---------------------- ------ #---##---%%%% %--------%%%%%%%%%%%%%%%% %%%-------------%%%%%%%% %%%% %%%%%%%%%%%%%%%%%%%%%%%%%%%%% %%%%%%%%%%%%%%%%%%%%
--------------||y||gy--|||--||||||||||||||--##---##-- ----- --#---#-----------# #---###--||||||--------||||||||||||||||||||--- --------- |||||||%|||||||||||||||||||||||||||||||||| ||||||||||||||||||||
-------------%%%%%%%%%%|||--| |||||||| |||%%%%-- %%%%%%--%%--##---##-----k--%%% %---%%%%%|| |||--#--#--|||||||||||||||| |||%%%%%---%%%%%| |||||||||||||||||||||||||||||||||||||||||  |||||||||||||||||||
XXXXXX XXXXXX|||||||||||||--||||||||||||||||||---||||||- ||XXXX---XXXXXXXXXX||| |---|||||||||||XXX--XXX|||||||||||||||||||||||||---|||||||||||||||||||||||||||||||||||||||||| ||||| ||||||||||||||||||||