--------------------------------------------------------------------------------------------------------------------------------------------------------------------------------------------------------
--------------------------------------------------------------------------------------------------------------------------------------------------------------------------------------------------------
--------------------------------------------------------------------------------------------------------------------------------------------------------------------------------------------------------
--------------------------------------------------------------------------------------------------------------------------------------------------------------------------------------------------------
--------------------------------------------------------------------------------------------------------------------------------------------------------------------------------------------------------
--------------------------------------------------------------------------------------------------------------------------------------------------------------------------------------------------------
--------------------------------------------------------------------------------------------------------------------------------------------------------------------------------------------------------
------------------------------------------------------------------------------------------------------------------------------------SSCCC2CS------------------------------------------------------------
----------------------------------------------------------------------------------------------------------------------------------gggkkgkggkkg----------------------------------------------------------
------------------------------------------------------CC2SUC-%%%%%%%%%%%%%%-----------------------------------------------------r-----------------------------------------------------------------------
-------------------------------------------------------------||||||||||||||-----g---g---g----%%%%%%%%%%%%%%-------------%%%%%%%%%-------------%%%%%%%%%%%%%--------------------------------------%    %%
-------------------------------------------------CCCU--------||||||||||||||------------------||||||||||||||-------%%%%%-|||||||||-------------|||||||||||||------------------%%%%%--%%%%%%%%%%%%%|||| ||
-------------------------------------------------------------||||||||||||||----%%%%%%%%%%%%%%||||||||||||||-------|||||-|||||||||%%%%%%%%%%%%%|||||||||||||----g-r-----------|||||--||||||||||||||||||||
-------------------------------------------------------------||||||||||||||----||||||||||||||||||||||||||||-----%%%%%%%%|||||||||||||||||||||||||||||||||||------------------|||||--||||||||||||||||||||
------%%%%%--------------------------------------------------||||||||||||||----||||||||||||||||||||||||||||-----|||||||||||||||||||||||||||||||||||||||||||---%%%%%%%%-------|||||--||||||||||||||||||||
XXXXXX|||||XXXXXXXXXXXXXX-----XXXXXXXXXXXXXXXXXXXXXXXXXXXXXXX||||||||||||||----||||||||||||||||||||||||||||-----|||||||||||||||||||||||||||||||||||||||||||---||||||||-----XXXXXXXXX||||||||||||||||||||