--------------------------------------------------------------------------------------------------------------------------------------------------------------------------------------------------------
--------------------------------------------------------------------------------------------------------------------------------------------------------------------------------------------------------
--------------------------------------------------------------------------------------------------------------------------------------------------------------------------------------------------------
--------------------------------------------------------------------------------------------------------------------------------------------------------------------------------------------------------
--------------------------------------------------------------------------------------------------------------------------------------------------------------------------------------------------------
--------------------------------------------------------------------------------------------------------------------------------------------------------------------------------------------------------
--------------------------------------------------------------------------------------------------------------------------------------------------------------------------------------------------------
--------------------------------------------------------------------------------------------------------------------------------------------------------------------------------------------------------
----------------------------------------------------------------------------------------------------------------------------------------------------------------------------------Tt--------------------
-----------------Tt---------------------------------------------------------------------------------------------------------------------------------------------------------------tt--------------------
-----------------tt---------------------------------------------------------------------------------------------------------------------------------------------------------------tt--------------------
-----------------tt------------------------------------SCCU-------------------G-----------------------------------------%-%%%%%%%%F%---------------%%%%%%%%%%--------------------Gtt--------------------
------%%%%%%%%%%-tt----------------------------------------------------%%%%%%%%%%%--------------------------------------|-||||||||%|---------------||||||||||---------UCC-----%%%%%%%%%-----------------
------|||||||%%%%%%%%%%%----------------------K------------------------|||||||||||------------------------------------K-|-||K|||||||---------------||||||||||-----------------|||||||||---------F-------
------||||||||||||||||||-----------%%%------%%%------------------------|||||||||||-----------------------------------%%%%%%%%%||||||---------------||||||||||-----------------|||||||||--------- -------
XXXXXXXXXXXXX|||||||||||XXXXXXXXXXX|||------|||XXXXXXXXXXXXXXXXXXXXXXXX|||||||||||XXXXXXXXXXXXXXXXXXXXXXXXXXXXXXXXXXX|||||||||XXXXXXXXXXXXXXXXXXXXXXXXXXXXXXXXXXXXXXXXXXXXXXXX|||||||||XXXXXXXXXXXXXXXXX