|||||||||||||||||||||||||||||||||||||||||||||||||||||||||||||||||||||||||||||||||||||||||||||||||||||||||||||||||||||||||||||||||||||||||||||||Tt|||||||||||||||||||||||||||||||||||||||||||||||||||||||
|||||||||||||||||||||||||||||||||||||||||Tt||||||||||||||||||||||||||||||||||||||||||||||||||||||||||||||||||||||||||||||||||||||||||||||||||||tt|||||||||||||||||||||||||||||||||||||||||||||||||||||||
|||||||||||||||||||||||||||||||||||||||||tt||||||||||||||||||||||||||||||||||||||||||||||||||||||||||||||||||||||||||||||||||||||||||||||||||||tt|||||||||||||||||||||||||||||||||||||||||||||||||||||||
|||||||||||||||||||||||||||||||||||||||||tt|||||||||||||||||||||||||||||||||||||||||||||||||||||||||||||||||||||||||||||||||||||||||||||||||||Ktt|||||||||||||||||||||||||||||||||||||||||||||||||||||||
||||||||||||||||K|||||||||||||||||||%%%%%%%%%%%|||||||||||||||||||||||||G|||||||||||||||||||||||||||||||%%%%%%%%%%||||||||||||||||F||||||||%%%%%%%%%%|||||||||||||||||||||||||||||||||||||||||||||||||||
||||||||||||||||UC2SS|||||||||||||||||||||||||||||||||||||||||||||||||||SU|||||||||||||||||||||||||G|||||G||||||||||||||||||||||||%|||||||||||K||||||||||||||||||||||||||||||%%%||%%%%||||||||||||||||||
||||||%%%%%%|||||||||||||||||||||||||||||||||||||||||||||||||||||||||||||||||||%%%%||%%%%||||||||%%%%%%%%%%|||||||||||||||||||||||||GK||||222U2|||%%%||||||||||||||||||||||||||||||||||||G||||||||||||||
|||||||||||||||||||||||||||||||||||||||||||||||||||||||||%%%%||||%%%|||||||||||||||||||||||||||||||||||||||||||||||||||||||||||||%%%%%%||||||||||||||||||||||||||||||||||||||||||||||||%%%%|||||%%%%%|||
XXXXXX||||||XXXXXXXXXXXXXXXXXXXXXXXXXXXXXXXXXXXXXXXXXXXXX|||||||||||XXXXXXXXXXX||||||||||XXXXXXXX||||||||||XXXXXXXXXXXXXXXXXXXXXX||||||XXXXXXXXXXXXXXXXXXXXXXXXXXXXXXXXXXXXXX|||||||||X||||||||||||||XXX
