--------------------------------------------------------------------------------------------------------------------------------------------------------------------------------------------------------
--------------------------------------------------------------------------------------------------------------------------------------------------------------------------------------------------------
--------------------------------------------------------------------------------------------------------------------------------------------------------------------------------------------------------
--------------------------------------------------------------------------------------------------------------------------------------------------------------------------------------------------------
--------------------------------------------------------------------------------------------------------------------------------------------------------------------------------------------------------
--------------------------------------------------------------------------------------------------------------------------------------------------------------------------------------------------------
--------------------------------------------------------------------------------------------------------------------------------------------------------------------------------------------------------
--------------------------------------------------------------------------------------------------------------------------------------------------------------------------------------------------------
-------------------------------------------------------------------------------------------------------------CUCSSSSCCSC-%%%%%%%%%%------k---kr---------------------------------------------------------
-------------------------------CSC---------------------------------------------------------------------------------------||||||||||---------------------------------------------------------------------
-------------------------------------------------------------------------------------------------------SSSUS-------------||||||||||-----%%%%%%%%%%%%%%-------%%%%%---------------%%%%-------------------
-----------------------------%%%%%------------------------------------------SUSS---%%%%%%%%%%%%%%------------------------||||||||||-----||||||||||||||-------|||||---------------|%%%%%%----------------
-----------------------------|||||-------------------------------------------------||||||||||||||------------------------||||||||||-----||||||||||||||-------|||||---------------|||||||----------------
-----------------------------|%%%%%---r-------------------------r------------------||||||||||||||------------------------||||||||||-----||||||||||||||-------|||||-------r---k---|||||||--%%%%%%%%    %%
------%%%%%------------------||||||---------------------%%%------------------------||||||||||||||%%%%%%%%%%%-------------||||||||||-----||||||||||||||-----%%%%%%%%-------------%%%%%%%%%%||||||||||| ||
XXXXXX|||||XXXXXXXXXXXXXX---XXXXXXXX---XXXXXXXXXXXX-----|||----XXXXXXXXXXXXXXXXXXXX|||||||||||||||||||||||||XXXXXXXXXXXXX||||||||||-----||||||||||||||-----||||||||-----XXXXXXXX||||||||||||||||||||||||