--------------------------------------------------------------------------------------------------------------------------------------------------------------------------------------------------------
--------------------------------------------------------------------------------------------------------------------------------------------------------------------------------------------------------
--------------------------------------------------------------------------------------------------------------------------------------------------------------------------------------------------------
--------------------------------------------------------------------------------------------------------------------------------------------------------------------------------------------------------
--------------------------------------------------------------------------------------------------------------------------------------------------------------------------------------------------------
--------------------------------------------------------------------------------------------------------------------------------------------------------------------------------------------------------
--------------------------------------------------------------------------------------------------------------------------------------------------------------------------------------------------------
--------------------------------------------------------------------------------------------------------------------------------------------------------------------------------------------------------
----------------------------------------------------------------------------------------------------------------k-----k----------------r----------------------------------------------------------------
----------------------------------------------------------------------------------------C22S2SUSC--%%%%%%%%%%%%-----------------------------------------------------------------------------------------
----------r----------------------------------------------------------------------------------------||||||||||||%%%%%%%%%%%%%--SS2SS---%%%%%%%%%%%-------------------------------------------------------
--------------------------------------------------------------------CSCUC---------S2SU-------------|||||||||||||||||||||||||----------|||||||||||-------------------------k-----r-----------------------
------------------------------%%%------------------------------------------------------------------|||||||||||||||||||||||||----------|||||||||||%%%%%%%%%----------------------------------------------
------------------------------|||----------------k-------------------------------------------------|||||||||||||||||||||||||----------||||||||||||||||||||--------------------------------------F-------
------%%%%%-------------------|||----%%%%%%%%%%%----%%%%%%%%%%%%%----------------------------------|||||||||||||||||||||||||%%%%%%%%%%||||||||||||||||||||----%%%%%%%%%%%----%%%%%%%%----------- -------
XXXXXX|||||XXXXXXXXXXXXXX-----|||----|||||||||||----|||||||||||||XXXXXXXXXXXXXXXXXXXXXXXXXXXXXXXXXX|||||||||||||||||||||||||||||||||||||||||||||||||||||||----|||||||||||----||||||||---XXXXXXXXXXXXXFXX