--------------------------------------------------------------------------------------------------------------------------------------------------------------------------------------------------------
--------------------------------------------------------------------------------------------------------------------------------------------------------------------------------------------------------
--------------------------------------------------------------------------------------------------------------------------------------------------------------------------------------------------------
--------------------------------------------------------------------------------------------------------------------------------------------------------------------------------------------------------
--------------------------------------------------------------------------------------------------------------------------------------------------------------------------------------------------------
--------------------------------------------------------------------------------------------------------------------------------------------------------------------------------------------------------
--------------------------------------------------------------------------------------------------------------------------------------------------------------------------------------------------------
--------------------------------------------------------------------------------------------------------------------------------------------------------------------------------------------------------
----------------------------------------------------------------------------------Tt--------------------------------------------------------------------------------------------------------------------
----------------------------------------------------------------------------------tt-----Tt-------------------------------------------------------------------------------------------------------------
----------------------------------------------------------------------Tt----------tt----Ktt-------------------------------------------------------------------------------------------------------------
----------------------------------------------------------------------tt-----%%%%%%%%%%%%tt-GG---------------------------------U2U UU2----------------------------SSCC2CU-------------------------------
---------%%%------------------%%%------------------------------------Ktt-----|||||||%%%%%%%%%%%--------K--------------------------%---------------------------------------------------------------------
---------|||----------%%%%%%--|||---------------------------------%%%%%%%%%%-||||||||||||||||||%%%-----%%%%----------%%%%%------%%%%%%-----------------------------------------------------------%    %%
---------|||----------||||||--|||---------------------%%%%%--%%%--||||||||||-|||||||||||||||||||||-----||||----------|||||------||||||---%%%%----------------------------------------------------|||||||
XXXXXXXXX|||XXXXXXXXXXXXXXXXXXXXXXXXXXXXXXXXXXXXXXXXXX|||||--|||XX||||||||||XXXXXXXXXXXXXXXXXXX|||-----||||XXXXXXXXXX|||||XXXXXXXXXXXXXXX||||XXXXXXXXXXXXXXXXXXXXXXXXXXXXXXXXXXXXXXXXXXXXXXXXXXXXX    XX