--------------------------------------------------------------------------------------------------------------------------------------------------------------------------------------------------------
--------------------------------------------------------------------------------------------------------------------------------------------------------------------------------------------------------
--------------------------------------------------------------------------------------------------------------------------------------------------------------------------------------------------------
--------------------------------------------------------------------------------------------------------------------------------------------------------------------------------------------------------
--------------------------------------------------------------------------------------------------------------------------------------------------------------------------------------------------------
--------------------------------------------------------------------------------------------------------------------------------------------------------------------------------------------------------
--------------------------------------------------------------------------------------------------------------------------------------------------------------------------------------------------------
----------------------------------------------------------------------------------------------------------------------------------------------SCSC2SSCU--%%%%%%%%%%%------------------------------------
---------------------------------------------------------------------------------------------------------------------------------------------------------|||||||||||------------------------------------
-----------------------------------------------------------------------------------U----------------------------tt------------------------U--------------|||||||||||------------------------------------
------------------------------------------------------------------------------------------2C--------------------tt-----%%%%%%%%%%%%%---------------------|||||||||||-----%%%%%%%%%%%%-------------------
---------------------------------------------------------------------------------------gkkkggrr-----------%%%%%%%%%%%%%|||||||||||||---------------------|||||||||||-----||||||||||||-------------------
--------------------------------------------------g----g--g-----------------------------------------------||||||||||||||||||||||||||---------------------|||||||||||-----||||||||||||---%%%%%%%%%%    %%
------------------------------------------%%%-----------------------------%%%%%%%%%%%%%--------%%%%%%%%%%%||||||||||||||||||||||||||%%%%%%%%-------------|||||||||||-----||||||||||||---||||||||||||| ||
------%%%%%-------------------------------|||----%%%%%%%%%%%%%%-----------|||||||||||||--------|||||||||||||||||||||||||||||||||||||||||||||-------------|||||||||||-----||||||||||||---||||||||||||||||
XXXXXX|||||XXXXXXXXXXXXXX---XXXXXXXXX-----|||----||||||||||||||---XXXXXXXX|||||||||||||XXXXXXXX|||||||||||||||||||||||||||||||||||||||||||||XXXXXXXXXXXXX|||||||||||-----||||||||||||---||||||||||||||||