--------------------------------------------------------------------------------------------------------------------------------------------------------------------------------------------------------
--------------------------------------------------------------------------------------------------------------------------------------------------------------------------------------------------------
--------------------------------------------------------------------------------------------------------------------------------------------------------------------------------------------------------
--------------------------------------------------------------------------------------------------------------------------------------------------------------------------------------------------------
--------------------------------------------------------------------------------------------------------------------------------------------------------------------------------------------------------
--------------------------------------------------------------------------------------------------------------------------------------------------------------------------------------------------------
--------------------------------------------------------------------------------------------------------------------------------------------------------------------------------------------------------
-------------------------------------------------------------------------------------------------------------------------------------------------------------------------------Tt-----------------------
-----------------------------------------------------------------------------------------------------------------------Tt------------------------------------------------------tt-----------------------
-------------------Tt--------------------------------------------------------------------------------------------------tt------------------------------------------------------tt-------Tt--------------
-------------------tt--------------------------------------------------------------------------------------------------tt-----------------------Tt-----------------------------tt-------tt----G---------
-------------------tt---------------------------------------------------------------------------------K---------------Gtt---------F-------------tt-------------------G-K---%%%%%%%%%%---tt----%%%%%-----
-------------------tt-------------------------------------------------------------------------------%%%%%%----------%%%%%%%%%%----%-------------tt-------------------%%%%--||||||||||%%%%%%%%%%||||-----
---------------%%%%%%%%%%---------------------------------------------------------------------------||||||----------||||||||||---G|------------Gtt-KG-----%%%---%%%%%||||--||||||||||||||||||||||||---F-
---------------||||||||||------------------------------%%%%-----%%%%%-----------%%%%------%%%-------||||||----------||||||||||--%%%%%------%%%%%%%%%%-----|||---|||||||||--||||||||||||||||||||||||--- -
XXXXXXXXXXXXXXXXXXXXXXXXXXXXXXXXXXXXXXXXXXXXXXXXXXXXXXX||||-----|||||XXXXXXXXXXX||||------|||XXXXXXXXXXXXXXXXXXXXXXXXXXXXXXXXXXX|||||XXXXXX||||||||||XXXXX|||---|||||XXXXXXXXXXXXXXXXXXXXXXXXXXXXXXXXXXX