--------------------------------------------------------------------------------------------------------------------------------------------------------------------------------------------------------
--------------------------------------------------------------------------------------------------------------------------------------------------------------------------------------------------------
--------------------------------------------------------------------------------------------------------------------------------------------------------------------------------------------------------
--------------------------------------------------------------------------------------------------------------------------------------------------------------------------------------------------------
--------------------------------------------------------------------------------------------------------------------------------------------------------------------------------------------------------
--------------------------------------------------------------------------------------------------------------------------------------------------------------------------------------------------------
--------------------------------------------------------------------------------------------------------------------------------------------------------------------------------------------------------
--------------------------------------------------------------------------------------------------------------------------------------------------------------------------------------------------------
--------------------------------------------------------------------------------------------------------------------------------------------------------------------------------------------------------
--------------------------------------------Tt-------------------------------Tt---------------------------------------------------------Tt--------------------------------------------------------------
--------------------------------------------tt-------------------------------tt---------------------------------------------------------tt--------------------------------------------------------------
--------------------------------------------tt-G--------------------------G--tt---K-------------------K---------------------------F-----tt-------------------------------------K----G-------------------
-----------------------------------------%%%%%%%%------------------------%%%%%%%%%%%-----------------%%%%%%%%%%%%-----------------%--GK-tt-----------------------------------U2U%%%%%%------------------
-----------------------------------------||||||||------------------------|||||||||||-----------------||||||||||||-----------------|-%%%%%%%%%%----------------------------------||||||--------------F---
-----------------------------------------||||||||------------------------|||||||||||-----------------||||||||||||-----------%%%%%%|-||||||||||----------------------------------||||||-------------- ---
XXXXXXXXXXXXXXXXXXXXXXXXXXXXXXXXXXXXXXXXX||||||||XXXXXXXXXXXXXXXXXXXXXXXX|||||||||||XXXXXXXXXXXXXXXXX||||||||||||XXXXXXXXXXX||||||XXXXXXXXXXXXXXXXXXXXXXXXXXXXXXXXXXXXXXXXXXXXXXXXXXXXXXXXXXXXXXXXXXXXXX