--------------------------------------------------------------------------------------------------------------------------------------------------------------------------------------------------------
--------------------------------------------------------------------------------------------------------------------------------------------------------------------------------------------------------
--------------------------------------------------------------------------------------------------------------------------------------------------------------------------------------------------------
--------------------------------------------------------------------------------------------------------------------------------------------------------------------------------------------------------
--------------------------------------------------------------------------------------------------------------------------------------------------------------------------------------------------------
--------------------------------------------------------------------------------------------------------------------------------------------------------------------------------------------------------
--------------------------------------------------------------------------------------------------------------------------------------------------------------------------------------------------------
--------------------------------------------------------------------------------------------------------------------------------------------------------------------------------------------------------
--------------------------------------------------------------------------------------------------------------------------------------------------------------------------------------------------------
--------------------------------------------------------------------------------------------------------------------------------------------------------------------------------------------------------
--------------------------------------------------------------------------------------------------------------------------------------------------------------------------------------------------------
---------------------------------------------------------------------------------------------------------UUCSUSC------------------ -------------------------------------------------K-------------------
---------------G------------------------------------------------------------------------------------------------------------------%-------------------------------------------------%%%%%---------------
--------------%%%%------%%%------G-------K------------------------G--%%%%%%%%-----------------------------------------------------|---------------%%%%%%%%%-------------------------|||||----------   %-
--------------||||------|||-----%%%%%%%%%%%---------------------%%%%%%|||||||--%%%%-----------------------------------------------|---------------|||||||||-------------------------|||||----------||||-
XXXXXXXXXXXXXX||||------|||XXXXX|||||||||||XXXXXXXXXXXXXXXXXXXXX||||||XXXXXXXXX||||XXXXXXXXXXXXXXXXXXXXXXXXXXXXXXXXXXXXXXXXXXXXXXXXXXXXXXXXXXXXXXX|||||||||XXXXXXXXXXXXXXXXXXXXXXXXX|||||XXXXXXXXX ||||-