--------------------------------------------------------------------------------------------------------------------------------------------------------------------------------------------------------
--------------------------------------------------------------------------------------------------------------------------------------------------------------------------------------------------------
--------------------------------------------------------------------------------------------------------------------------------------------------------------------------------------------------------
--------------------------------------------------------------------------------------------------------------------------------------------------------------------------------------------------------
-----------------------------------------------------------------------------------------------------------------------------------------------------------------------------------------------------F--
--------------------------------------------------------------------------------------------------------------------------------------------------------------------------------------------------------
--------------------------------------------------------------------------------------------------------------------------------------------------------------------------------------------------------
--------------------------------------------------------------------------------------------------------------------------------------------------------------------------------------------------------
----------------------------------------------------------------g---------------------------------------------------------------------------------------------------------------------------------------
------------------------------------------------------------------------------------------U-------------------------------------------------------------------------------------------------------------
--------------------------------------------------------------------------------------------------------------------------------------------------------------------------------------------------------
----------------------------------------ggkgkkkkkggg------------------------------------------gggggggggggggg----------------------------------------------------22CSSS2CS-------------------------------
--------------------------------------r--||||||||||-----------------------tt--------------------||||||||||-----------%%%%%%%%%---%%%%%%%%%%%%-----------------------------------------------------------
-------------------------%%%%%%%%%%%%%%--||||||||||-%%%%%%%%%%%-----------tt---------%%%%%%%%%--||||||||||--%%%%%%%%%|||||||||---||||||||||||--g--%%%%%%%%%%%%---------------g------g-------------------
------%%%%%--------------||||||||||||||--||||||||||-|||||||||||-----%%%%%%%%%%%%%----|||||||||--||||||||||--||||||||||||||||||---||||||||||||-----||||||||||||------------------------------------------
XXXXXX|||||XXXXXXXXXXXXXX||||||||||||||XXXXXXXXXXXXX|||||||||||-----|||||||||||||----|||||||||XXXXXXXXXXXXXX||||||||||||||||||---||||||||||||-----||||||||||||XXXXXXXXXXXXXXXXXXXXXXXXX---XXXXXXXXXXXFXX