--------------------------------------------------------------------------------------------------------------------------------------------------------------------------------------------------------
--------------------------------------------------------------------------------------------------------------------------------------------------------------------------------------------------------
--------------------------------------------------------------------------------------------------------------------------------------------------------------------------------------------------------
--------------------------------------------------------------------------------------------------------------------------------------------------------------------------------------------------------
--------------------------------------------------------------------------------------------------------------------------------------------------------------------------------------------------------
--------------------------------------------------------------------------------------------------------------------------------------------------------------------------------------------------------
--------------------------------------------------------------------------------------------------------------------------------------------------------------------------------------------------------
--------------------------------------------------------------------------------------------------------------------------------------------------------------------------------------------------------
--------------------------------------------------------------------------------------------------------------------------------------------------------------------------------------------------------
--------------------------------------------------------------------------------------------------------------------------------------------------------------------------------------------------------
---------------G-------------------------------------Tt----------G--------------------------------------------------------------------------------------------------------------------------------------
----------SCU2SU-------K-K---------------------------tt-------%%%%---------C2U2CS-------G----------------------------------------- --------------------------------------------------%%%%%%%%%%---------
----------------------%%%%------------UCC2UGC--------tt-------||||---------------%%%%--%%%%-----------------------%%%%%%%%%%------%-------------------------S--------------%%%%%%----||||||||||--K------
-------%%%%%%%%%%%----||||-------%%%%%%%%%%%2UUUU-K--t--------||||----%%%%-------||||--||||-----------------------||||||||||------|----------------------------------------||||||----||||||||||%%% ----%
-------|||||||||||----||||-------|||||||||||-----%%%%%%%%%%---||||----||||-------||||--||||-----------------------||||||||||------|----------%%%%%-----%%%%%-%%%%%-----%%%%||||||----||||||||||||||----|
XXXXXXXXXXXXXXXXXXXXXX||||XXXXXXXXXXXXXXXXXXXXXXX||||||||||XXXXXXXXXXX||||XXXXXXX||||--||||XXXXXXXXXXXXXXXXXXXXXXXXXXXXXXXXXXXXXXXXXXXXXXXXXX|||||-----|||||X|||||-----||||||||||XXXXXXXXXXXXXX||||----|