----------------------------------------------------- -------------------- --------------------------------------------- ---------- ------------------------------------- -------------------- - - -----
--------- --------------------------------------------- ------------------------------------------- -------------------------------------------------------------------------- ----- -------------------
------------------------------------------------------------------------------------------------ -------------------------------------------------------- ---------------------------  -----------------
----- ------------------------------------------------------------------- ------- ------------------------------------------------------------------------------------ ---------------------------------
-----------------  ------------- ---------------------------------------------- ----- ------------------------------------------------------------------------------------ -----------------------------
------------------------------------------------------------------------------------------------------------------------------------------------------------------------ -------------------------------
--------------------------- ---------------------------------------------------------------------------------------------------------------------------------- -------------------------------- --------
-- ------------- ------------------------------------------------------ ----------------------Tt ----------------------------------- -------- ------------------ ----- ------------------------- -------
----------------------------Tt------------ ------------------ -------------- ----- -----------tt----------------------------------------- ---------- --- --------------------------------  -------------
------------------ ---------tt--------- ------------------------ ---------- ------------------tt--------- -------------- ----------------------- ---------- -----------------------------tt-------------
--------------------- ------tt---------------------------------- -----------------------------tt--K--------------------------------------------------------------------------G---G------- t-------------
-----------------------%%%%%%%%%%-------- ----------------------------- -------------------%%%%%%  ---------------------- --------F-----------------------------------------2CS22 -------tt-------------
-----------------------||||||||||--- --------------------G--------- -----------------------||||||||--------%%%%% %%---%%%%---%%%% %%%%----------- --------- ------------------------ %%%%% %%%%---------
------ ----------------|||UCSC2C|-----------------------SCSSS------ -----------------------|||||%%%--------||| ||||---||||---| |||||||------------------------K----------%%%--------|||||||||||---------
-----------------------||||||||||--------------------------- ---- %% %%---%%%%  ---%%% ---- |||||||--------||||||||---||||---|||||||||------------- %%%%----%%%------- --|||--------|||||||||||--- -----
        XXX  X X XX XXX  X   X   XXXX  XXXXX X XX XX XXX  XXX XXX||| ||   | |||--- ||||        XX XXXX    X XX||| |---||||   |||||||||XXXX X  XX X |||||----|||   XXX  X X   X  X  X|||||||||||X X XX X 