--------------------------------------------------------------------------------------------------------------------------------------------------------------------------------------------------------
--------------------------------------------------------------------------------------------------------------------------------------------------------------------------------------------------------
--------------------------------------------------------------------------------------------------------------------------------------------------------------------------------------------------------
--------------------------------------------------------------------------------------------------------------------------------------------------------------------------------------------------------
--------------------------------------------------------------------------------------------------------------------------------------------------------------------------------------------------------
--------------------------------------------------------------------------------------------------------------------------------------------------------------------------------------------------------
--------------------------------------------------------------------------------------------------------------------------------------------------------------------------------------------------------
--------------------------------------------------------------------------------------------------------------------------------------------------------------------------------------------------------
------------------------------------------------------------------------------------------------------------------------------------------------------------------------Tt-------------------Tt---------
---------------------------------------------------------------------------------------------------------------------------------------Tt--------Tt---------------------tt-------------------tt---------
------------------------------------------------------------------------------Tt-------------------------------------------------------tt--------tt---------------------tt-------------------tt---------
------------------------------------------------------------------------------tt---------------------------------------CC---------F----tt--------tt--KU-------------%%%%%%%%%----------------tt-----K---
----------C----------------------%%%%------%%%%%---------%%%%%----%%%%--------tt%%%%%%%%%%%---G-----------------------------------%%%%%%%%%%%-%%%%%%%%--------------|||||||||-------------%%%%%%%%-%%%%%
------------------G--SC2U--------||||------|||||---------|||||----||||--------tt|||||||||||---SSCCC%%%%---------------------------|||||||||||-||||||||--------------|||||||||-------CC----||||||||F%%%||
-----------%%%%%%%%%%------------||||------|||||---------|||||----||||-----%%%%%%%%||||||||--------||||---------------------------|||||||||||-||||||||--------------%%%||||||-------------|||||||| |||||
XXXXXXXXXXX||||||||||XXXXXXXXXXXX||||------|||||XXXXXXXXX|||||----||||XXXXX||||||||XXXXXXXXXXXXXXXXXXXXXXXXXXXXXXXXXXXXXXXXXXXXXXXX||||||||||XXXXXXXXXXXXXXXXXXXXXXX|||XXXXXXXXXXXXXXXXXXX||||||||XXXXXX