--------------------------------------------------------------------------------------------------------------------------------------------------------------------------------------------------------
--------------------------------------------------------------------------------------------------------------------------------------------------------------------------------------------------------
--------------------------------------------------------------------------------------------------------------------------------------------------------------------------------------------------------
--------------------------------------------------------------------------------------------------------------------------------------------------------------------------------------------------------
--------------------------------------------------------------------------------------------------------------------------------------------------------------------------------------------------------
--------------------------------------------------------------------------------------------------------------------------------------------------------------------------------------------------------
--------------------------------------------------------------------------------------------------------------------------------------------------------------------------------------------------------
--------------------------------------------------------------------------------------------------------------------------------------------------------------------------------------------------------
--------------Tt---------------------------------------------------------------------------------------------------------------------------------------------Tt-----------------------------------------
--------------tt---------------------------------------------------------------------------------------------------------------------------------------------tt-----------------------------------------
--------------tt-----------------------------------------------Tt-----------------------------------------------------------------------------------------K-Gtt---------------------------------F-------
-----------G--tt------------------SC2SCU2------------------G---tt--------------------------------------------G--------------------F----GG----------------%%%%%%%%%------------------------------ -------
---------%%%%%%%%%%%%------------------------------------%%%%%%tt%%----------------------------------------%%%%%------------------%----%%%%-----%%%------|||||||||--------------%%%%%------%%%%%%------%
---------||||||||||||------------------------------------||||||tt||------------%%%%-----%%%%---------------|||||------------------|----||||-----|||------|||||||||--------------|||||------||||||%%%%%%%
---------||||||||||||------------------------------------|||%%%%%%%%%%---------||||-----||||---------------|||||------------------|----||||-----|||------|||||||||--------------|||||------|||||||||||||
XXXXXXXXX||||||||||||XXXXXXXXXXXXXXXXXXXXXXXXXXXXXXXXXXXXXXX||||||||||XXXXXXXXX||||-----||||XXXXXXXXXXXXXXXXXXXXXXXXXXXXXXXXXXXXXXXXXXX||||-----|||XXXXXXXXXXXXXXXXXXXXXXXXXXXXXXXXXXXXXXXX||||||XXXXXXX