--------------------------------------------------------------------------------------------------------------------------------------------------------------------------------------------------------
--------------------------------------------------------------------------------------------------------------------------------------------------------------------------------------------------------
--------------------------------------------------------------------------------------------------------------------------------------------------------------------------------------------------------
--------------------------------------------------------------------------------------------------------------------------------------------------------------------------------------------------------
-----------------------------------------------------------------------------------------------------------------------------------------------------------------------------------------------------F--
-------------------------------------------------------------------------------------------------------------------------------SCCSU--%%%%%%%%%%--------------------------------------------------------
--------------------------------------------------------------------------------------------------------------------------------------||||||||||--------------------------------------------------------
--------------------------------------------------------------------------------------------------------------------------SU----------||||||||||--------------%%%%%%%%----------------------------------
-----------------------------------------------------------------------------------gggggggg-------------------------------------------||||||||||-----g---g----||||||||----------------------------------
------------------------------------------------------g--g--g--------------------r--||||||--------------------------------------------||||||||||--------------||||||||----------------------------------
------------------------------------C2CS----------------------------%%%%%%%%%%%%%%--||||||-%%%%%%%%%----------------------------------||||||||||----%%%%%%%%--||||||||-------U2-------------------------
-----------------------------------gkkgkkgk-------------------------||||||||||||||--||||||-|||||||||-----g------g---%%%%%%%%%---------||||||||||----||||||||%%%%%%%%%%%%%%------------------------------
---------------------------------r----------------------------------||||||||||||||%%%%%%%%%|||||||||----------------|||||||||---------||||||||||----||||||||||||||||||||||-g----g-----------------------
-------------------------%%%%%%%%%---------%%%%%%%%%%---------------||||||||||||||||||||||||||||||||----%%%%%%%%%%%%|||||||||---------||||||||||----||||||||||||||||||||||---------------g--------------
------%%%%%--------------|||||||||---------||||||||||----%%%%%%%%%%%||||||||||||||||||||||||||||||||----|||||||||||||||||||||---------||||||||||----||||||||||||||||||||||%%%%%%%%----------------------
XXXXXX|||||XXXXXXXXXXXXXX|||||||||XXXXXXXXX||||||||||----|||||||||||||||||||||||||||||||||||||||||||----|||||||||||||||||||||XXXXXXXXX||||||||||----||||||||||||||||||||||||||||||XXXXXXXXXXXXXXXXXXXFXX