--------------------------------------------------------------------------------------------------------------------------------------------------------------------------------------------------------
--------------------------------------------------------------------------------------------------------------------------------------------------------------------------------------------------------
--------------------------------------------------------------------------------------------------------------------------------------------------------------------------------------------------------
--------------------------------------------------------------------------------------------------------------------------------------------------------------------------------------------------------
--------------------------------------------------------------------------------------------------------------------------------------------------------------------------------------------------------
------------------------------------------------------------------------------------------------------------------------------------------------------------------------------2-------------------------
---------------------------------------------------------------2US2S2C-%%%%%%%%%%%%%--CSC2222CS---------------------------------------------------------------------------------------------------------
-----------------------------------------------------------------------|||||||||||||--------------------------------------------------------------------------------------------------------------------
-----------------------------------------------------------CU----------|||||||||||||-gg-----------------------------------------------------------------------------------------------------------------
-----------------------------------------------------------------------|||||||||||||--------------------------------%%%%%----------------------------SCSCSC-----------------%%%%%-----------------------
-----------------------------------------------------------------------|||||||||||||%%%%%%%%%%%%%%%%%%%%%%%%%%------|||||---------------------------ggkggkkkg---------------|||||-----------------------
----------------------------------------------%%%%%--------------------|||||||||||||||||||||||||||||||||||||||-----%%||||-------------------------r-------------------------|||||-----------------------
----------------------------------------------|||||--%%%%%%%%----------|||||||||||||||||||||||||||||||||||||||-----||||||---------------%%%%%%%%%%%----------%%%%%%%%%------|%%%|-----------------------
------------------------------%%%%%%%---------|||||--||||||||----------|||||||||||||||||||||||||||||||||||||||----%%%%%%%%-----%%%%%%---|||||||||||----------|||||||||----%%%%%%%%%-k----k--------------
------%%%%%-------------------|||||||---------|||||--||||||||----------|||||||||||||||||||||||||||||||||||||||----||||||||-----||||||---|||||||||||%%%%%%%%%%|||||||||----|||||||||---------------------
XXXXXX|||||XXXXXXXXXXXXXX---XXXXXXXXXXXXX---XXXXXXXXX||||||||XXXXXXXXXX|||||||||||||||||||||||||||||||||||||||----||||||||---XXXXXXXXXXX||||||||||||||||||||||||||||||----|||||||||XXXXXXXXXXXXXXX    XX