--------------------------------------------------------------------------------------------------------------------------------------------------------------------------------------------------------
--------------------------------------------------------------------------------------------------------------------------------------------------------------------------------------------------------
--------------------------------------------------------------------------------------------------------------------------------------------------------------------------------------------------------
--------------------------------------------------------------------------------------------------------------------------------------------------------------------------------------------------------
--------------------------------------------------------------------------------------------------------------------------------------------------------------------------------------------------------
--------------------------------------------------------------------------------------------------------------------------------------------------------------------------------------------------------
--------------------------------------------------------------------------------------------------------------------------------------------------------------------------------------------------------
--------------------------------------------------------------------------------------------------------------------------------------------------------------------------------------------------------
------------------------------------------------------------U-------------------------------------------------------------------------------------------------------------------------------------------
----------------------------------------------------------------------------------------------------------------SSSCC---------------g-------g-----------------------------------------------------------
--------------------------gg------g-------------------------------%%%%%%%--------------------------------------ggkggggkk--------------------------------------------------------------------------------
----------------------------------------------------------------ggggkkgkggg----------------------------------r---------------------%%%%%%%%%%---CS2SSCCCU-----------------g--g--------------------------
--------------------------------------------------------%%%%%%%%--|||||||------------------------%%%%%%%%%%%%%----------%%%%%%%%%%%||||||||||-----------------------------------------------------------
------------------------------------------gg------ggg---||||||||--|||||||--%%%%%%%%--------------|||||||||||||----------|||||||||||||||||||||-----------------------------------------------------------
------%%%%%---------------------------------------------||||||||--|||||||--||||||||----%%%%%%%%%%|||||||||||||%%%%%%%%%%|||||||||||||||||||||-----------------------------------------------------------
 X X  |||||X X  XX XXX X ----XX    X  ---   X XX XX-----|||||||| X X X XX X||||||||----|||||||||||||||||||||||||||||||||||||||||||||||||||||| XX     X XXX XXX  XXX XX XX----X  X  X ---- XXXX XX  XXFX 