--------------------------------------------------------------------------------------------------------------------------------------------------------------------------------------------------------
--------------------------------------------------------------------------------------------------------------------------------------------------------------------------------------------------------
--------------------------------------------------------------------------------------------------------------------------------------------------------------------------------------------------------
--------------------------------------------------------------------------------------------------------------------------------------------------------------------------------------------------------
--------------------------------------------------------------------------------------------------------------------------------------------------------------------------------------------------------
--------------------------------------------------------------------------------------------------------------------------------------------------------------------------------------------------------
--------------------------------------------------------------------------------------------------------------------------------------------------------------------------------------------------------
--------------------------------------------------------------------------------------------------------------------------------------------------------------------------------------------------------
--------------------------------------------------------------------------------------------------------------------------------------------------------------------------------------------------------
-------------------------------------------------------------Tt-------------------------------------------------------------------------------------------------Tt--------------------------------------
-------------------------------------------------------------tt-----------------------------Tt------------------------K------------------------Tt---------------tt--------------------------------------
-------------------------------------------------------------tt-----------------------------tt------------------------U2C2SUC-----F------------tt---------------tt--------------------------------------
---------K--------------------------%%%%%%%%%%-----------%%%%%%%%%%%------------------------tt---G--------------------------------%------------tt---------S2S%%%%%%%%%%---------%%%--%%%%---------------
---------%%%------%%%--------------G||||||||||-----------|||||||||||---------------------%%%%%%%%%--------------------------------|-----222%%%%%%%%%%%-------||||||||||---------|||--||||------------F--
---------|||------|||-----%%%--%%%%%||||||||||-----------|||||||||||---------------------|||||||||--------------------------------|--------|||||||||||-------||||||||||---------|||--||||------------ --
XXXXXXXXX|||------|||XXXXX|||--|||||||||||||||XXXXXXXXXXX|||||||||||XXXXXXXXXXXXXXXXXXXXX|||||||||XXXXXXXXXXXXXXXXXXXXXXXXXXXXXXXXXXXXXXXXX|||||||||||XXXXXXXXXXXXXXXXXXXXXXXXXX|||--||||XXXXXXXXXXXXXXX