--------------------------------------------------------------------------------------------------------------------------------------------------------------------------------------------------------
--------------------------------------------------------------------------------------------------------------------------------------------------------------------------------------------------------
--------------------------------------------------------------------------------------------------------------------------------------------------------------------------------------------------------
--------------------------------------------------------------------------------------------------------------------------------------------------------------------------------------------------------
--------------------------------------------------------------------------------------------------------------------------------------------------------------------------------------------------------
--------------------------------------------------------------------------------------------------------------------------------------------------------------------------------------------------------
--------------------------------------------------------------------------------------------------------------------------------------------------------------------------------------------------------
-------------------------------------------------------------------------------------------------------------------------------------------------------%%%%%--------------------------------------------
-------------------------------------------------------------------------------------------------------------------------------------------------------|||||--------------------------------------------
-----------------------------------------------------------------------------------SS2SSS---------------k---------------------------------------------%%%%%%------------------CUCCS---------------------
---------------------------------------------------------------------------------gkgggggkgk-----------------------------------------------------------||||||--%%%%%%%%%%%%%------------2CSSCSSCSS-------
-------------------------------------------------------------SCCSCC------------r-----------------------------------------------%%%%----------%%%%%%--%%%%%%%%%|||||||||||||-k---------------------------
----------------------------------------------------------------------%%%%%%%%%%-----------%%%%%%%%%%%%%----%%%%%%%%%%%%%------||||----------||||||--||||||||||||||||||||||------------------------   %%
-----------------------------------------------------------g----------||||||||||-----------|||||||||||||----|||||||||||||------|%%%%%%%------|%%%%%--||||||||||||||||||||||%%%%%%%%%%--------------|| ||
------%%%%%-----------------------------------------------------------||||||||||%%%%%%%%%%%|||||||||||||----|||||||||||||------||||||||------||||||--||||||||||||||||||||||||||||||||%%%%%%%%%%%%% |||||
XXXXXX|||||XXXXXXXXXXXXXX-----XXXXXXXXXXXX-----XXXXXXXXXXXXXXXXXXXXXXX||||||||||||||||||||||||||||||||||----|||||||||||||-----XXXXXXXXXXXXXXXXXXXXXXX|||||||||||||||||||||||||||||||||||||||||||||||||||