--------------------------------------------------------------------------------------------------------------------------------------------------------------------------------------------------------
--------------------------------------------------------------------------------------------------------------------------------------------------------------------------------------------------------
--------------------------------------------------------------------------------------------------------------------------------------------------------------------------------------------------------
--------------------------------------------------------------------------------------------------------------------------------------------------------------------------------------------------------
--------------------------------------------------------------------------------------------------------------------------------------------------------------------------------------------------------
--------------------------------------------------------------------------------------------------------------------------------------------------------------------------------------------------------
--------------------------------------------------------------------------------------------------------------------------------------------------------------------------------------------------------
--------------------------------------------------------------------------------------------------------------------------------------------------------------------------------------------------------
-----------------------------------------------------------------------------------------------------------------------------------------------------------r----r---------------------------------------
-------------------------------------------------------------------------------------------------------------------------------------------kgggkggk-----------------------------------------------------
---------------------------------------------------------------------U----------------------------%%%%%%%%%%%%%--------------------------r--||||||---------%%%%%%%%%%%---------------------------%    %%
----------------------------------------------%%%%-----------------------ggggggggkgg--------------|||||||||||||----gg-------%%%%%%%%%%%%%%--||||||-%%%%%%%%|||||||||||---------------------------|||| ||
----------------------------------------------|%%%%%%%--------------------------------------------|||||||||||||-------------||||||||||||||--||||||-|||||||||||||||||||---%%%%%%%%----------------|||||||
-------------------------------g---g----------||||||||----g----------g--------------%%%%%%%%%%%%%%|||||||||||||---%%%%%%%%%%||||||||||||||%%%%%%%%%|||||||||||||||||||---||||||||---%%%%%%%%%%%%%|||||||
------%%%%%-----------------------------------||||||||-------%%%%%%%%%%%%-----------|||||||||||||||||||||||||||---||||||||||||||||||||||||||||||||||||||||||||||||||||---||||||||---||||||||||||||||||||
XXXXXX|||||XXXXXXXXXXXXXX-----XXXXXXXXXX-----XXXXXXXXXXXX----||||||||||||XXXXXXXXXXX|||||||||||||||||||||||||||---||||||||||||||||||||||||||||||||||||||||||||||||||||---||||||||---||||||||||||||||||||