--------------------------------------------------------------------------------------------------------------------------------------------------------------------------------------------------------
--------------------------------------------------------------------------------------------------------------------------------------------------------------------------------------------------------
--------------------------------------------------------------------------------------------------------------------------------------------------------------------------------------------------------
--------------------------------------------------------------------------------------------------------------------------------------------------------------------------------------------------------
--------------------------------------------------------------------------------------------------------------------------------------------------------------------------------------------------------
--------------------------------------------------------------------------------------------------------------------------------------------------------------------------------------------------------
--------------------------------------------------------------------------------------------------------------------------------------------------------------------------------------------------------
---------------------------------------------------------------------------------------------------------------Tt---------------------------------------------------------------------------------------
------------------------------------------------------------------------------Tt-------------------------------tt---------------------------------------------------------------------------------------
------------------------------------------------------------------------------tt-------------------------------tt---------------------------------------------------------------------------------------
------------------------------------------------------------------------------tt--------G----------------------tt---------G--------KK-------------------------------------------------------------------
------------------------------------------------------------------------------tt%%%G%%%%%%--Tt--------------%%%%%%%%%----2UCSC--SSFCC-------------------------------------------------------------------
----------------------%%%%-------------------------------------%%%-------%%%%%%%%%%%||||||--tt--------------|||||||||-------------%----------------------------GG-----------C2U---------------------F---
--------%%%%%%%%%-----||||-----------------------K-------------|||-------||||||||||||%%|||--tt--------------|||||||||-------------|------------------%%%%%-----%%%%%--U2U--------------------------- ---
--------|||||||||-----||||-------------------%%%%%--%%%%%------|||-------||||||||||||||%%%%%%%%%%%----------|||||||||-------------|------------------|||||-----|||||-------------------%%%%%------%%%---
XXXXXXXX|||||||||XXXXX||||XXXXXXXXXXXXXXXXXXX|||||--|||||XXXXXX|||XXXXXXX|||||||||||XXX|||||||||||XXXXXXXXXXXXXXXXXXXXXXXXXXXXXXXXXXXXXXXXXXXXXXXXXXX|||||-----|||||XXXXXXXXXXXXXXXXXXX|||||------|||XXX