--------------------------------------------------------------------------------------------------------------------------------------------------------------------------------------------------------
--------------------------------------------------------------------------------------------------------------------------------------------------------------------------------------------------------
--------------------------------------------------------------------------------------------------------------------------------------------------------------------------------------------------------
--------------------------------------------------------------------------------------------------------------------------------------------------------------------------------------------------------
--------------------------------------------------------------------------------------------------------------------------------------------------------------------------------------------------------
--------------------------------------------------------------------------------------------------------------------------------------------------------------------------------------------------------
---------------------------------------------------------------------------------------------------------------------------------------------------------------------C2S--------------------------------
--------------------------------------------------------------------------------------------------------------------------------------------------------------------------------------------------------
----------------------------------------------------------------------------------------------------------------------------------------------------------------g---------------------------------------
----------------------------------------------------U---------------------------------------------------------------------------------------------------------------------------------------------------
------------------------------------------------------------SSSS----------------------------------------------------------------------SSS2C---------------%%%%%%%%%%%%%%%%----gg------------------------
--------------------------------------------------------ggkgggggkk---------------------------SSSS-----SSSSCSC-----------------------kgkkgggggg------------||||||||||||||||------------------------------
-------------------------------------------g--------------------------------------------------------------------------------------r-----------------------||||||||||||||||---%%%%%%%%%%%%---------------
--------------------------g----%%%%%%%-------%%%%%%%%%%%----------%%%%%%%%-------------------g----g-------------g-------%%%%%%%%%%%-----------%%%%%%%%%%%%||||||||||||||||---||||||||||||---------------
------%%%%%--------------------|||||||-------|||||||||||----------||||||||----------------------------------------------|||||||||||-----------||||||||||||||||||||||||||||---||||||||||||---------------
XXXXXX|||||XXXXXXXXXXXXXX----XXXXXXXXXXXXX---|||||||||||XXXXXXXXXX||||||||-----XXXXXXXXXXXXXXXXXXXXXXXXXXXXXXXXXXXXXXXXX|||||||||||XXXXXXXXXXX||||||||||||||||||||||||||||---||||||||||||XXXXXXXXX    XX