--------------------------------------------------------------------------------------------------------------------------------------------------------------------------------------------------------
--------------------------------------------------------------------------------------------------------------------------------------------------------------------------------------------------------
--------------------------------------------------------------------------------------------------------------------------------------------------------------------------------------------------------
--------------------------------------------------------------------------------------------------------------------------------------------------------------------------------------------------------
--------------------------------------------------------------------------------------------------------------------------------------------------------------------------------------------------------
--------------------------------------------------------------------------------------------------------------------------------------------------------------------------------------------------------
--------------------------------------------------------------------------------------------------------------------------------------------------------------------------------------------------------
--------------------------------------------------------------------------------------------------------------------------------------------------------------------------------------------------------
--------------------------------------------------------------------------------------------------------------------------------------------------------------------------------------------------Tt----
---------------------------------------------------Tt---------------------------------------------------------------------------------------------------------------------------------------------tt----
---------------------------------------------------tt---------------------------------------------------Tt----------------------------------------------------------------------------------------tt----
---------------------------------------------------tt-G-------------------------------------------------tt------------------------F%%%%%%%%%%%%----------------G------------------------------G--Gtt-KK-
----------------------------------------------S2%%%%%%%%%------%%%%%%%%%%----2S-------------------------tt-----------------------%%%|||||||||||----------------2C2CUU----G--CCC-----------G--%%%%%%%%%%%
----------------%%%-----%%%---------------------|||||||||------||||||||||-------------------------------tt-G---------------------||||||||%%%%||-------------------%%%%-%%%%%%%%%--%%%%%%%%%--|||||||F|||
----------------|||-----|||---------------------|||||||||------||||||||||----------------------------%%%%%%%%--------------------||||||||||||||-------------------||||-|||||||||--|||||||||--||||||| |||
XXXXXXXXXXXXXXXX|||-----|||XXXXXXXXXXXXXXXXXXXXX|||||||||XXXXXX||||||||||XXXXXXXXXXXXXXXXXXXXXXXXXXXX||||||||XXXXXXXXXXXXXXXXXXXXXXXXXXXXXXXXXXXXXXXXXXXXXXXXXXXXXXXXXXXXXXXXXXXXX|||||||||XXXXXXXXXXXXX