--------------------------------------------------------------------------------------------------------------------------------------------------------------------------------------------------------
--------------------------------------------------------------------------------------------------------------------------------------------------------------------------------------------------------
--------------------------------------------------------------------------------------------------------------------------------------------------------------------------------------------------------
--------------------------------------------------------------------------------------------------------------------------------------------------------------------------------------------------------
--------------------------------------------------------------------------------------------------------------------------------------------------------------------------------------------------------
--------------------------------------------------------------------------------------------------------------------------------------------------------------------------------------------------------
--------------------------------------------------------------------------------------------------------------------------------------------------------------------------------------------------------
--------------------------------------------------------------------------------------------------------------------------------------------------------------------------------------------------------
--------------------------------------------------------------------------------------------------------------------------------------------------------------------------------------------------------
--------------------------------------------------------------------------------------------------------------------------------------------------------------------------------------------------------
---------------------------------------------------------------------------------------------------------------Tt----------------------Tt---------------------------------------------------------------
-----------G-------K--------------------------------------------------------%%%%%%%%%%----------------------%%%tt%%%%%------------ ----tt------------------------------------------------------------ UC
-------%%%%%----%%%%---------------------------------------K-------------%%%%%||||||||----------------------%%%tt|||||------------%----tt---------------------------------------------------G-----------
-------|||||----||||-------------------------------------%%%------%%%%---|||||||||||||----------------------|||tt|||||------------%%%%%%%%%%%%---G--------K--------------------------------%%%----   ---
-------|||||----||||--------------------%%%%%%%%---------|||------||||---|||||||||||||---------------------%%%%%%%%%||------------||||||||||||-%%%%-%%%%--%%%%%----------%%%%%--%%%--------|||----|||---
XXXXXXX|||||----||||XXXXXXXXXXXXXXXXXXXX||||||||XXXXXXXXX|||------||||XXX|||||XXXXXXXXXXXXXXXXXXXXXXXXXXXXX|||||||||XXXXXXXXXXXXXXXXXXXXXXXXXXX||||X||||--|||||XXXXXXXXXX|||||--|||XXXXXXXX|||----||| XX