-----------------------------------------------------------------------------------------------------------------------------      ---------------------------------------------------------------------
-----------------------------------------------------------------------------------------------------------------------------      ---------------------------------------------------------------------
-----------------------------------------------------------------------------------------------------------------------------      ---------------------------------------------------------------------
-----------------------------------------------------------------------------------------------------------------------------      ---------------------------------------------------------------------
-----------------------------------------------------------------------------------------------------------------------------      ---------------------------------------------------------------------
-----------------------------------------------------------------------------------------------------------------------------      ---------------------------------------------------------------------
-----------------------------------------------------------------------------------------------------------------------------      ---------------------------------------------------------------------
-----------------------------------------------------------------------------------------------------------------------------      ---------------------------------------------------------------------
-----------------------------------------------------------------------------------------------------------------------------      -----Tt--------------------------------------------------------------
------------------Tt-----------------------------------------------------------------------------------Tt--------------------      -----tt--------------------------------------------------------------
------------------tt-----------------------------------------------------------------------------------tt--------------------      -----tt--------------------------------------------------------------
------------------tt-----------Tt----------------------------------------------------------------------tt-K------------------      ---K-tt---------------------------------------------K----------------
-------C2CCCS%%%%%%%%%%%%------tt---------2S-------------------------------------------------------%%%%%%%%%%----------%%%---      %-%%%%%%%%------------------------%%%%-----------%%%%%--%%%%---------
-------------||||||||||||---G%Gtt%%----------------%%%%%----%%%-------%%%%--%%%-%%%%%------%%%-----||||||||||----------|||---      |-||||||||------%%%%%%%%%%--------||||-------K---|||||--||||---------
-------------||||||||||||--%%%%%%%%%%--------------|||||----|||-------||||--|||-|||||------|||-----||||||||||----------|||---      |-||||||||------||||||||||--------||||-%%%%%%%%--|||||--||||--------%
XXXXXXXXXXXXXXXXXXXXXXXXXXX||||||||||XXXXXXXXXXXXXX|||||----|||XXXXXXX||||--|||X|||||------|||XXXXXXXXXXXXXXXXXXXXXXXXX|||---      |X||||||||XXXXXX||||||||||XXXXXXXXXXXXX||||||||XX|||||--||||XXXXXXXX|