------------------- --------------- --------------------------------------------------------------------------------------------------------------------------------------------------------------------
---------------------------------------------------------------------------------------------------- ---------------------------------------------------------------------------------------------------
--------------------------------------------------------------------------------------------------------------------------------------------------------------------------------------------------------
--------------------------------------------------------------------------------------------------------------------- ---------------- ---- --- --------------------------------------------------------
---------------------------------------------------------------------------------------------------------------- ---- ------------------------------- ------------------------------- ------------------
--------------------------- ----------------------------------------------------------------------------------------- ---- -----------------------------------------------------------------------------
---------------------------- ------------------------------------------------------- ---------------------- --------- ----------------------------------------------------------------------------------
------------------------------------------------------------------------------------------------ -------------------  -------------------------------------%%%%%----------------------------------------
-----------------------------------------------------------------   ------------------U------------------------------ --------------------------------k----|%%%%%%%----rr------------- ---- ------------
-- ---------------------- -----------------------------U2CS--%%%%%%%%%%----------------------SS2SS--------------- --- ----------r--------------------------||||||||----------- -------------------------
-------------------------------------------------------------||||||||||--------- --------------------------------%%%% %%%%----------------- %%%%%%%%%% %%%%%%%%%%%%%%%%%%%%%%%%%%%----- ----------------
----------------------------------------- ----SSCSSSSU-------||||||||||------------- -----ggggggkkgk-------------|||| ||||-----%%%%%%%%%%%%%|||||||||||| |||||||||||||||||||||||||----------------------
----------------- -------------------------------------------||||||||||-----%%%%%%%%%%%%%%-----------------------|||| ||||-----||||||||||||||||||||||||| ||||||||||||| |||||||||||------------- --------
--------------------------g--gg----gg------------------------||||||||||-----||||||||||||||----------%%%%%%%%%%% %|||||||||- ---||||||||||| |||||||||||||||||||||||||||||||||||||||-----%%%%%%%%%%%%%% %%
------%%%%%------------------ -------------------------------||||||||||-----||||||||||||||----------||||||||||||||||||||||-----|||||||||||||||||||||||||||||||| ||||||||||| ||||||-----||||||||||||||%||
XXXXXX|||||XXXXXXXXXXXXXX----XXXXXXXXXXXXXX X XXXXXXXXXXXXXXX||||| ||||-----||||||||||||||XXXXXXXXXX||||||||||||||||||||||-----||||||||||||||||||||||||||||||| |||||||||||||||||||-----|||||||||||||||||