--------------------------------------------------------------------------------------------------------------------------------------------------------------------------------------------------------
--------------------------------------------------------------------------------------------------------------------------------------------------------------------------------------------------------
--------------------------------------------------------------------------------------------------------------------------------------------------------------------------------------------------------
--------------------------------------------------------------------------------------------------------------------------------------------------------------------------------------------------------
--------------------------------------------------------------------------------------------------------------------------------------------------------------------------------------------------------
--------------------------------------------------------------------------------------------------------------------------------------------------------------------------------------------------------
--------------------------------------------------------------------------------------------------------------------------------------CSSCCS------------------------------------------------------------
--------------------------------------------------------------------------------------------------------------------SCSSU--%%%%%%%%---------------------------------------------------------------------
----------------------------------------------------g----------------------------------------------------------------------||||||||---------------------------------------------------------------------
-----------------------------------kggkgkg----------------g-----------------2SCC2SCC----------------------------US---------||||||||---------------------------------------------------------------------
---------------------------------r--|||||---------------------------------gkggggggkggg-------------------------------------||||||||%%%%%%%%%%%%-----g---------------------------------------------------
-------------------------%%%%%%%%%--|||||-%%%%%%%%%-----%%%%%%----------r--------------------------------------------------||||||||||||||||||||---------------------------------------------------------
-------------------------|||||||||--|||||-|||||||||----%%%||||---%%%%%%%%-------------%%%%%%%%--------tt-------------------||||||||||||||||||||----%%%%%%%%%%%-----%%%%%%%%%%%%%%%%%%%%%%---------------
-------------------------|||||||||%%%%%%%%|||||||||----|||||||---||||||||-------------||||||||--------Tt--%%%%%%%%---------||||||||||||||||||||----|||||||||||-----||||||||||||||||||||||---------------
------%%%%%--------------||||||||||||||||||||||||||---%%%%%%%%%%%||||||||%%%%%%%%%%%%%||||||||--------tt--||||||||---------||||||||||||||||||||----|||||||||||-----||||||||||||||||||||||---------------
XXXXXX|||||XXXXXXXXXXXXXX||||||||||||||||||||||||||---||||||||||||||||||||||||||||||||||||||||----XXXXXXXX||||||||XXXXXXXXX||||||||||||||||||||----|||||||||||-----||||||||||||||||||||||XXXXXXXXX    XX