------------------------------------------------------------------------------------------------------------------------------        ------------------------------------------------------------------
------------------------------------------------------------------------------------------------------------------------------        ------------------------------------------------------------------
------------------------------------------------------------------------------------------------------------------------------        ------------------------------------------------------------------
------------------------------------------------------------------------------------------------------------------------------        ------------------------------------------------------------------
------------------------------------------------------------------------------------------------------------------------------        ------------------------------------------------------------------
------------------------------------------------------------------------------------------------------------------------------        ------------------------------------------------------------------
------------------------------------------------------------------------------------------------------------------------------        ------------------------------------------------------------------
------------------------------------------------------------------------------------------------------------------------------        ------------------------------------------------------------------
------------------------------------------------------------------------------------------------------------------------------        ------------------------------------------------------------------
-------------------------------------------------------------------------Tt---------------------------------------------------        ------------------------------------------------------------------
-----------------------------------------------------------------Tt------tt---------------------------------------------------        ------------------Tt-------------------Tt-------------------------
----------G--------------------K-------G-------------------------tt------t----------------------------------------------------        %%%%%-------------tt-------------------tt-------------------------
--------%%%%-------------------%%%%%%%%%%%----%%%%%--------------tt--K%%%%%%%%%-------%K%%%%%%--------------------------------        |||||-------------tt-------------------tt-------------------------
--------||||-------------------|||||||||||----|||||--%%%%%----%%%%%%%%|||||||||-----%%%%%%%%%|---------------------------%%%%%        |||||-------------tt--G----------------tt---2U-----%%%%%%%%%%%----
--------||||-------------------|||||||||||----|||||--|||||----|||||||||||||||||-----||||||||||---------------------------|||||        |||||--------%%%%%%%%%%%-----------%%%%%%%%%-------|||||||||||----
XXXXXXXXXXXXXXXXXXXXXXXXXXXXXXXXXXXXX|||||----|||||XX|||||XXXX||||||||XXXXXXXXXXXXXXXXXXXXXXXXXXXXXXXXXXXXXXXXXXXXXXXXXXX|||||        XXXXXXXXXXXXX|||||||||||XXXXXXXXXXX|||||||||XXXXXXXXXXXXXXXXXXXXXX