------------------------------------------------------------------------------------------------------------------------------------------------ -------- ---------------------------------- -----------
------------------------------------------------------------------------ -------------------------------------------------- ------------------------------------------------ -------------------------  
----- ------- ----------------------------------------------------------------------- ----------------------------------------------------------------------------------------------------------------- 
-------------------------------------------------------------------------------- -----------------------------------------------------------------------------------------------------------------------
------ ----------------------------------------------------------------------------------------------------------------------------------------------------------------- -------------------------------
------------------------------------------------------------------- ---------- -------------------------------------------------------------------------------------------------------------------------
------------------------------------------------------ -------------------------------------------------------------------------------------------------------------------------------------------------
----------------------------------------------------------------------------- -----------------------------------------%%% -----------------------------------------------------------------------------
-----------------------------------------------------------------g-----g ---------------------------------------g-----r%%%%k--------------------------------------- ------------------------------------
--------------------------------------------------------------------------------------------S U2C-%%%  %%%%%%%%-------||||||--------------- --- ------------------- ------------------------------------
----------------------- ---------------SC SS2 2---------------------------------------------------|||||||||||||-------||||||--------------------------------%%%%%%% %%%%--------------------------------
--------------------------------------ggkggkgggggg--------------------%%%%%% ---------S  ---------||| |||||||||-----%%%% %%%%%------------------------ -----||||||| ||||--------------------------------
---- --------------------- ---------r---------------------------------|||||||---------------------|||||||||||||-----||||||||| ---%%%%%%%% %%%----%%%%%%%%%% ||||||| ||||-r---r--------------------------
-------------------------% %%% %%%%%%-- ----------%%%%%%%%%%%%%%------|||||||---------------------|||||||||||||-----||||||||||---||||||||| ||----|||||||||||||||||| ||||------------ -------------------
------%%%% ------------ -||||||||||||-------------||||||||||||||----%%%%%%%%%%% ------------------|||||||||||||-----||||||||||---||||||||||||----|||||||||||||||||| ||||%%%%%%%%%%%%%-------------------
 XXXXX|||||X XXXXXX X XXX||||||||||||XXXXXXX XXXXX||||||||||||||----||||||||||||XXXXXXXXXXXXXXXXXX|||||||||||||-----|| |||||||---||||||||||||----|||||||||||||||||| |||||||||||||||||---X XXXXXXXXXXXFXX