-------------------------------------------------------------------------------------------------------------------------------------------------        -----------------------------------------------
-------------------------------------------------------------------------------------------------------------------------------------------------        -----------------------------------------------
-------------------------------------------------------------------------------------------------------------------------------------------------        -----------------------------------------------
-------------------------------------------------------------------------------------------------------------------------------------------------        -----------------------------------------------
-------------------------------------------------------------------------------------------------------------------------------------------------        -----------------------------------------------
-------------------------------------------------------------------------------------------------------------------------------------------------        -----------------------------------------------
-------------------------------------------------------------------------------------------------------------------------------------------------        -----------------------------------------------
-------------------------------------------------------------------------------------------------------------------------------------------------        -----------------------------------------------
---------------------------------------------------------------------------------------------------------S2S2------------------------------------        -----------------------------------------------
-------------------------------------------------------------------------------------------------------------------------------------------------        -----------------------------------------------
-------------------------------------------------------------------------------------------------------------------------------------------------        -----------------------------------------------
----------------------------------------------------------------------------------------------------------Y-r-------------CSSC-------------------        -----------------------------------------------
----------------------------------------------------------------------------------------%%%%%%%%%-------%%%%%%%--------------------------%%%%%%%%        %%%%%%%%%%%%%%%%%%%%%%%%%%%%%%%%%%%%%%%%%%%%%%%
--------------------------Tt-----#---#---------%%%---%%%--------------------------------|||||||||-------||||||yr-------------------------||||||||        |||||||||||||||||||||||||||||||||||||||||||||||
-------------%%%%%--%%%%%-tt----##---##--------|||---|||%%%%%--%%%%%%%---%%%%%%%%%--%%%%|||||||||------%%%%%%%%%%%%%%%%-ky---------------||||||||        |||||||||||||||||||||||||||||||||||||||||||||||
XXXXXXXXXXXXX|||||--|||||XXXXXXXXX---XXXXXX--XX|||---||||||||--|||||||---|||||||||--|||||||||||||XX--XX||||||||||||||||XXXXXXXXXXXXX--XXX||||||||        |||||||||||||||||||||||||||||||||||||||||||||||