--------------------------------------------------------------------------------------------------------------------------------------------------------------------------------------------------------
--------------------------------------------------------------------------------------------------------------------------------------------------------------------------------------------------------
--------------------------------------------------------------------------------------------------------------------------------------------------------------------------------------------------------
--------------------------------------------------------------------------------------------------------------------------------------------------------------------------------------------------------
--------------------------------------------------------------------------------------------------------------------------------------------------------------------------------------------------------
--------------------------------------------------------------------------------------------------------------------------------------------------------------------------------------------------------
--------------------------------------------------------------------------------------------------------------------------------------------------------------------------------------------------------
---------------------------------------------------------------2CCCSSSSUS--%%%%%%%%-------tt------------------------------------------------------------------------------------------------------------
---------------------------------------------------------------------------||||||||-------tt-------------------------------------------------------------------gg---------------------------------------
---------------------------------------------------------USSSS-------------||||||||-------tt--------------------------------------------------------------------------------g--r------------------------
---------------------------------------------------------------------------||||||||%%%%%%%%%%%%%%-------------------------------------------------%%%%%%%%----%%%%%%%%%----------------%%%%%%%%%%%    %%
---------------------------------------------------------------------------||||||||||||||||||||||--------------U---kkkgkgggkgggk------------------||||||||----|||||||||----%%%%%%%%%%%%|||||||||||||| ||
---------------------------------------------------------------------------||||||||||||||||||||||----------------------SSSCCC---------------------||||||||----|||||||||----|||||||||||||||||||||||||||||
-------------------------------------%%%%%%%%%%%%%%%%%%%%%%%%%%%%%%%%%%%%%%||||||||||||||||||||||-------------------------------%%%%%%%%%%%-------|%%%%%%%%%--|||||||||----|||||||||||||||||||||||||||||
------%%%%%-------------------%%%----||||||||||||||||||||||||||||||||||||||||||||||||||||||||||||-------------------------------|||||||||||-----%%%%%%%%%%%%%%|||||||||----|||||||||||||||||||||||||||||
XXXXXX|||||XXXXXXXXXXXXXX-----|||----||||||||||||||||||||||||||||||||||||||||||||||||||||||||||||----XXXXXXXXXXXXXXXXXXXXXXXXXXX|||||||||||-----|||||||||||||||||||||||----|||||||||||||||||||||||||||||