--------------------------------------------------------------------------------------------------------------------------------------------------------------------------------------------------------
--------------------------------------------------------------------------------- ----------------------------------------------------------------------------------------------------------------------
-------------------------------------------------------------------------------------------------------------------------------------------------------- -----------------------------------------------
---------------------------------------------------------------------------------------------------------------- ---------------------------------------------------------------------------------------
------------------------------------------------------------------------------------------------------------------------------------------------ -------------------------------------------------------
--------------------------------------------------------------------------------------- ----------------------------------------------------------------------------------------------------------------
-------------------------------------------------------------- ------------------------------------------------------------------------------------------------- ---------------------------------------
--------------------------------------------------------------------------------------------------------------------------------------------------- ----------------------------------------------------
-----------------------------------------------------------------k-------------------- --------------------------- -------------------------------------------------------------------------------------
-----------------------------------------SU22SCCCC--%%%%%%% %%%%----------------------------------------------------------------------------------------------------------------------------------------
----------r-k------------------------------ --------||||||||||||-----------------------%%%%%-----------------------------------------------------------r----------- -------- ---------------------------
---------------------------------CS2CCCU------------|| |||||||||-----%%%%%%%%%%%-------|||||-------------------------------------2CSCS-------------------------- ---------------------------------------
-----  ---------------------------------------------||||||||||||-----|||||||||||-------|||||----------------------------------------------------------%%%%%%%%%%%--%%%%%%%------------------------------
----------------------------------------------------||||||||||||-----|||||||||||-------|||||------- ----------------r---------------------------------|||||||||||--|||||||--------------kk--------------
------%%%%%--------- -------------------------------||||||||||||-----|||||||||||-----%%%%%%%%%--------------------------------------------------------|||||||||||--|||||||------------------------------
  XXX |||||XXXXX XXX XXXXXX X X X X  XXXXX XXXX XXX ||||||||||||-----|||||||||||-----|||||||||----XX X X X X XX----X XXXXXXX  XXXXXXX XX X XX X X XXXX|||||||||||  X   XX XXX X  X   XX----X XXXXX XXF  