--------------------------------------------------------------------------------------------------------------------------------------------------------------------------------------------------------
--------------------------------------------------------------------------------------------------------------------------------------------------------------------------------------------------------
--------------------------------------------------------------------------------------------------------------------------------------------------------------------------------------------------------
--------------------------------------------------------------------------------------------------------------------------------------------------------------------------------------------------------
--------------------------------------------------------------------------------------------------------------------------------------------------------------------------------------------------------
--------------------------------------------------------------------------------------------------------------------------------------------------------------------------------------------------------
--------------------------------------------------------------------------------------------------------------------------------------------------------------------------------------------------------
--------------------------------------------------------------------------------------------------------------------------------------------------------------------------------------------------------
-----------------------------------------------------------------------------------------------------------------------------------------------------------------------------------g------g-------------
---------------------------------------------------------g----------------------------------------------------------------------------------------------------------------------------------------------
-----------------------------------------------------------------------------------------------U--------------------------------------------------------------------------------------------------------
--------------------------------------------------------%%%%%%%%%%%%%%-----------------------------kkgggkgkk--------------------------------gkggggggggg-------------%%%%%%%%%%%%%%----------------------
--------------------------------------------------------||||||||||||||-------------------------------%%%%%-----------------------------------%%%%%%%%%--------------||||||||||||||-----%%%%%%%----    %%
-----------------------------g--g----g-------%%%%%%%----||||||||||||||-------------------------------|||||--%%%%%%%%%-----%%%%%%----------r--|||||||||-%%%%%%%%%%%%%||||||||||||||-----|||||||----||| ||
------%%%%%----------------------------------|||||||----||||||||||||||-----------------%%%%%%%%%%%%--|||||--|||||||||-----||||||---%%%%%%%%--|||||||||-|||||||||||||||||||||||||||-----|||||||----||||||
XXXXXX|||||XXXXXXXXXXXXXX---XXXXXXXXXXX----XXXXXXXXXXXXX||||||||||||||---XXXXXXXXXXXXXX||||||||||||XXXXXXXXX|||||||||---XXXXXXXXXXX||||||||XXXXXXXXXXXX|||||||||||||||||||||||||||---XXXXXXXXXXXXX||||||