--------------------------------------------------------------------------------------------------------------------------------------------------------------------------------------------------------
--------------------------------------------------------------------------------------------------------------------------------------------------------------------------------------------------------
--------------------------------------------------------------------------------------------------------------------------------------------------------------------------------------------------------
--------------------------------------------------------------------------------------------------------------------------------------------------------------------------------------------------------
--------------------------------------------------------------------------------------------------------------------------------------------------------------------------------------------------------
--------------------------------------------------------------------------------------------------------------------------------------------------------------------------------------------------------
--------------------------------------------------------------------------------------------------------------------------------------------------------------------------------------------------------
--------------------------------------------------------------------------------------------------------------------------------------------------------------------------------------------------------
-----------------------------------------------------------------------g----------------------------------------g-g-------------------------------------------------------------------------------------
---------------------------------------------------------------------------------------------------------------------------CSCS2USSS--------------------------------------------------------------------
---------------------------------------------------------------------------------------------gkggkggggg--------%%%%%%%%%%-------------------------------------------------------------------------------
----------------------------------------------------ggkggkggg------------------------------r--||||||||---------||||||||||-------------------------------------------------------S2CSSCCU----------------
--------------------------------------------------r--|||||||-----------------------%%%%%%%%%--||||||||-%%%%%%%%||||||||||-------------------------------------------------------------------------------
-----------------------------g-g-g--------%%%%%%%%%--|||||||-%%%%%%%%--------------|||||||||--||||||||-||||||||||||||||||%%%%%%%%%%%%%-----g----g---------------g-------------g---------k---------------
------%%%%%-------------------------------|||||||||--|||||||-||||||||--------------|||||||||%%%%%%%%%%%|||||||||||||||||||||||||||||||------------------------------------------------------------------
XXXXXX|||||XXXXXXXXXXXXXX---XXXXXXXXXXXXXX|||||||||XXXXXXXXXX||||||||-----XXXXXXXXX|||||||||||||||||||||||||||||||||||||||||||||||||||----XXXXXXXXX---XXXXXXXXX---XXXXXXXXXXXXXXXXXXXXXXXXXXXXXXXX    XX