--------------------------------------------------------------------------------------------------------------------------------------------------------------------------------------------------------
--------------------------------------------------------------------------------------------------------------------------------------------------------------------------------------------------------
--------------------------------------------------------------------------------------------------------------------------------------------------------------------------------------------------------
--------------------------------------------------------------------------------------------------------------------------------------------------------------------------------------------------------
--------------------------------------------------------------------------------------------------------------------------------------------------------------------------------------------------------
--------------------------------------------------------------------------------------------------------------------------------------------------------------------------------------------------------
--------------------------------------------------------------------------------------------------------------------------------------------------------------------------------------------------------
--------------------------------------------------------------------------------------------------------------------------------------------------------------------------------------------------------
-------------------------------------------------------------------------------------------------------------Tt-----------------------------------------------------------------------------------------
-------------------------------------------------------------------------------------------------------------tt-----------------------------------------------------------------------------------------
--------------------------------Tt--------------------------------------Tt-----------------------------------tt-----------------------------------------------------------------------------------------
--------------------%%%%%%------tt--------------------------------------tt------------------G----------------tt------------------- %%%-------------G----------------------------------------------------
--------------------||||||--G---tt--------------------------------------tt----------%%%%%%%%%%%------%%%--%%%%%%%%----------------%|||-%%%%----%%%%%-----G-------------------------------------------K--
---------%%%%%%%%%--||||||-%%%%%%%%%%%-----------------KG---------------tt----------|||||||||||------|||2U||||||||----------------||||-||||----|||||----%%%%--%%%----------%%%------%%%%------%%%%    --
---------|||||||||--||||||-|||||||||||-----------------%%%%%%-------%%%%%%%%%%------|||||||||||------|||--||||||||-----%%%%-------||||-||||----|||||----||||--|||----------|||------||||------||||||||-%
XXXXXXXXX|||||||||XXXXXXXXX|||||||||||XXXXXXXXXXXXXXXXX||||||XXXXXXX||||||||||XXXXXXXXXXXXXXXXXXXXXXXXXXXX||||||||XXXXX||||XXXXXXXXXXXX||||----|||||XXXX||||--|||XXXXXXXXXX|||------||||XXXXXX||||||||X|