--------------------------------------------------------------------------------------------------------------------------------------------------------------------------------------------------------
--------------------------------------------------------------------------------------------------------------------------------------------------------------------------------------------------------
--------------------------------------------------------------------------------------------------------------------------------------------------------------------------------------------------------
--------------------------------------------------------------------------------------------------------------------------------------------------------------------------------------------------------
--------------------------------------------------------------------------------------------------------------------------------------------------------------------------------------------------------
--------------------------------------------------------------------------------------------------------------------------------------------------------------------------------------------------------
--------------------------------------------------------------------------------------------------------------------------------------------------------------------------------------------------------
--------------------------------------------------------------------------------------------------------------------------------------------------------------------------------------------------------
-------------------------------------------------------------------------------------------------------------------------------------------------------------------------Tt-----------------------------
-------------------------------------------------------------------------------------------------------------------------------------------------------------------------tt-----------------------------
----------------------------------------------------------------G--------------------------------------------------------------------------------------------------------tt-----------------------------
---------------------------------------------------------------22SSCSC-----------K----G---------------------------K--------------- ----------%%%%%%%-%%------------------tt-----------------------------
------------------------------------------------G----%%%%%-------------------%%%%%%%%%%%%-----------------------%%%%%%%%%%%%------%----------||%%%%%%%%%%%%-----------%%%%%%%%-------------------------%
----------------------------------------------%%%%%--|||||-------------------||||||||||||-------22--------------||||||||||||------|-----%%%%-||||||||||||||K----------||||||||-----------------%%%   --|
------------------%%%%%-----------------------|||||--|||||-------------------||||||||||||-----------------------||||||||||||------|-----||||-||||||||||||||%%%%%%-----||||||||-----------------||||||--|
XXXXXXXXXXXXXXXXXX|||||XXXXXXXXXXXXXXXXXXXXXXX|||||XX|||||XXXXXXXXXXXXXXXXXXX||||||||||||XXXXXXXXXXXXXXXXXXXXXXX||||||||||||XXXXXXXXXXXXXXXXXXX||||||||||||||||||XXXXX||||||||XXXXXXXXXXXXXXXXX|||||| X|