---------------------------------------------------------------------------------------------------------------------------------     ------------------------------------------------------------------
---------------------------------------------------------------------------------------------------------------------------------     ------------------------------------------------------------------
---------------------------------------------------------------------------------------------------------------------------------     ------------------------------------------------------------------
---------------------------------------------------------------------------------------------------------------------------------     ------------------------------------------------------------------
---------------------------------------------------------------------------------------------------------------------------------     ------------------------------------------------------------------
---------------------------------------------------------------------------------------------------------------------------------     ------------------------------------------------------------------
---------------------------------------------------------------------------------------------------------------------------------     ------------------------------------------------------------------
---------------------------------------------------------------------------------------------------------------------------------     ------------------------------------------------------------------
-------------------------------------------------------------------------------------------------------------------Tt------------     ------------------------------------------------------------------
-------------------------------------------------------------------------------------------------------------------tt------------     ------------------------------------------------------------------
---------------------------Tt-----------------------------Tt-------------------------------------G-----------------tt------------     ------------------------------------------------K-----------------
---------------------------tt---------------------U2CUS---tt----------------------------%%%%%%%-%%-----------------tt--G---------     --------------------G-----------------------CUU-%%%%--------------
---------------------------tt%%%%%%%%%%%------------------tt----------------G-----------|||%%%%%%%%%%%---------%%%%%%%%%---------     -------------------U2CU-------------------------||||--------------
--------%%%%%%%%-------%%%%%%%%%%%||||||---------------%%%%%%%%%-----------%%%---%%%%%--||||||||||||||----USUU-|||||||||---------     ------------------------------------------K-----||||-K---------K--
--------||||||||-------|||||||||||||||||---------------|||||||||-----------|||---|||||--||||||||||||||---------|||||||||---------     %%%%-----%%%%--------------------%%%%----%%%----||||%%%%%------%%%
XXXXXXXXXXXXXXXXXXXXXXX|||||||||||XXXXXXXXXXXXXXXXXXXXX|||||||||XXXXXXXXXXX|||---|||||XXXXX|||||||||||XXXXXXXXXXXXXXXXXXXXXXXXXXX     ||||-----||||XXXXXXXXXXXXXXXXXXXX||||----|||XXXXXXXX|||||------|||