------------------ -- ------------------------------------------- ------------ ----------------- ---------------------------------------------------------------------------- --------------------------
------------------ -------------------------------------------------------------------------------------------------------------------------------------------------------------------------------------
------------------------------- -------------------------------------------------------------------------- ----- ----- ----------------- ---------------------------------------------------------------
------------------- ---------------------------------------------------------------------------------------------------------------------------------------------------- --------- --------- -----------
-------------- ---------------------- --------------------- -------------- -------------- -------- -------------------------- ---------- ---------------------------------------------------- ----------
------------------------------------------------------------------------------ ---------------------------------------------------------------------- ------------------------------- -- ---------------
---------  -------------------- ------------------------- ------------------------------------------------------------------------------------------- ----------------------- --------------------------
---------------- ---------------- ----------------------- ------------------------- ----------------------------------- ---------- ---------------------------- ---------------------- -----------------
-------------------------------------CSS2SCSCC--------------g------------------------------- ------------------------------------- ---------------------------------------------gg----r-----------------
-------------- --- ----------------kgg ggggggkgg---------------------------------- ------------------------------------ ------------ ------------------ -------- ---------------------------------------
---------------------------------r---- --------------------------------U---------------- -----------g---------------------------------------------------------------------------------------------------
-------------------- ----%%% %%%%%---- ---------%%   %%%%%%------------- --ggggkgggkkgg--------------------------- --------%%%% %-------------------------------------- %%%% %%------%%---------------- 
-------------------------|||||||||---- - -------|||||||||||--------- ----------------- --------- --------------------------||||||------------------ -------%%%%%%% ----||||||||------|%%%%%-------------
-------------------------|||||||||% %%%%%%% %%%%|||||||||||--------- --------- - ------%  %%%%%%%%%%---------- -------g ---|g||||- -gg------- -------------||||||||----||||||||----- |||||| -%%%%% %%F% 
------%%%% ----- --------||||||||||||||||||||||||||| ||||||---%%%%   % %%%%------------|||||||||||||----%%%%%%% %%%%%------||||||--------------------------||||||| ----||||||||------||          ||||%||
 XXXXX|||||XXXX XXX  X XX||||||||||| |||||||||||||||||||||| --||||| |||||||XXXXXXXXXXXX ||||||||||||----| |||||||||||---- XXXXXXXXX -----XX XXXXXXX XX---XX XXXXXXXXXXX|||||| |----- XXXXXX X|||||||||||