--------------------------------------------------------------------------------------------------------------------------------------------------------------------------------------------------------
--------------------------------------------------------------------------------------------------------------------------------------------------------------------------------------------------------
--------------------------------------------------------------------------------------------------------------------------------------------------------------------------------------------------------
--------------------------------------------------------------------------------------------------------------------------------------------------------------------------------------------------------
--------------------------------------------------------------------------------------------------------------------------------------------------------------------------------------------------------
--------------------------------------------------------------------------------------------------------------------------------------------------------------------------------------------------------
--------------------------------------------------------------------------------------------------------------------------------------------------------------------------------------------------------
-------------------------------------------------------------------------------Tt-----------------------------------------------------------------------------------------------------------------------
-------------------------------------------------Tt----------------------------tt---Tt------------------------------------------------------------------------------------------------------------------
----------Tt-------------------------------------tt----------------------------tt---tt------------------------------------------------------------------------------------------------------------------
----------tt--G----------------------------------tt-KG-------------------------tt-K-tt------------------------------------------------------------------------Tt----------------------Tt----------------
----------tt%%%%%%-----------------K----------%%%%%%%%%---------------------%%%%%%%%tt---------K---------------------------------- --F------------------------tt----------------------tt------K---------
------%%%%%%%%%%%|-----------%%%%--%%%--------|||||||||---------------------||||%%%%%%%%%%--%%%%-----%%%%%-%%%--%%%%%-------------%K--------------------------tt----------------------tt----%%%%%%%%%%--
------|||||||||||%%%%%%------||||--|||--------|||||||2CU--------------------||||||||||||||--||||-----|||||-|||--|||||-------------SS2 -%%%%%------%%%%---%%%%%%%%%%-------------------tt----||||||||||--
------|||||||||||||||||------||||--|||--------|||||||||---------------------||||||||||||||--||||-----|||||-|||--|||||------------------|||||------||||---||||||||||--------------%%%%%%%%%%%||||||||||--
     XXX X  XXXX ||||||X XX  ||||--|||XXX   X  X X XXXXXXX  X XXXXXXXX XX X XXX XXXXXX X    ||||-----|||||X|||--|||||XXXX XXXXXXXXX XXX|||||------||||XXX||||||||||XXX XXXXXX XXX|||||||||||X XXXX   XXX