-------------------------------------------------------------------------------------------------------------------------------       ------------------------------------------------------------------
-------------------------------------------------------------------------------------------------------------------------------       ------------------------------------------------------------------
-------------------------------------------------------------------------------------------------------------------------------       ------------------------------------------------------------------
-------------------------------------------------------------------------------------------------------------------------------       ------------------------------------------------------------------
-------------------------------------------------------------------------------------------------------------------------------       ------------------------------------------------------------------
-------------------------------------------------------------------------------------------------------------------------------       ------------------------------------------------------------------
-------------------------------------------------------------------------------------------------------------------------------       ------------------------------------------------------------------
-------------------------------------------------------------------------------------------------------------------------------       ------------------------------------------------------------------
-------------------------------------------------------------------------------------------------------------------------------       ------------------------------------------------------------------
----------------------------Tt-------------------------------------------------------------------------------------------------       ------------------------------------------------------------------
----------------------------tt-----------------------------------------------------------------------Tt------------------------       ------------------------------------------------------------------
------------G----G----------tt-----------------------------------------------------%%%Tt%%%%---------tt-----------%%%%%%%-%----       --G-K-----------------------------------------%%%-----------------
-----------%%%%%%%%---------tt--G----------CUSC-----------------G------------------|||t-||||------G--tt---------%%%%%||||-|---%       --%%%------------G-------K--------------G-----%%%%%%%%%%%---------
-----------||||||||----%%%%%%%%%%%---------------%%%--%%%%---%%%%%------%%%%------%%%%%%%%%%-----%%%%%%%%%------|||||||||-|---|       --|||----%%%%---%%%%%----%%%----------%%%%----|||||||||||---------
-----------||||||||----|||||||||||---------------|||--||||---|||||------||||------||||||||||-----|||||||||------||||%%%%%%%%%%|       --|||----||||---|||||----|||----------||||----|||||||||||---------
XXXXXXXXXXX||||||||XXXX|||||||||||XXXXXXXXXXXXXXX|||--||||XXX|||||------||||XXXXXXXXXXXXXXXXXXXXX|||||||||XXXXXXXXXX|||||||||||       --|||XXXX||||---|||||XXXXXXXXXXXXXXXXXXXXXXXXX|||||||||||XXXXXXXXX