------------- --------------- ------------------------------------------------------------------------------------------------------------------------ ----------------- -------------------------------
------------------------ ------------- -----------------------------------------------------------------------------------------------------------------------------------------------------------------
---------------- ----------------------------------------------------------------------------------------------------------------- ---------------------------------------------------------------------
-------- -------------------------------------------------------------- ---- --------------------------------------------------------------- -----------------------------------------------------------
---------------------------------------------------- ----------------------------------------------------------------- --------------------- -----------------------------------------------------------
------------------------------------------------------------------- ------------------------------------------------- ----------------------------------------------------------------------------------
---------------------------------------------------------------------------------------------------------------------------------------------------------------------------------------- ---------------
-------------------------------------------------------------------------- ------------------------------------------------------------------------------------------------------------------------ ----
--- -------------------------------------------------------------------------------- -------------------------------- ---------- ----------------------------------- -----------------------------------
---------------------------------------------------------------------------------------------------------------------------------------------------------------- ---------------------------------------
-------------- --------------Tt---------Tt------------------------------------------------------- ------------------------------------------------------------------------------------------------------
-----------------------------tt---------tt-----------------------------------------------------------GG---------------------------F------------- ------------------------------------- -----------------
--- ------------%%%%%%%%%%---tt-G-------tt------------------USUSS-K -------G----------------- %%%%%%%%%%--------------------------%-----2UU---- ------------------------------------ -------------------
----------------||||||||%%%%%%%%%%------tt-K---------------------%%%%%%%%%%%%-----------------||||||||||222C22--------------------|----G---------------G----------------------- ------------------ -----
----------------||||||||||||||||||---%%%%%%%%%--%%%%-------------||||||||||||-%%%------%%%%---||||||||||-------------------%%%%%--|--%%%--------------%%%%%--%%%--%%%%%%%%%%%------------- --------%%%%%
 XXXX XXXXXXXXXXXXXXXXXXXXXXXXXXXXXXX|||||||||XX||||XXXXXXXXXXXXX||||||||||||X|||------||||XXXXXXXXXXXXXXXXXXXXXXXXXXXXXXXX|||||--|--|||XXXXXXXXXXXXXX|||||--|||XX|||||||||||XXXXXXXXXXXXXXXXXXXXXX|||||