--------------------------------------------------------------------------------------------------------------------------------------------------------------------------------------------------------
--------------------------------------------------------------------------------------------------------------------------------------------------------------------------------------------------------
--------------------------------------------------------------------------------------------------------------------------------------------------------------------------------------------------------
--------------------------------------------------------------------------------------------------------------------------------------------------------------------------------------------------------
--------------------------------------------------------------------------------------------------------------------------------------------------------------------------------------------------------
--------------------------------------------------------------------------------------------------------------------------------------------------------------------------------------------------------
---------------------------------------------------------------------------------------------------------SU22CC-----------------------------------------------------------------------------------------
------------------------------------------------------------------------------------------------------------------------------------------------------------------------------------%%%%%%--------------
------------------------------------------------------------------------------------------k----------r------------------------------------------------------------%%%%%%-----------%%%||||--------------
--------------------------------------------------------k---------------------------------------------------------------------------------------------------------||||||-----------|||||||--------------
-----------------------------------------2CCS--------------------------------------------%%%%%%%%%%%%%%%%%%%%%%%%%------------------------------------------------||||||---r------%%%%%%%%%%%%%%%%    %%
----------------------------------------ggkggkg------------------------------------------|||||||||||||||||||||||||-----------------------------------------------%%%||||----------||||||||||||||||||| ||
--------------------------------------r-----------------------tt-------------------------|||||||||||||||||||||||||----------------------------------------------%%%%%%%%%%%%%%%%%%||||||||||||||||||||||
-------------------------%%%%%%%%%%%%%%--------%%%%%%%%-------tt--------------%%%%%%%%%%%|||||||||||||||||||||||||----------------------%%%%%%-------%%%%%%%----||||||||||||||||||||||||||||||||||||||||
------%%%%%--------------||||||||||||||--------||||||||-------tt--------------||||||||||||||||||||||||||||||||||||-----%%%%%%%%%%%%-----||||||-------|||||||----||||||||||||||||||||||||||||||||||||||||
XXXXXX|||||XXXXXXXXXXXXXX||||||||||||||XXXXXXXX||||||||---XXXXXXXX-----XXX----||||||||||||||||||||||||||||||||||||-----||||||||||||---XXXXXXXXXX---XXXXXXXXXXXXX||||||||||||||||||||||||||||||||||||||||