--------------------------------------------------------------------------------------------------------------------------------------------------------------------------------------------------------
--------------------------------------------------------------------------------------------------------------------------------------------------------------------------------------------------------
--------------------------------------------------------------------------------------------------------------------------------------------------------------------------------------------------------
--------------------------------------------------------------------------------------------------------------------------------------------------------------------------------------------------------
--------------------------------------------------------------------------------------------------------------------------------------------------------------------------------------------------------
-------------------------------------------------------------------------------------%%%%%--------------------------------------------------------------------------------------------------------------
-------------------------------------------------------------------------------------|||||--------------------------------------------------------------------------------------------------------------
-------------------------------------------------------------------------------------|||||--------------------------------------------------------------------------------------------------------------
-------------------------------------------------------------------------------------|||||------------y-------------------------------------------------------------------------------------------------
-------------------------------------------------------------------------------------|%%%%%%%-------%%%%----------------g-r-----------------------------------------------------------------------------
-----------------------------------#---#------------------------------CCSC-----------||||||||-------||||-----#---#------%%%-----------------------------------------------------------------------------
----------------------------------##---##--------------------#--#--------------------||||||||-------||||----##---##-----|||-----------------------------------------------------------------------------
---------------------------------###---###---------%%%%%%%%%%%--%%%------------------||||||k|-y-%%%%%%%%%%%%%%---%%%%---||r---y-------%%%%--%%%%--------------------------------------------------------
-----------------------%%%%%%%%%%%%%---%%%%%-------|||||||||||--|||-k----G---------%%%%%%%%%%%%%||||||||||||||---||||%%%%%%%%%%%%%%%%%||||--||||--------------------------------------------------------
-----------------------|||||||||||||---|||||-------|||||||||||--|||%%%%%%%%%%%%--%%|||||||||||||||||||||||||||---|||||||||||||||||||||||||--||||%%%%%%%% %%%%%%%%%%%%%%%%%%%%%%%%%%%%%%%%%%%%%%%%%    %%
XXXXXXXXXXXXXXXX--XXXXX|||||||||||||---|||||XX---XX|||||||||||--|||||||||||||||--|||||||||||||||||||||||||||||---|||||||||||||||||||||||||--||||||||||||X|||||||||||||||||||||||||||||||||||||||||||||||