-------------------------------------------------------------------------------------------------------------------------------------------------------    ---------------------------------------------
-------------------------------------------------------------------------------------------------------------------------------------------------------    ---------------------------------------------
-------------------------------------------------------------------------------------------------------------------------------------------------------    ---------------------------------------------
-------------------------------------------------------------------------------------------------------------------------------------------------------    ---------------------------------------------
-------------------------------------------------------------------------------------------------------------------------------------------------------    ---------------------------------------------
-------------------------------------------------------------------------------------------------------------------------------------------------------    ---------------------------------------------
-------------------------------------------------------------------------------------------------------------------------------------------------------    ---------------------------------------------
-------------------------------------------------------------------------------------------------------------------------------------------------------    ---------------------------------------------
-------------------------------------------------------------------------------------------------------------------------------------------------------    ---------------------------------------------
-------------------------------------------------------------------------------------------------------------------------------------------------------    ---------------------------------------------
------------------------#--#-------Tt------------------------------------------------------------------------------------------------------------------    ---------------------------------------------
-----------------------##--##------tt-------------------------------SCSS-------------------------------------------------------------------------------    ---------------------------------------------
----------------------###--###-----tt-------------------------------------------------------------%%--%%------------Tt-Tt------------------------------    ---------------------------------------------
--------------------%%%%%--%%%%%%%%%%%%%%---%%%-----------%%---%%-------------------------%%%--%%%||--||------------tt-tt-----------------------%%%%%%%    %%%%%%%%%%%%%%%%%%%%%%%%%%%%%%%%%%%%%%%%%%%%%
--------------------|||||--||||||||||||||---|||%%%%---%%%%||---||-g-----------------------|||--|||||--||%%%%%%%%%---tt-tt----%%---%%%%%%%--%%%%%|||||||    |||||||||||||||||||||||||||||||||||||||||||||
XXXXXXXXXXXXXXX---XX|||||--||||||||||||||---|||||||---||||||---||XXXXXXXXXXXX---XXXXXX--XX|||--|||||--|||||||||||XXXXXXXXXXXX||---|||||||--||||||||||||    |||||||||||||||||||||||||||||||||||||||||||||