--------------------------------------------------------------------------------------------------------------------------------------------------------------------------------------------------------
--------------------------------------------------------------------------------------------------------------------------------------------------------------------------------------------------------
--------------------------------------------------------------------------------------------------------------------------------------------------------------------------------------------------------
--------------------------------------------------------------------------------------------------------------------------------------------------------------------------------------------------------
--------------------------------------------------------------------------------------------------------------------------------------------------------------------------------------------------------
--------------------------------------------------------------------------------------------------------------------------------------------------------------------------------------------------------
--------------------------------------------------------------------------------------------------------------------------------------------------------------------------------------------------------
--------------------------------------------------------------------------------------------------------------------------------------------------------------------------------------------------------
--------------------------------------------------------------------------------------------------------------------------------------------------------------------------------------------------------
------------------------------------------------------------------------------------------------------------------------------------%%%%%---------------------------------------------------------------
---------------------------------------#---#----------------------------------------------------------------------------------------|||||---------------------------------------------------------------
--------------------------------------##---##-----r-g------------------tt--tt----------------------------------------------------%%%%%%%|---------------------------------------------------------------
-------------%%%%%---%%%%%----------%%%%---%%%%%%%%%%%%%%%%%---%%%%%---tt--tt-%%%---%%%-----------%%%%%%%%%%%%--%%%%%---#---#----||||||||---------------------------------------------------------------
-------------|||||---|||||----------||||---|||||||||||||||||---|||||---tt--tt-|||---|||---Tt------||||||||||||--|||||--##---##---||||||||----------------------------------------------------------F----
-------------|||||---|||||%%%%--%%%%||||---|||||||||||||||||---|||||%%%%%%%%%%|||---|||---tt------||||||||||||--|||||%%%%---%%%%-||k|||||rr-------------------------------------------------------- ----
XXXXXXXXXXXXX|||||---|||||||||--||||||||---|||||||||||||||||---||||||||||||||||||---|||XXXXXXXXXXX||||||||||||--|||||||||---||||XXXXXXXXXXXXXXXXXXXXXXXXXFXXXXXXXXXXXXXXXXXXXXXXXXXXXXXXXXXXXXXXXXXXXXXX