--------------------------------------------------------------------------------------------------------------------------------------------------------------------------------------------------------
--------------------------------------------------------------------------------------------------------------------------------------------------------------------------------------------------------
--------------------------------------------------------------------------------------------------------------------------------------------------------------------------------------------------------
--------------------------------------------------------------------------------------------------------------------------------------------------------------------------------------------------------
--------------------------------------------------------------------------------------------------------------------------------------------------------------------------------------------------------
--------------------------------------------------------------------------------------------------------------------------------------------------------------------------------------------------------
--------------------------------------------------------------------------------------------------------------------------------------------------------------------------------------------------------
--------------------------------------------------------------------------------------------------------------------------------------------------------------------------------------------------------
----------------------------------------------------------------------------g---------------------------------------------------------------------------------------------------------------------------
-------------------------------------------------------------------------------------------------------------------------------------------ggkggggkkg---------------------------------------------------
-----------------------------------------------------------2S--------------------%%%%%---------------------------------------------------r--||||||||---------------------------%%%%%%%%%%%%%------------
---------------------------------------------------------gkggkgg-----------------|||||-----------------%%%%%%%-------SSUSCSSSS--%%%%%%%%%%--||||||||-%%%%%%%%%%%------g--------|||||||||||||------------
-------------------------------------------------------r------------------------%%||||-----------------|||||||------------------||||||||||--||||||||-|||||||||||---------------|||||||||||||------------
--------------------------g------g--------%%%%%%%%%%%%%%--------%%%%%%%%%%%-----||||||-------gg--------|||||||-----g------------||||||||||%%%%%%%%%%%|||||||||||-----%%%%%%%%%%|||||||||||||%%%%%%    %%
------%%%%%-------------------------------||||||||||||||--------|||||||||||----%%%%%%%%---------------XXXX||||------------------||||||||||||||||||||||||||||||||-----|||||||||||||||||||||||||||||||| ||
XXXXXX|||||XXXXXXXXXXXXXX---XXXXXXXXXXXXXX||||||||||||||XXXXXXXX|||||||||||----||||||||-----XXXXXXXXXXXXXXXXXXXXXXXXXXXXXXXXXXXX||||||||||||||||||||||||||||||||-----|||||||||||||||||||||||||||||||||||