------------------------- -------------------------------------------------------------------------------------------------------------------------- ---------------------------------------------------
---------------------------------------------------------------------------------------------------------------------------------------------------------------------- ---------------------------------
-------------- -------------------------------------------------------------------------------------------------------------------------------------------------- ------------------------- ------------
--------------------------------------------------------------------------------------------------------------------------------------------------------------------------------------------------------
---------------------------------------------------------------------------------------------------------------- --------------- -------- --------------------------------------------------------------
------------- ------------------------------------------------------------------------------------------------------------------------------------------------------------------------------------------
--------------------------------------------------------------------------------------------------------------------------------------------------------------------------------------------------------
--------------------------------------- ----------------------------------------------------------------------------------------------------------------------------------------------------------------
-------------------------------Tt---------------------------------------------------Tt------------------------Tt------------------------------------------- --------------- ----------------------------
-------------------------Tt----tt---------------------------------------------------tt------------------------tt-----------------------Tt----- --------------- -----------------------------------------
-------------------------tt----tt---------------------------------------------------tt--------------- --------tt-----------------------tt---------------------------------------------------------------
-------------------------tt%%%%%%%%%----------------------G-KSCU----------------G-US22SC----------------------tt------------------ ----tt---------------------- ----------------------------------------
---- ---------K----------tt|||%G%%%|-%%%------------------%%%---%%%%%----%%%%--%%%%%%%%%%%%---------------%%%%%%%%%%--------------%-%-%%%%%%--------------------G-------------------------------------- 
-------%%%--%%%------%%%%%%%%%%%||||-|||------------------|||---|||||----||||--||||||||||||-%%%---%%%%----||||||||||--------------| |-||||||-U---K---------- ---%%%%------------------------------------
-------|||--|||------| |||||||||||||-|||------------------|||---|||||----||||--||||||||||||-|||---||||----||||||||||--------------%%%%||||||--%%%%-----%%%%%----||||------------------------------------
XXXXXXX|||--|||XXXXXXXXXXXXXXXXXXXXXX|||XXX XXXXXXXXXXXXXX|||XXX|||||----||||XXXXXXXXXXXXXXX|||---||||XXXXXXXXXXXXXXXXXXX XXXXXXXX||||||||||XX||||-----||| |XXXXXXXXXXXXXXXXXXXXXXXXXXXXXXXXXXXXXXXXXXXX