--------------------------------------------------------------------------------------------------------------------------------------------------------------------------------------------------------
--------------------------------------------------------------------------------------------------------------------------------------------------------------------------------------------------------
--------------------------------------------------------------------------------------------------------------------------------------------------------------------------------------------------------
--------------------------------------------------------------------------------------------------------------------------------------------------------------------------------------------------------
--------------------------------------------------------------------------------------------------------------------------------------------------------------------------------------------------------
--------------------------------------------------------------------------------------------------------------------------------------------------------------------------------------------------------
--------------------------------------------------------------------------------------------------------------------------------------------------------------------------------------------------------
--------------------------------------------------------------------------------------------------------------------------------------------------------------------------------------------------------
--------------------------------------------------------------------------------------------------------------------------------------------------------------------------------------------------------
------------------------------------------------------------------------------------------------------------------------------------Tt------------------------------------------------------------------
------------------------------------------------------------------------------------------------------------------------------------tt------------------------------------------------------------------
------------------------K--------------------------------------------------------------------------------------------------------- -tt------------------------------------------------------------------
---------U2CSS---------%%%%---------G------------------%%%%%%------------%%%--%%%-------------------------------------------------%-tt------------------------%%%%------%%%%----------------------------
----------------U2U----||||-------%%%%%%%%%%%%%%-------||||||------------|||--|||--------%%%%%%---------------------------------%%%%%%%%%%--------------------||||------||||----------------------------
----------------------%%%%%%------||||||||||||||-------||||||------------|||--|||--------||||||---------%%%%%%%%%---------------||||||||||--------------------||||------||||%%%----%%%%%----------------
XXXXXXXXXXXXXXXXXXXXXX||||||XXXXXXXXXXXXXXXXXXXXXXXXXXXXXXXXXXXXXXXXXXXXX|||--|||XXXXXXXX||||||XXXXXXXXX|||||||||XXXXXXXXXXXXXXX||||||||||XXXXXXXXXXXXXXXXXXXX||||------|||||||----|||||XXXXXXXXXX    XX