--------------------------------------------------------------------------------------------------------------------------------------------------------------------------------------------------------
--------------------------------------------------------------------------------------------------------------------------------------------------------------------------------------------------------
--------------------------------------------------------------------------------------------------------------------------------------------------------------------------------------------------------
--------------------------------------------------------------------------------------------------------------------------------------------------------------------------------------------------------
-------------------------------------------------------------------2C-----------------------------------------------------------------------------------------------------------------------------------
--------------------------------------------------------------------------------------------------------------------------k-----------------------------------------------------------------------------
--------------------------------------------------------------------------------------------------------------------------------------------------------------------------------------------------------
---------------------------------------------------------------------------------------CSC2CSSSCS-----------------------%%%%%---------------------------------------------%%%%%-------------------------
------------------------------------------------------------------%%%%%---------------ggggggggkgggg---------------g-----|||||----SUCCSC-----------------------------------|||||-------------------------
------------------------------------------------------------------|||||-------------r-----------------------------------|||||----------------------2UC22-----------------%%%|||-------------------------
------------------------------------------------------------------|||||--%%%%%%%%%%%%--------------%%%%%%%%%%%%%%-------|||||---k----------------------------------------||||||--k----------r-----------
----------------------------------------------------------------%%%%%%%%%||||||||||||--------------||||||||||||||-----%%%%%%%%%-------------------k--------%%%%%%%%%%---%%%%%%%%------------------------
----------------------------------------------------------------|||||||||||||||||||||%%%%%%%%%%%%%%||||||||||||||-----|||||||||%%%%%%%%%%%%%%%%%%----------||||||||||---||||||||%%%%%%%%%%%%%%----------
----------------------------------------------g-----%%%%%%%%----|||||||||||||||||||||||||||||||||||||||||||||||||-----|||||||||||||||||||||||||||%%%%%%%%%%||||||||||---||||||||||||||||||||||----------
------%%%%%-----------------------------------------||||||||----|||||||||||||||||||||||||||||||||||||||||||||||||-----|||||||||||||||||||||||||||||||||||||||||||||||---||||||||||||||||||||||----------
XXXXXX|||||XXXXXXXXXXXXXX-----XXX----XXXXXXXXX----XXXXXXXXXXXXXX|||||||||||||||||||||||||||||||||||||||||||||||||-----|||||||||||||||||||||||||||||||||||||||||||||||---||||||||||||||||||||||XXXX    XX