--------------------------------------------------------------------------------------------------------------------------------------------------------------------------------------------------------
--------------------------------------------------------------------------------------------------------------------------------------------------------------------------------------------------------
--------------------------------------------------------------------------------------------------------------------------------------------------------------------------------------------------------
--------------------------------------------------------------------------------------------------------------------------------------------------------------------------------------------------------
--------------------------------------------------------------------------------------------------------------------------------------------------------------------------------------------------------
--------------------------------------------------------------------------------------------------------------------------------------------------------------------------------------------------------
--------------------------------------------------------------------------------------------------------------------------------------------------------------------------------------------------------
--------------------------------------------------------------------------------------------------------------------------------------------------------------------------------------------------------
------------------------------------------------------------------------------------------------------------------------Tt------------------------------------------------------------------------------
------------------------------------------------------------------Tt----------------------------------------------------ttTt----------------------------------------------------------------------------
------------------------------------------------------------------tt----------------------------------------------------tttt----------------------------------------------------G--------------------G--
------------------------------------------SC2---------------------tt--------------K-----------------------------------%%%%tt%%---- ------------------------------------------%%G%%---------------% -  %-
---------------------------------------------%%%%%%%%%------------tt---G----%%%%%%%%%%---------------%%%%-------------|%%%%%%%%%--%-------G------------G---------------------|%%%%---------------||-|||-
---------------------------------------------|||||||||-------%%%%%%%%%%%----||||||||||%--------------||||---------%%%%%%%%%|||||--|------%%%%%%%-----%%%%%-------------------|||||------------%%%%    %%
------------------------------%%%%%--%%%%----|||||||||-------|||||||||||----|||||||||||--------------||||---------||||||||||||||--|------|||||||-----|||||-------------------|||||------------||||||||||
XXXXXXXXXXXXXXXXXXXXXXXXXXXXXX|||||--||||XXXX|||||||||XXXXXXX|||||||||||XXXX||||||||||XXXXXXXXXXXXXXXXXXXXXXXXXXXXXXXXXXXXXXXXXXXXXXXXXXXXXX||||-----|||||XXXXXXXXXXXXXXXXXXXX||||XXXXXXXXXXXX||||||||||