---------------------------------------- ------------------------------------------------------------------------------------------------------------------- ---------------------- --------------------
---------- --------------------- ----------------------------------------------- ------------------------------------------------------------------------------------------------- ----------- ---------
------------------------------------------------------------- --------------------------------------------------- -------------------------------------------------------------------- -----------------
----------------------------------- ------------------------ ------------------------------------------------------------ ----- -------------------------- ---------------------------------------------
--------------------------------------------- ----------------------------------------------------------------------------------------- ----------------- ----------------------------------------------
------------------------------------  ------------------------------------------------------------------------------------------------------------------------------------------------------------------
-------- --------------------------------------------------------------------------------- ------------------------------------- ------------------------ ----------------------------------------------
--- -------------------------------------------------------------------------------------------------------------- ----- ---------------------- -- -------------- --------------------------------------
--------------------------------------------------------------------------------------------------------------------------------- -----g--k---------------k-----------k-----r---------------------------
---------------------------------------------- ------------------------------ --------------------- ----------- S2  SUS--%%%%%%%%% %%%%-----------------------%%%%%-------------------------------------
-------------------------------------------------------------------------------------------------------------------------||||||||||||||-----------------------|%%% -------------------------------------
-----------------------------------------g-g ----U---ggkgkggkgg----------------- ------------------------USS------------- |||||||||||||-----------------------|||||---------% %%%%------------% %%%%%F% 
----- ----------- -------------------------------------------------------------g---------g--------- ----------------- ---||||||||||||||-----%%%%%% %%%% %---%%%%%  %%-------||||||--- --------|||||||%||
------------------------------%%%%%% ------------------%%%%%%--%%%%%%% %%------------------  %%%%%% ---------------------||||||||||||||-----|||||||||||||---|||||||||-------||||| ---%% %% %%%||||||||||
------% % %-------------------|||||||------------------||||||- ||||||||||-----% %%%  % %  %|||||||||---------------------||||||||||||||- ---|||||||||||||---|||||||||-----%%%%%%% %% |||||||||||||||||||
 XXX X|||||XXXXXX X  XXX ---XXXXXX XXXX ---XXXXXX   XXXXXXXXXXX||||||||||-----|||||||||||| |||||||||XXX  XXXXXXXXXXXX XXX||||||||||||||-----|||||||||||||---|||||||||-----|||||| |||||||||||||||||||||||