------------------ ------------------------------------------------------------------------------------------------------------------------------------------ ------------------------------------------
------------------ ------------------------------------------------------------------------------- ----------------------------------- ------------- ---------------------------------------------------
------------------ ------------------------------------------------------------ ------------------------------------- ----------------------------------------------------------------------------------
------------------ --------------------------------------------------------------------------------------------------- ---------------------------------------------------------------------------------
----------- --------------------------------------------------------------------------------------------------------------------------------------------------------------------------------------------
---------------------------------------------------------------------------------------- ---------------------------------------------------------------------------------------------------------------
----------------------------------------------------------------------------------- --------------------------------------------------------------------------------------------------------------------
------------------------------------- -----U----------------------------------------------------------------------------------------------SCS2C---------------- ----------------------------------------
------------------------------------------------------------------- -gg-----g-----gk-----------------------------------------%%%%%%%--------------------------------------------------------------------
-------------------------------------------------%%%%%-----------------------------------------------------------------------|||||||----rk------------------- ------------------------------------------
-----------------------------------------------ggggggggg------------------------------------k---------------------r--------%%%%%%%%%%%%----------%%%%%%%%%%%%%%-----------------------------------------
--- ----------------------ggg---------%%%%%%%%%--|||||---------------------------------------------------------------------||||||||||||%%%%%%%%%%||||||||||||||--------k------r-------%%%%%%%-----------
---------------------------------tt---|||||||||--|||||--%%%%%%%%%%%%-----%%%%%%%%%---%%% %%%%-----%%%------------%%%%%%%%%%||||||||||||||||||||||||||||||||||||-----------------------|||||||-----------
---------------------------------tt---|||||||||--|||||--||||||||||||-----|||||||||---||||||||-----|||----%%%%%%%%||||||||||||||||||||||||||||||||||||||||||||||-----%%%%%%%%%%%-------|||||||-----------
------%%%%%----------------------tt---|||||||||%%%%%%%%%||||||||||||-----|||||||||---||||||||-----|||----||||||||||||||||||||||||||||||||||||||||||||||||||||||-----|||||||||||-------|||||||----%%%%F%%
 XXXXX|||||XXXXXXXXXXXXXX----XXXXXXXXX|||||||||||||||||||||| |||||||-----|||||||||---||||||||-----|||----||||||||||||||||||||||||||||||||||||||||||||||||||||||-----|||||||||||-----XX XXXXXXXXXX||||X||