--------------------------------------------------------------------------------------------------------------------------------------------------------------------------------------------------------
--------------------------------------------------------------------------------------------------------------------------------------------------------------------------------------------------------
--------------------------------------------------------------------------------------------------------------------------------------------------------------------------------------------------------
--------------------------------------------------------------------------------------------------------------------------------------------------------------------------------------------------------
--------------------------------------------------------------------------------------------------------------------------------------------------------------------------------------------------------
--------------------------------------------------------------------------------------------------------------------------------------------------------------------------------------------------------
--------------------------------------------------------------------------------------------------------------------------------------------------------------------------------------------------------
--------------------------------------------------------------------------------------------------------------------------------------------------------------------------------------------------------
--------------------------------------------------------------------------------------------------------------------------------------------------------------------------------------------------------
----------------------------------------------------------------------------------------------------------------------------------------------------------------------------g---------------------------
-----------------------------------------------------------------------------------------------------------------------------------U--------------------------------------------------------------------
------------------------------------------------------ggggkggggkk-----------------------------------%%%%%----SCUSCCS2------------------gkggkggggkggg----------------------------------------------------
----------------------------------------------------r--|||||||||------------------------------------|||||--------------------------------%%%%%%%%%--------------%%%%%%%%%%%-----------------------------
-------------------------------g-g-----g%%%%%%%%%%%%%--|||||||||-%%%%%%%%%%%%%------gg-----g--------|||||----------------g-----g---------|||||||||--%%%%%%%%%%%%|||||||||||-----%%%%%--g------g--g------
------%%%%%-----------------------------|||||||||||||--|||||||||-|||||||||||||----------------------|||||------------------%%%%%%%%%%%%--|||||||||--|||||||||||||||||||||||-----|||||-------------------
   X X||||| X XX X  XXXXX-----X X XXX XX|||||||||||||X XXX X X XX|||||||||||||----- XX XXX XXX----X XX X XX XXXXXXXXX  X---||||||||||||XX XXX XX XXX|||||||||||||||||||||||---XXXXXXXX-----XXXXXX XXXFXX