--------------------------------------------------------------------------------------------------------------------------------------------------------------------------------------------------------
--------------------------------------------------------------------------------------------------------------------------------------------------------------------------------------------------------
--------------------------------------------------------------------------------------------------------------------------------------------------------------------------------------------------------
--------------------------------------------------------------------------------------------------------------------------------------------------------------------------------------------------------
--------------------------------------------------------------------------------------------------------------------------------------------------------------------------------------------------------
--------------------------------------------------------------------------------------------------------------------------------------------------------------------------------------------------------
--------------------------------------------------------------------------------------------------------------------------------------------------------------------------------------------------------
----------------------------------------------------------------------------------------------------------------------------------------------------------------------------------------Tt--------------
-------------------------------------------------------------------------------------------------------------------------------------Tt-------------------------------------------------tt--------------
------------------------------------------Tt---------------------------------------------------------Tt------------------------------tt-------------------------------------------------tt--------------
------------------------------------------tt---------------------------------------------------------tt------------------------------tt-------------------------------------------------tt--------------
---------G--------------------------------tt--G-------------------------------------------------K----tt--------------------------- --tt----------------------------------------------%%%%%%%%%%---------
---------%%%%%----%%%%----------------%%%%%%%%%%%------G----------------US%%%%%%%%%%%-----------%%%--tt---------------------------%%%%%%%%%----------------------------------SSS2UUS-||||||||||---------
---------|||||----||||----------------|||||||||||------%%%%---------------|||||||||||--SCSSC----||%%%%%%%%------------------------|||||||||-------------G-G--------------------------||||||||||---------
---------|||||----||||-------%%%%%%---|||||||||||------||||---------------|||||||||||-----------||||||||||------------------------|||||||||------------%%%%%----%%%%%----------------||||||||||---------
XXXXXXXXX|||||----||||XXXXXXX||||||XXXXXXXXXXXXXXXXXXXXXXXXXXXXXXXXXXXXXXXXXXXXXXXXXXXXXXXXXXXXXXX||||||||XXXXXXXXXXXXXXXXXXXXXXXX|||||||||XXXXXXXXXXXX|||||----|||||XXXXXXXXXXXXXXXXXXXXXXXXXXXXX    XX