--------------------------------------------------------------------------------------------------------------------------------------------------------------------------------------------------------
--------------------------------------------------------------------------------------------------------------------------------------------------------------------------------------------------------
--------------------------------------------------------------------------------------------------------------------------------------------------------------------------------------------------------
--------------------------------------------------------------------------------------------------------------------------------------------------------------------------------------------------------
--------------------------------------------------------------------------------------------------------------------------------------------------------------------------------------------------------
--------------------------------------------------------------------------------------------------------------------------------------------------------------------------------------------------------
--------------------------------------------------------------------------------------------------------------------------------------------------------------------------------------------------------
---------------------------------Tt---------------------------------------------------------------------------------------------------------------------------------------------------------------------
---------------------------------tt---------------------------------Tt----------------------------------------------------------------------------------------------------------------------------------
---------------------------------tt---------------------------------tt----------------------------------------------------------------------------------------------------------------------------------
---------------------------------tt-K-------------------------------tt---------------K---------------------------------------------------Tt-------------------------------------------------------------
-----------------------------%%%%%%%%%%-----------------------------tt2SG------------UCUC--------------Tt------------------------- ------tt---------------------------------------------G---------------
-----------------------------||||||||||--------------------------%%%%%%%%--K---------------------------tt-------------------------%------tt------------------------K------------G-%%%%%%%%%-------------
--------------------G----%%%%||||||||||------------CCCUU---------||||||||%%%%%%%%%%------------------K-tt-------------------------|--%%%%%%%%%---------------------%%%%%------%%%-|||||||||-------------
-----------------%%%%%%%%%%%|||||||||||--------------------------||||||||||||||||||-----------------%%%%%%%%%---------------------|--|||||||||---------------------|||||------|||-|||||||||-------------
XXXXXXXXXXXXXXXXX|||||||||||XXXXXXXXXXXXXXXXXXXXXXXXXXXXXXXXXXXXXXXXXXXXX||||||||||XXXXXXXXXXXXXXXXX|||||||||XXXXXXXXXXXXXXXXXXXXXXXXXXXXXXXXXXXXXXXXXXXXXXXXXXXXXX|||||------|||XXXXXXXXXXXXXXXXX    XX