--------------------------------------------------------------------------------------------------------------------------------------------------------------------------------------------------------
--------------------------------------------------------------------------------------------------------------------------------------------------------------------------------------------------------
--------------------------------------------------------------------------------------------------------------------------------------------------------------------------------------------------------
--------------------------------------------------------------------------------------------------------------------------------------------------------------------------------------------------------
--------------------------------------------------------------------------------------------------------------------------------------------------------------------------------------------------------
--------------------------------------------------------------------------------------------------------------------------------------------------------------------------------------------------------
--------------------------------------------------------------------------------------------------------------------------------------------------------------------------------------------------------
--------------------------------------------------------------------------------------------------------------------------------------------------------------------------------------------------------
-------------------------------------------------------------------------Tt-----------------------------------------------------------------------------------------------------------------------------
-------------------------------------------------------------------------tt-----------------------------------------------------------------------------------------------------------------------------
-------------------------------------------------------------------------tt---------------------------------K-K-----------------------------------------------------------------------------------------
---------------------------------------------------------------------%%%%%%-%%%%---------------%%%%--%%%%%%%%%%------------------- ---------------------------------------------------------------------
-----------------------------------------%%%%%------%%%--------------||%%%%%%%%%---------------||||--||||||||||-----------G-------K----------------K-----------------------------------------%%%%-------
---------2CU----G------------------------|||||------|||--------------|||||||||||SC-------------||||--||||||||||-----22UU2UU--2SS2CSS-----%%%%%%%%%%%-----------------------------------------||||--   U2
----------------%%%%%%-------------------|||||------|||--------------|||||||||||---------------||||--||||||||||--------------------------|||||||||||----%%%%-----%%%%------------------------||||-------
XXXXXXXXXXXXXXXX||||||XXXXXXXXXXXXXXXXXXX|||||------|||XXXXXXXXXXXXXXXX|||||||||XXXXXXXXXXXXXXXXXXXXXXXXXXXXXXXXXXXXXXXXXXXXXXXXXXXXXXXXX|||||||||||XXXX||||-----||||XXXXXXXXXXXXXXXXXXXXXXXX||||X    XX