------------------------------------------------------------------------------------------------------------------------------------------------------- ----------------- -------------------- ---------
----------------------------------------------------- ----- -------- -- - ---------------------------------------- -------------------------------------------------------------------------------------
-------------------------------------------------------------  -------------------------------------------------------------- ----------  ----------------------------------------------------------- --
--------------------------------------------------------------------------------------------------------------------------------------------------------------------------------------------------------
--------------------- --------------------------------------------------------------------------------------------------------------------------------------- ------------------------------------------
------ -------------------------------  -------- ------------------------------------------------------------------------------------ ---------- -------------------------------------------------------
---------------- -------------- ------------------------------------ ------------------------------------------------ ----------------------------------------------------------------------------------
------------------------------------ ---------------------------------------------------------------------------------------------------------------------------- --------------------------------------
------------------ ----------------------------------------------------------------------------------- --------------------------------------------------- - -------------------------------------------
----------------------------------------------------------------------------------------------------------------------- ------------------------------------------------------------------ -------------
------------------------------------------------------------------------------------------------------- --- ---K-------------------------Tt--------------------------------------- ---------------------
---------------------------------------------------------------------G-K--------------%%%%%-%%%%%%%%%%---- 22SSC2-----------------F------tt----2CSU2UC-----Tt-------------------------------------------
---------------------------%%%%%%%%%%----------%%%%%-----------------%%%%-----%%%%%--%%%%%%-||||||||||----------------------------U------tt-- -------------t -------------------------------%%%--%%%%---
--------------%%%%----%%%%-||||||||||----------|||||-----------------||||-----|||||--||||||-||||||||||------SCU----%%%%%-----%%%%%--%%%%%%%%%%-------------tt---- ------- ------------- ----|||--||||---
--------------||||----| ||-||||||||||----------|||||%%%%%------------||||-----|||||--||||||-||||||||||-------------|||||-----|||||--||||||||||-- ------%%%%%%%%%----------------------------|||--||||-%%
 XXX XXX XX   ||||----|||| ||||||||||X  XXXXXX ||||||||||XX  XXX XXXX||||-----|||||XX  X XXXXX X XXX  X XXXXXXXX   |||||-----|||||XX |||||||||X  XXX XX|||||||||X  X  XXXXXX XX X XXXXX X XX|||--|||| ||