-------------------------------------------------------------------------------------------------------------------------------------------------        -----------------------------------------------
-------------------------------------------------------------------------------------------------------------------------------------------------        -----------------------------------------------
-------------------------------------------------------------------------------------------------------------------------------------------------        -----------------------------------------------
-------------------------------------------------------------------------------------------------------------------------------------------------        -----------------------------------------------
----------------------------------------------SSS-S----------------------------------------------------------------------------------------------        -----------------------------------------------
-------------------------------------------------------------------------------------------------------------------------------------------------        -----------------------------------------------
-------------------------------------------------|-----------------------------------------------------------------------------------------------        -----------------------------------------------
---------------------------------------------GK--r-k---------------------------------------------------------------------------------------------        -----------------------------------------------
---------------------------------------------%%%%%%%---------------------------------------------------------------------------------------------        -----------------------------------------------
---------------------------------------------|||||||------------------------------------------------------------------------------------r--g-g---        -----------------------------------------------
---------------------------------------------|||||||---------------------------------------------------#--#----------------------------%%%%%%%---        -----------------------------------------------
--------------------------------------------Y|||||||----r---------------------------------------------##--##---------------------------|||||||---        -----------------------------------------------
-----------------------------%%%%%%--------%%%%%%%%%%%%%%%%%%---------------------------------------%%%%--%%%%------------------------r|||||||---        -----------------------------------------------
-----------------------------||||||--------||||||||||||||||||%%---%%--------------------------------||||--||||%%%%%--%%%%%------%%--%%%%%|||||---        -----------------------------------------------
----------%%%%%---%%%%%----k-||||||--------||||||||||||||||||||---||------------%%%%%--%%%%%--------||||--|||||||||--|||||%%--%%||--||||||||||--%        %%%%%%%%%%%%%%%%%%%%%%%%%%%%%%%%%%%%%%%%%%%%%%%
XXXXXXXXXX|||||---|||||XXXXXXXXXXXXXXXXXXXX||||||||||||||||||||---||XXXXX--XXXXX|||||--|||||XXX--XXX||||--|||||||||--|||||||--||||XXXXXXXXXXXXXX|        |||||||||||||||||||||||||||||||||||||||||||||||