-----------------------------------------------------------------------------------------------------------------------------       --------------------------------------------------------------------
-----------------------------------------------------------------------------------------------------------------------------       --------------------------------------------------------------------
-----------------------------------------------------------------------------------------------------------------------------       --------------------------------------------------------------------
-----------------------------------------------------------------------------------------------------------------------------       --------------------------------------------------------------------
-----------------------------------------------------------------------------------------------------------------------------       --------------------------------------------------------------------
-----------------------------------------------------------------------------------------------------------------------------       --------------------------------------------------------------------
-----------------------------------------------------------------------------------------------------------------------------       --------------------------------------------------------------------
-----------------------------------------------------------------------------------------------------------------------------       --------------------------------------------------------------------
-----------------------------------------------------------------------------------------------------------------------------       --------------------------------------------------------------------
----------------------------Tt-----------------------------------------------------------------------------------------------       ------------------------------Tt------------------------------------
----------------------------tt------Tt------------------------------K--------------------------------------------------------       ------------------------------tt------------------------------------
------------------------G---tt------tt----------------------------%%%%----------K--------------------------------------------       -----------K-K----------------tt------------------------------------
-----------------------%%%%%%%%%%---tt----------------------------||||------%%%%%---%%%%%--G---------------------------2U----       --G-%%%%%%%%%%----------------tt----------------------------K-------
-----------------------||||||||||--Ktt----------------------------||||--2UC2|||||---|||||-UUUUSSU----------------------------       UUU-||||||||||-----------%%%%%%%%%%---%%%%%----%%%-------%%%%%---%%%
-----------------------||||||||||%%%%%%%%%------------------------||||------|||||---|||||--------------------------------%%%%       ----|||||||%%%%%%%%------||||||||||---|||||----|||-------|||||---|||
XXXXXXXXXXXXXXXXXXXXXXXXXXXXXXXXX|||||||||XXXXXXXXXXXXXXXXXXXXXXXXXXXXXXXXXX|||||---|||||XXXXXXXXXXXXXXXXXXXXXXXXXXXXXXXX||||       XXXXXXXXXXX||||||||XXXXXX||||||||||XXX|||||----|||XXXXXXX|||||---|||