--------------------------------------------------------------------------------------------------------------------------------------------------------------------------------------------------------
--------------------------------------------------------------------------------------------------------------------------------------------------------------------------------------------------------
--------------------------------------------------------------------------------------------------------------------------------------------------------------------------------------------------------
--------------------------------------------------------------------------------------------------------------------------------------------------------------------------------------------------------
--------------------------------------------------------------------------------------------------------------------------------------------------------------------------------------------------------
------------------------------------------------------------------------------------SSSSCSSS------------------------------------------------------------------------------------------------------------
-----------------------------------------------------------------------------------gggggkgggkk----------------%%%%%%-----------------------------------gkkggggggg-------------------------2S------------
---------------------------------------------------------------------------------r----------------------------|%%%%%---------------------------------r--||||||||----------------------------------------
----------------------------------------------------------g------------%%%%%%%%%%%------------%%%%%%%%%%g-g---||||||---------------------%%%%%%%%%%%%%--||||||||-%%%%%%%%%%%%---------------------------
-------------------------------------SSSCSUSC2--%%%%%%%%%%-------%%%%%-|||||||||||------------||||||||||------||||||---------------------|||||||||||||--||||||||-||||||||||||---------------------------
------------------------------------------------||||||||||-------|||||-|||||||||||%%%%%%%%%%%%||||||||||----%%%%%%%%%%-----g------g------|||||||||||||%%%%%%%%%%%||||||||||||%%%%%%%%%%%%%%%%%%---------
-------------------------------SCU--------------||||||||||-----%%%%%%%%|||||||||||||||||||||||||||||||||----||||||||||-------------------||||||||||||||||||||||||||||||||||||||||||||||||||||||---------
------------------------------------------------||||||||||-----|||||||||||||||||||||||||||||||||||||||||----||||||||||-----%%%%%%%%%%%%%%||||||||||||||||||||||||||||||||||||||||||||||||||||||---------
------------------------------------------------||||||||||-----|||||||||||||||||||||||||||||||||||||||||----||||||||||-----||||||||||||||||||||||||||||||||||||||||||||||||||||||||||||||||||||---------
------%%%%%-------------------------------------||||||||||-----|||||||||||||||||||||||||||||||||||||||||----||||||||||-----||||||||||||||||||||||||||||||||||||||||||||||||||||||||||||||||||||%%%    %%
XXXXXX|||||XXXXXXXXXXXXXXXXXXXXXXXXXXXXXXXXXXXXX||||||||||-----|||||||||||||||||||||||||||||||||||||||||----||||||||||-----|||||||||||||||||||||||||||||||||||||||||||||||||||||||||||||||||||||||||| ||