------------------------------------------------------------------------------------------------------------------------- ------------------------------------------------------------------------------
------------------------------------------ ----------------------------------------------------------- -------------------------------------------------------------------------------------------------
-------------------------------------------------------------------------- --------------------- -------------------------------------------------------------------------------------------------------
--------------------------------------------------------------------------------------------------------------------------------------------------------------------------------------------------------
---------------- ------------------------------------------------------------------------------------------------------------------------------------------------ --------------------------------------
------------------------------------------------------------------------------------------------------------------------------------------------------------------------- ------------------------------
------------------------------------------------------------------------------------------------------------------------------------------- ------------------------------------------------------------
-----------Tt--------- ---------------------------------------------------------------------------------------- ----------------------------------------------------------------------------------------
----- -----tt---------------------------------------------------------------------------------------------------------------------------------------------------------------------------- --------------
-----------tt----------------------------------------------------------------Tt------------------------------------------------------------------------------------------------------------- --------Tt-
----------Gtt----- ---------Tt-----------------------------------------------tt- --------------------------------------------------------------------------------------------------------------------tt-
-------%%%%%%%%%%-----------tt---%%%% -------------K-------------------------tt--------------------------------------------G-G----F------------------- ----------------Tt------------------CCUSU-----tt-
-------||%%%%%%||--------G-Ktt---|||||-------------%%%----%%%%- -- ----------tt--K%%%%%%%-%%-------------------------------C2UCUS-G------------------------------------tt-----------------------%%%%%%%%
-------||||||||||------%%%%%%%%%%%||||-------------|||----||||----------%%%%%%%%%%%%||%%%%%%%%------------------------------- ----%%%%--%%%%--%%%%--%%%%---------------tt-----------------------||||||||
-------||||||||||---%%%|||||||||||||||-------------|||----||||----------||||||||||||||||||||||------------------------------------||||--||||--||||--||||------------%%%%%%%%%%------------------||||||||
    X XXXX         X||||||||||||||XX XX X X XX XXXX|||----||||X XXXXX  X||||||||||||XX   XX XXXX   XXXXXXXXX  XXXXXXXX X  XX XXXX ||||--|||| X||||--||||XXXXX X  XX ||||||||||XXXXXX X X  XXXXXX||||||||