-------------------------------------------------------------------------------------------------------------------------------       ------------------------------------------------------------------
-------------------------------------------------------------------------------------------------------------------------------       ------------------------------------------------------------------
-------------------------------------------------------------------------------------------------------------------------------       ------------------------------------------------------------------
-------------------------------------------------------------------------------------------------------------------------------       ------------------------------------------------------------------
-------------------------------------------------------------------------------------------------------------------------------       ------------------------------------------------------------------
-------------------------------------------------------------------------------------------------------------------------------       ------------------------------------------------------------------
-------------------------------------------------------------------------------------------------------------------------------       ------------------------------------------------------------------
---------------------------------------------------------------------------------------------Tt--------------------------------       ------------------------------------------------------------------
---------------------------------------------------------------------------------------------tt--------------------------------       ------------------------------------------------------------------
----------------------------------------------------------------------------Tt---------------tt--------------------------------       ------------------------------------------------------------------
----------------------Tt-------------K--K-----------------------------------tt---------------tt-G------------------------------       ------------------------------------------------------------------
----------------------tt-------------2C22CC---------------------------------tt----2S-----%%%%%%%%%%----------------------------       ------------------G------------------%%%%%------------------------
------------G---------tt------------------------------------------------%%%%%%%%%%-------||||||||||------------------------UC--       ----------------%%%------------------|||||------------------------
---------%%%G%%%%%%%%%%%%%%%%--------SS--------------------K------------||||||||||-------||||K|||||-------------%%%%---%%%%----       ------------K---|||--%%%----%%%%-----|||||------------------------
---------|%%%%||%%%||||||||||----------------------------%%%%----%%%----||||||||||-------||||%%%%%|-------------||||---||||----       --------%%%%%---|||--|||----||||-----|||||------------------------
XXXXXXXXXX|||||||||XXXXXXXXXXXXXXXXXXXXXXXXXXXXXXXXXXXXXX||||----|||XXXX||||||||||XXXXXXXXXXX|||||XXXXXXXXXXXXXX||||---||||XXXX       XXXXXXXX|||||XXXXXXXX|||----||||XXXXXXXXXXXXXXXXXXXXXXXXXXXXXXXXXX