--------------------------------------------------------------------------------------------------------------------------------------------------------------------------------------------------------
--------------------------------------------------------------------------------------------------------------------------------------------------------------------------------------------------------
--------------------------------------------------------------------------------------------------------------------------------------------------------------------------------------------------------
--------------------------------------------------------------------------------------------------------------------------------------------------------------------------------------------------------
--------------------------------------------------------------------------------------------------------------------------------------------------------------------------------------------------------
--------------------------------------------------------------------------------------------------------------------------------------------------------------------------------------------------------
--------------------------------------------------------------------------------------------------------------------------------------------------------------------------------------------------------
--------------------------------------------------------------------------------------------------------------------------------------------------------------------------------------------------------
--------------------------------------------------------------------------------------------------------------------------------------------------------------------------------------------------------
--------------------------------------------------------------------------------------------------------------------------------------------------------------------------------------------------------
----------------Tt------K-G-------------------------------------------------------------------------------------------------------------------------------------------------------Tt--------------------
----------------tt-----%%%%%-------------%%%%%%-----------------------------------------------------------------------------------F--------------------------------%%%------------tt--------------------
----------------tt---K-|||||UC2SS--------||||||---------------------%%%%------K---------------------22--%%%%----------------------%-------------------------G------|||------------tt--G-----------F-----
-------------%%%%%%%%%%|||||-------------||||||----GG---------------||%%%%%%%%%%%------%%%%---%%%%------||||----------------------|------------------------%%%%%%%%|||-------%%%%%%%%%%----K------ -K---
-------------|||||||||||||||-------------||||||----%%%------%%%%----|||||||||||||------||||---||||------||||-----------%%%%%%%%---|------------------------||||||||%%%-------||||||||||-%%%%%---%%%%%---
XXXXXXXXXXXXX||||||||||XXXXXXXXXXXXXXXXXXXXXXXXXXXX|||------||||XXXXXXXXXXXXXXXXXXXXXXX||||---||||XXXXXXXXXXXXXXXXXXXXX||||||||XXXXXXXXXXXXXXXXXXXXXXXXXXXXXXXXXXXX|||XXXXXXX||||||||||X|||||---|||||XXX