--------------------------------------------------------------------------------------------------------------------------------------------------------------------------------------------------------
--------------------------------------------------------------------------------------------------------------------------------------------------------------------------------------------------------
--------------------------------------------------------------------------------------------------------------------------------------------------------------------------------------------------------
--------------------------------------------------------------------------------------------------------------------------------------------------------------------------------------------------------
--------------------------------------------------------------------------------------------------------------------------------------------------------------------------------------------------------
--------------------------------------------------------------------------------------------------------------------------------------------------------------------------------------------------------
--------------------------------------------------------------------------------------------------------------------------------------------------------------------------------------------------------
--------------------------------------------------------------------------------------------------------------------------------------------------------------------------------------------------------
--------------------------------------------------------------------------------------------------------------------------------------------------------------------------------------------------------
-------------------------------------------------------------------------------------------------------Tt-----------------------------------------------------------------------------------------------
-------------------------------------------------------------------------------------------------------tt-----------------------------------------------------------------------------------------------
------------------------------------------------Tt-----------------------------------------------------tt-------------------------F----------------K----------------------------------------------------
------------------------------------------------tt------------------------------------------------%%%%%%%%%%%%--------------------%------------KUSC2------------------G---------------------------------
------------------------------------------------tt-G----------------------------------------------||||||||||||--------------------|-----%%%%%%%%-----K-------------%%%%%%%%%%---------------------------
---------------------%%%%%----%%%%%----------%%%%%%%%%%-------------------------------------------||||||||||||--------------------|-----||||||||----%%%%----%%%----||||||||||---------------------------
  XXX  XXX XXXXXX X X|||||----|||||XXX XX  X ||||||||||XX XXXXXXXX  X XXXX  XXXXXXX XXXXXX X XXXXX XXXX  XXXXXXXXXXXX XX XXX XX  X  XX  ||||||||XXX ||||----|||X X ||||||||||XXX X X  X XXXXXXXXX XXX XX