--------------------------------------------------------------------------------------------------------------------------------------------------------------------------------------------------------
--------------------------------------------------------------------------------------------------------------------------------------------------------------------------------------------------------
--------------------------------------------------------------------------------------------------------------------------------------------------------------------------------------------------------
--------------------------------------------------------------------------------------------------------------------------------------------------------------------------------------------------------
--------------------------------------------------------------------------------------------------------------------------------------------------------------------------------------------------------
--------------------------------------------------------------------------------------------------------------------------------------------------------------------------------------------------------
--------------------------------------------------------------------------------------------------------------------------------------------------------------------------------------------------------
--------------------------------------------------------------------------------------------------------------------------------------------------------------------------------------------------------
-------------Tt-----------------------------------------------------------------------------------------------------------------------------------------------------------------------------------------
-------------tt-------------------------------------------------------------------------------------------------------------Tt--------------------------------------------------------------------------
-------------tt-G-------------------TG----------------------------------------------------------Tt--------------------G-----tt------------------------------------------------------Tt------------------
--------%%%%%%%%%%%--------%%%%%%-%%tt%%%%%%%%--------------------------------------------------tt--------------------S-----tt----F---------------%%%%%%%%%%%%--------------------%%tt%%%%--------------
--------|||||||||||--------||||||-||tt||||||||--------------------------------------------------tt------------------K-------tt----%-----------%%%%%%%%%|||||||--------------------||tt||||--------------
--------|||||||||||--------||||||-||tt||||||||---%%%%%%%%%%-----%%%%%%%%-%-------------------%%%%%%%%%%----%%%%--%%%%%--%%%%%%%%%-|-----------||||||||||||||||--------------------K|tt|G||---------F----
--------|||||||||||--------||||||%%%%%%%%%%|||---||||||||||-----||||%%%%%%%%%%---------------||||||||||----||||--|||||-%%%|||||||-|-----%%%%%-||||||||||||||||---%%%%%-----------%%%%%%%%|--------- ----
XXXXXXXXXXXXXXXXXXXXXXXXXXXXXXXXX||||||||||XXXXXX||||||||||XXXXXXXXX||||||||||XXXXXXXXXXXXXXX||||||||||XXXX||||--|||||X|||XXXXXXXXXXXXXX|||||XXXXXXXXXXXXXXXXXXXX|||||XXXXXXXXXXX||||||||XXXXXXXXXXXXXXX