-----------------------------------------------------------------------------------------------------------------------------      ---------------------------------------------------------------------
-----------------------------------------------------------------------------------------------------------------------------      ---------------------------------------------------------------------
-----------------------------------------------------------------------------------------------------------------------------      ---------------------------------------------------------------------
-----------------------------------------------------------------------------------------------------------------------------      ---------------------------------------------------------------------
-----------------------------------------------------------------------------------------------------------------------------      ---------------------------------------------------------------------
-----------------------------------------------------------------------------------------------------------------------------      ---------------------------------------------------------------------
-----------------------------------------------------------------------------------------------------------------------------      ---------------------------------------------------------------------
-----------------------------------------------------------------------------------------------------------------------------      ---------------------------------------------------------------------
-----------------------------------------------------------------------------------------------------------------------------      ---------------------------------------Tt----------------------------
-----------------------------------------------------------------------------------------------------------------------------      ---------------------------------------tt----------------------------
----------------------------------------------K------------------------------------------------------------------------------      -------------Tt------------------------tt---------------------------T
-------------------------------------------S222SU2-------------------%%%%%%%%%-----------------------------------------------      ------K%%%%--tt---------------------%%%%%%%%%-----------------------t
---------------------------------------------------------------------|||||||||-------------------%%%%--------GCSUSSS--------%      %%-C22S||||--tt---------------------|||||||||--------------------G--t
------------------------------------%%%%%%---------------------------|||||%%%%-------------------||||-------%%%%------------|      ||-----|%%%%%%%%%%%-----------------|||||||||-------------------%%%%%
--------------------------%%%%%%%%%%||||||---------------------------|||||||||-------------------||||-------||||------------|      ||-----||||||||||||-----------------|||||||||-------------------|||||
XXXXXXXXXXXXXXXXXXXXXXXXXX||||||||||||||||XXXXXXXXXXXXXXXXXXXXXXXXXXXXXXXXXXXXXXXXXXXXXXXXXXXXXXXXXXXXXXXXXXXXXXXXXXXXXXXXXX|      ||XXXXXX|||||||||||XXXXXXXXXXXXXXXXXXXXXXXXXXXXXXXXXXXXXXXXXXXXXXXXXX