-------------------------------------------------------------------------------------------------------------------------- ------------------------------------------------- ---------------------------
--------------------------------------------------------------------------------------------------------------------------------------------------------- ----------------------------------------------
-------------------------------------------- ------------------------------------- ---------------------------------------------------------------------------------------------------------------------
------------------------------------------------------------------------------------------------------------------------------------- ------------------------------------------------------------------
------- ------------------------------------------ ------------------------------------------------------------ ------------------------------------- --------------------------------------------------
 ---------------------------------------------- ----------------------------------------------------------------------------------------------------- --------------------------------------------------
-------------------------- - -------------------------- ------------------------------------------------ -------------------- - ------------------------------------------------------------------------
----------------------------------------------------------------------------------------------------------------------------------------------------------------------------------------------------- --
---------------------------------------------------------------------------------------------------------------------------- ---------- t-------------------------- ------------------------------------
---------------- t---------------------------------------------------------------------------------------------------------------------tt------------------------------------------------------- -------
----------------tt---------- ---- t-------------------------------------------------------------------------------------------- -------tt---------------------- ----------------------------------------
------------ ---tt---------------tt------------------------------------------------------------------------------------------ ---- F---tt-----------------------------------------------UU-UCCS--- -----
-----------%%%%%%%%%%--------- --tt--------------------------------------------------------------- ------------------%%%%%%%%%%---%-%%%%%%%%- --------------------------------------------------%%%%%%%%
-----------||||||||||--------%%%%%%%%%--------------------  ------ --------------------------------------------------||||||||||---|-||||%%%%%%----------------------------- -%%%%--%%%%%--------||||||||
-----------|| |||||||--------|||||| ||-------------------%%%%--%%%%--------------------------------------------------||||||||||---|-||||||||| %%%%%%%%%%-- -------%%%%%%%%%%%||||--|||||--------||||||||
 X  XXX  XX||||||||||X  XXX  |||||||||  X  X XXXXX XX XX ||||-- |||X XXXX  XXXX XX XX X  XXX XXXXXXX X XXX XXXXXX XXXXXXXXXXX  XXX XXXX ||||||||||||||||XX  XX XXX|||||||||||||||--|||||  XX X X XXX XX 