--------------------------------------------------------------------------------------------------------------------------------------------------------------------------------------------------------
--------------------------------------------------------------------------------------------------------------------------------------------------------------------------------------------------------
--------------------------------------------------------------------------------------------------------------------------------------------------------------------------------------------------------
--------------------------------------------------------------------------------------------------------------------------------------------------------------------------------------------------------
--------------------------------------------------------------------------------------------------------------------------------------------------------------------------------------------------------
--------------------------------------------------------------------------------------------------------------------------------------------------------------------------------------------------------
--------------------------------------------------------------------------------------------------------------------------------------------------------------------------------------------------------
--------------------------------------------------------------------------------------------------------------------------------------------------------------------------------------------------------
--------------------------------------------------------------------------------------------------Tt----------------------------------------------------------------------------------------------------
--------------------------------------------------------------------------------------------------tt---------------------------------------Tt-----------------------------------------------------------
------------------------------------------------------ t------------------------------------------tt-------K-------------------------------tt---------------------G-------------------------------------
------------------------------------------------ 2C---tt------------------------------------------t ------S2SS22U-----------------F-----G--tt---------------------UC--------%%%---------------G---------
-----------%%%%%---%   %----------K-------KK---------- t-------------------------------------%%% %%%%%%%--------------------------%---%%%%%%%%%%%%--------------------------|||-------%%%%   %%%%-------
-----------|||||---|||||----------%%%%--%%%%---------Ktt---------------------------------SU S|||||||||||--------------------------|---||||||||||||--------------------------|||-------|||||||||||-------
-----------|||||---|||||----------||||--||||-------%%%%  % ----------------------------------|||||||||||---%% %%--------%%%-- %%--|---||||||||||||--------------------------|||-------|||||||||||-------
  XXX XXXXX|||||---|||||XXXXXXXXXX||||--||||XXXXXXX|||||||| XXXXXXX XXXXXXXXXXXXXXXXXXXXXXXXX|||||||||||XXX|||||XXXXXXXX|||--|||XXXXXXXXXX XXXXXXXXXXXXXXXXXXXXXXXX XXXXXXX XXXXXXX XXXXXX XXXXX XXXXXXX