--------------------------------------------------------------------------------------------------------------------------------------------------------------------------------------------------------
--------------------------------------------------------------------------------------------------------------------------------------------------------------------------------------------------------
--------------------------------------------------------------------------------------------------------------------------------------------------------------------------------------------------------
--------------------------------------------------------------------------------------------------------------------------------------------------------------------------------------------------------
--------------------------------------------------------------------------------------------------------------------------------------------------------------------------------------------------------
--------------------------------------------------------------------------------------------------------------------------------------------------------------------------------------------------------
--------------------------------------------------------------------------------------------------------------------------------------------------------------------------------------------------------
--------------------------------------------------------------------------------------------------------------------------------------------------------------------------------------------------------
--------------------------------------------------------------------------------------------------------------------------------------------------------------------------------------------------------
-------------------------------------------------------------CSSS---------------Tt----------------------------------------------------------------------------------------------------------------------
----------------------------------------------------------------------------tt--tt----------------------------------------------------------------------------------------------------------------------
----------------------------------------------------------------------------tt--tt----------------------------------------------------------------------------------------------------------------------
------------------------------------------------------------y------------%%%%%%%%%%%-g--------------%%%%%--%%%%%----#--#----%%%---%%%%%%--%%%-----------------------------------------------------------
--------------%%---%%-----%%%%%--%%%%%%%%%--%%%%---------%%%%%%%%%-------|||||||||||%%%%%%%%--#--#--|||||--|||||---##--##---|||---||||||--|||-----------------------------------------------------------
--------------||---||-----|||||--|||||||||--||||---------|||||||||-------|||||||||||||||||||%%%--%%%|||||--|||||--###--###--|||---||||||--|||-----------------------------------------------------------
XXXXXXXXXXXXXX||---||XXXXX|||||--|||||||||--||||XXX---XXX|||||||||XX---XX||||||||||||||||||||||--||||||||--|||||XXXXX--XXXXX|||---||||||--|||XXXXXXXX XXXXXXXXXXXXXXXXXXXXXXXXXXXXXXXXXXXXXXXXXXXX    XX