--------------------------------------------------------------------------------------------------------------------------------------------------------------------------------------------------------
--------------------------------------------------------------------------------------------------------------------------------------------------------------------------------------------------------
--------------------------------------------------------------------------------------------------------------------------------------------------------------------------------------------------------
--------------------------------------------------------------------------------------------------------------------------------------------------------------------------------------------------------
--------------------------------------------------------------------------------------------------------------------------------------------------------------------------------------------------------
--------------------------------------------------------------------------------------------------------------------------------------------------------------------------------------------------------
--------------------------------------------------------------------------------------------------------------------------------------------------------------------------------------------------------
------------------------Tt------------------------------------------------------------------------------------------------------------------------------------------------------------------------------
------------------------tt------------------------------------------------------------------------------------------------------------------------------------------------------------------------------
------------------------ t------------------------------------------------------------------------------------------------------------------------------------------------------------------------------
---------------------K--tt-K---------------------------------------------K------------------------------------------------------------------------------------------------------------------------------
-------------------- %%%  %%%%-----------------------------------------%%%-----S2 U----------------------------------------------- F-------------------------------G------------------------------------
-------------------G||||||||||-----------------------------------------|||---------------------------K---------------------U2 S2S2 ----------------------US------ %%%----------------------------------G
---------------CSSCU||||||||||-----------------------------------------|||------------------------%%%%--%%%%----------------------|------------------------------||||--------------------------- % %%%%%
--------------------||||||||||-----------------------------------------|||------------------------||||--||||----------------------|------------------------------||||---------------------------||||||||
 XXXXXX   XX X XXXXXX XX XXXXXXXXXXXXXXX XXXXXXX XXXXXXXX  XXXXX XXX XXXXXXXXXXXXXXX  XXXXXXXXXXXX||||--||||XXX XXXX XX X XXX XXXXX XXXXXXXXXXXXXXXX XX XXXX   XX||||XXX XXX  XXXXXXXXXX X XXXXXXXXXXXXX