--------------------------------------------------------------------------------------------------------------------------------------------------------------------------------------------------------
--------------------------------------------------------------------------------------------------------------------------------------------------------------------------------------------------------
--------------------------------------------------------------------------------------------------------------------------------------------------------------------------------------------------------
--------------------------------------------------------------------------------------------------------------------------------------------------------------------------------------------------------
--------------------------------------------------------------------------------------------------------------------------------------------------------------------------------------------------------
--------------------------------------------------------------------------------------------------------------------------------------------------------------------------------------------------------
--------------------------------------------------------------------------------------------------------------------------------------------------------------------------------------------------------
--------------------------------------------------------------------------------------------------------------------------------------------------------------------------------------------------------
--------------------------------------------------------------------------------------------------------------------------------------------------------------------------------------------------------
--------------------------------------------------------------------------------------------------------------------------------------------------------------------------------------------------------
-----------------------------------------------Tt-------------------------------------------------------------------------------------------------------------------------------------------------------
-----------------------------------------------tt---------------------------%-%%%%%%%%%------------------------------------------- ------------------------------------------K----%%%-------------------
-----------------------------------------------tt-G-----------------------%%%%%%%%%||||---%%%%----%%%%----------------------------%%%%%%%%%%--------------------------------CC22U-|||-------C2SUU-------
------------------------------------------%%%%%%%%%%----------------------|||||||||||||---||||----||||---G----------K%%-----------||||||||||---------%%%%%%%%%%-------------------|||---%%%%%-----------
------------------%%%%-----%%%------------||||||||||----------------------|||||||||||||---||||----||||---%%%-------%%%%%%%%%%-----||||||||||---%%%%%%||||||||||-------------------|||---|||||----------%
XXXXXXXXXXXXXXXXXX||||-----|||XXXXXXXXXXXX||||||||||XXXXXXXXXXXXXXXXXXXXXX|||||||||XXXXXXX||||----||||XXX|||XXXXXXX||||||||||XXXXXXXXXXXXXXXXXX||||||XXXXXXXXXXXXXXXXXXXXXXXXXXXXXXXXXXX|||||XXXXX    X|