--------------------------------------------------------------------------------------------------------------------------------------------------------------------------------------------------------
--------------------------------------------------------------------------------------------------------------------------------------------------------------------------------------------------------
--------------------------------------------------------------------------------------------------------------------------------------------------------------------------------------------------------
--------------------------------------------------------------------------------------------------------------------------------------------------------------------------------------------------------
--------------------------------------------------------------------------------------------------------------------------------------------------------------------------------------------------------
--------------------------------------------------------------------------------------------------------------------------------------------------------------------------------------------------------
--------------------------------------------------------------------------------------------------------------------------------------------------------------------------------------------------------
-----------------------------------------------------------------------------------------------------------------------------------------------------------------------------------------------------Tt-
-------------------------------------------------------------------Tt--------------------------------------------------------------------------------------------------------------------------------tt-
-------------------------------------------------------------------tt--------------------------------------------------------------------------------------------------------------------------------tt-
-------------------------------------------------------------------tt--------------------------------------------------------------------------------------------------------------------Tt----------tt-
-------------------------------------------------------------------tt----------------------------------------------------US------- F------------------------------G----------------------tt------%%%%%%%
---------------------------------------------------------------%%%%%%%%%----------------------%%%%%%----------%%%---%%%-----------%--------G---------------------%%%%%%%%K%%-----------K-tt------|||||||
------------------G----------------S2CU2U2---------------------|||||||||--------------%%%--%%%||||||----------|||---|||--------%%%% -----%%%%%------G------------||||||%%%%%%%%%%%%%%%%%-tt------||||%%%
------------------%%%%%--%%%%%----------------%%%%--%%%%%------|||||||||--------------|||--|||||||||----------|||---|||--------|||||-----|||||-----%%%%%--%%%%%--|||||||||||||||||||||%%%%%%%%---|||||||
 X XXXX X XXX X  X|||||--|||||      X X XX XX ||||--||||| X  X |||||||||XX XXX  X XX  |||--|||  XXXX  X  XXX  |||---|||X XXX X |||||-----|||||XXX X|||||--|||||XX XXXXX  X XXXX XX   X||||||||   XXXX|||