--------------------------------------------------------------------------------------------------------------------------------------------------         ---------------------------------------------
--------------------------------------------------------------------------------------------------------------------------------------------------         ---------------------------------------------
--------------------------------------------------------------------------------------------------------------------------------------------------         ---------------------------------------------
--------------------------------------------------------------------------------------------------------------------------------------------------         ---------------------------------------------
--------------------------------------------------------------------------------------------------------------------------------------------------         ---------------------------------------------
--------------------------------------------------------------------------------------------------------------------------------------------------         ---------------------------------------------
--------------------------------------------------------------------------------------------------------------------------------------------------         ---------------------------------------------
------------------------------------------------------------------------------%%%%%%--------------------------------------------------------------         ---------------------------------------------
------------------------------------------------------------------------------||||||--------------------------------------------------------------         ---------------------------------------------
------------------------------------------------------------------------------||||||--------------------------------------------------------------         ---------------------------------------------
-------------------------------------%%%--------------------------------2S----|||||r--------------------------------------------------------------         ---------------------------------------------
-------------------------------------|r|---Y----------------------------------|||%%%%%%%----------------------------------------------------------         ---------------------------------------------
---------------#--#-----------%%%%%%%%%%%%%%%%--------------#---#------%------||||r|||||-----------------------------#---#------------------------         ---------------------------------------------
-------------%%%--%%%%%%---%%%||||||||||||||||---#--#------##---##-----|----%%%%%%%%%%%%%%%%%%%%%--%%%%%------------##---##------------------%%%%%         %%%%%%%%%%%%%%%%%%%%%%%%%%%%%%%%%%%%%%%%%%%%%
-------------|||--||||||---|||||||||||||||||||--##--##----###---###--%%%%%%%|||||||||||||||||||||--|||||-----------###---###--%%%---%%%------|||||         |||||||||||||||||||||||||||||||||||||||||||||
XXXXXXXXXXXXX|||--||||||---|||||||||||||||||||XXXX--XXXXXXXXX---XXXXX||||||||||||||||||||||||||||--|||||XXX---XXXXXXXX---XXXXX|||---|||XX--XX|||||         |||||||||||||||||||||||||||||||||||||||||||||