--------------------------------------------------------------------------------------------------------------------------------------------------------------------------------------------------------
--------------------------------------------------------------------------------------------------------------------------------------------------------------------------------------------------------
--------------------------------------------------------------------------------------------------------------------------------------------------------------------------------------------------------
--------------------------------------------------------------------------------------------------------------------------------------------------------------------------------------------------------
--------------------------------------------------------------------------------------------------------------------------------------------------------------------------------------------------------
--------------------------------------------------------------------------------------------------------------------------------------------------------------------------------------------------------
--------------------------------------------------------------------------------------------------------------------------------------------------------------------------------------------------------
---------------------------------------------------------------------------------------------------------------------------------Tt---------------------------------------------------------------------
---------------------------------------------------------------------------------------------------------------------------------tt------------------------------------Tt-------------------------------
---------------------------------------------------------------------------------------------------------------------------------tt------------------------------------tt-------------------------------
---------------------------------------------------------------------------------------------------------------------------------tt--K---------------------------------tt---G---------------------------
--------------------------------------------------------------------------------------G---------------------------------------%%%% %%%------------------------------%%%%%%%%%%K%%%%%%%%%%---------------
----------------------------------------%%%%%%%%%%----------------------------------%%%%--------------------------------------||||%|||------------------------------|||||||||%%%%%||G||||---------------
---------------------------------------%%%%|||||||----------------------------------||||----------K----K----------------K-----||||||||----%%%%%%%%%-----------------||||%%%%||||||%%%||||------------ %%
-------%%%%%---------------------------|||||||||||----------------------------------||||---------%%%%%%%%--%%%------%%%%%-----||||||||----|||||||||-----------------|||||||||||||%%%%%%||-----%%%----|||
XXXXXXX|||||XXXXXXXXXXXXXXXXXXXXXXXXXXXXXXXXXXXXXXXXXXXXXXXXXXXXXXXXXXXXXXXXXXXXXXXX||||XXXXXXXXX||||||||XX|||------|||||XXXXXXXXXXXXXXXXX|||||||||XXXXXXXXXXXXXXXXXXXXXXXXXXXXXX||||||XXXXXXX|||X    XX