--------------------------------------------------------------------------------------------------------------------------------------------------------------------------------------------------------
--------------------------------------------------------------------------------------------------------------------------------------------------------------------------------------------------------
--------------------------------------------------------------------------------------------------------------------------------------------------------------------------------------------------------
--------------------------------------------------------------------------------------------------------------------------------------------------------------------------------------------------------
--------------------------------------------------------------------------------------------------------------------------------------------------------------------------------------------------------
--------------------------------------------------------------------------------------------------------------------------------------------------------------------------------------------------------
--------------------------------------------------------------------------------------------------------------------------------------------------------------------------------------------------------
--------------------------------------------------------------------------------------------------------------------------------------------------------------------------------------------------------
--------------------------------------------------------------------------------------------------------------------------------------------------------------------------------------------------------
--------------------------------------------------------------------------------------------------------------------------------------------------------------------------------------------------------
-----------------------------------------------------------------------------------------------------------------------------------------------------------------------------------------------G-G------
-----------------------------------------------CS2----G----------------------------------------%%%%%%%%%%------------------------- ------------------------------------------------------------UUU  --%%
-----------------------------------------------------%%%%%%---------------G--------------------||||||||||--K----------------------%-------------------------------G-----------------------------%%    %%
-----------------------K-----------------------------||||||------------%%%%CCU2C---------K-----||||||||||%%%%%%%%%%------------%%%|--%%%%%---------------%%%--%%%%%-----------------------------||||||||
----------------%%%%%--%%%%%--------%%%%---%%%%------||||||------------||||-------------%%%%---||||||||||||||||||||------------||||--|||||---------------|||--|||||-----------------------------||||||||
XXXXXXXXXXXXXXXX|||||--|||||XXXXXXXX||||---||||XXXXXX||||||XXXXXXXXXXXXXXXXXXXXXXXXXXXXX||||XXXXXXXXXXXXXXXXXXXXXXXXXXXXXXXXXXX||||--|||||XXXXXXXXXXXXXXX|||--|||||XXXXXXXXXXXXXXXXXXXXXXXXXXXXXXX    XX