--------------------------------------------------------------------------------------------------------------------------------------------------------------------------------------------------------
--------------------------------------------------------------------------------------------------------------------------------------------------------------------------------------------------------
--------------------------------------------------------------------------------------------------------------------------------------------------------------------------------------------------------
--------------------------------------------------------------------------------------------------------------------------------------------------------------------------------------------------------
--------------------------------------------------------------------------------------------------------------------------------------------------------------------------------------------------------
--------------------------------------------------------------------------------------------------------------------------------------------------------------------------------------------------------
-----------------------------------------------------------------------------------------------SS2SSS2CS------------------------------------------------------------------------------------------------
----------------------------------------------------------------------------------------------------------------------------%%%%%%----------------------------------------------------------------------
---------------------------------------------------------------------------ggkggkg-------------------------------------g-g--||||||----------------------------------------------------------------------
-------------------------------------------------------------------------r--|||||-------------------------------------------||||||----------------------------------------------------------------------
---------------------------------------------------------------%%%%%%%%%%%--|||||-%%%%%%%%%%%%%%%%%%%%%%%%%%%%%%%%%%%%%---%%%%%%%%%%%--------------------------------------k--k-------------------------
--------------------------------------gg-----------------tt----|||||||||||--|||||-|||||||||||||||||||||||||||||||||||||---|||||||||||-g----r----------k-------------------------------------------------
---------------------------------------------------------tt----|||||||||||%%%%%%%%|||||||||||||||||||||||||||||||||||||---|||||||||||-------------------------------------%%%%%%%%%%%%------------------
-------------------------------------%%%%%%%%%%%---------tt----||||||||||||||||||||||||||||||||||||||||||||||||||||||||---|||||||||||%%%%%%%%%%%-----%%%%%%%%-----%%%%%%--||||||||||||------------------
------%%%%%-------------------%%%----|||||||||||----%%%%%%%%%%%||||||||||||||||||||||||||||||||||||||||||||||||||||||||---||||||||||||||||||||||-----||||||||-----||||||--||||||||||||---%%%%%%%%%    %%
XXXXXX|||||XXXXXXXXXXXXXX-----|||----|||||||||||----|||||||||||||||||||||||||||||||||||||||||||||||||||||||||||||||||||---||||||||||||||||||||||-----||||||||---XXXXXXXXXX||||||||||||---|||||||||||| ||