--------------------------------------------------------------------------------------------------------------------------------------------------------------------------------------------------------
--------------------------------------------------------------------------------------------------------------------------------------------------------------------------------------------------------
--------------------------------------------------------------------------------------------------------------------------------------------------------------------------------------------------------
--------------------------------------------------------------------------------------------------------------------------------------------------------------------------------------------------------
--------------------------------------------------------------------------------------------------------------------------------------------------------------------------------------------------------
--------------------------------------------------------------------------------------------------------------------------------------------------------------------------------------------------------
--------------------------------------------------------------------------------------------------------------------------------------------------------------------------------------------------------
--------------------------------------------------------------------------------------------------------------------------------------------------------------------------------------------------------
-------------------------------------------------------------------------------------------------------------------------g------------------------------------------------------------------------------
---------------------------------------------------------------------------------------------------------------------------------------------------------SS---------------------------------------------
----------------------------------U---------------------------------------------------------------SSCC2CS----------------------------------------------gkgkggr--------%%%%%%%%%%%%%%--------------------
--------------------------------------gggggggggg------------------------------------------------ggggggkgggk------------------------------------------r----------------||||||||||||||--------------------
----------------------------------------------------------------------------------------------r-----------------------------------------%%%%%%%%%%%%%%--------%%%%%%%%||||||||||||||-----%%%%%%%%%    %%
------------------------------------------------%%%%%%%%%%----gg---------gg-----------%%%%%%%%%------------%%%%%%%%%%%%%%---------------||||||||||||||--------||||||||||||||||||||||-----|||||||||||| ||
------%%%%%--------------%%%%%%%%%%%%%----------||||||||||----------------------------|||||||||------------||||||||||||||---------------||||||||||||||%%%%%%%%||||||||||||||||||||||-----|||||||||||||||
XXXXXX|||||XXXXXXXXXXXXXX|||||||||||||XXXXXXXXXX||||||||||---XXXXXXXX---XXXXXXXXXXXXXX|||||||||XXXXXXXXXXXX||||||||||||||---XXXXXXXXXXXX||||||||||||||||||||||||||||||||||||||||||||-----|||||||||||||||