--------------------------------------------------------------------------------------------------------------------------------------------------------------------------------------------------------
--------------------------------------------------------------------------------------------------------------------------------------------------------------------------------------------------------
--------------------------------------------------------------------------------------------------------------------------------------------------------------------------------------------------------
--------------------------------------------------------------------------------------------------------------------------------------------------------------------------------------------------------
-----------------------------------------------------------------------------------------------------------------------------------------------------------------------------------------------------F--
--------------------------------------------------------------------------------------------------------------------------------------------------------------------------------------------------------
--------------------------------------------------------------------------------------------------------------------------------------------------------------------------------------------------------
--------------------------------------------------------------------------------------------------------------------------------------------------------------------------------------------------------
--------------------------------------------------------------------------------------------------------------------------------------------gkkgggggggg--------------r----------------------------------
--------------------------------------------------------g--g--g---------------------------------------------------------------------------r--|||||||||--------------------------------------------------
---------------------------------------SS-----------------------------------------------------%%%%%-------%%%%%-------------------%%%%%%%%%--|||||||||-%%%%%%%%%%%%-------------------------------------
-------------------------------------ggkgkgg--------------------------------------------------|||||-------|||||----SSUS-----------|||||||||--|||||||||-||||||||||||-------------------------------------
-----------------------------------r------------------------%%%%%---------------------------%%%%%%%%%---%%%%%%%%------------------|||||||||%%%%%%%%%%%%||||||||||||-------------------------------------
-------------------------%%%%%%%%%%%--------%%%%%%%%%%%-----|||||---------------g--g---g----|||||||||---||||||||-g-------%%%%%%%%%|||||||||||||||||||||||||||||||||-------------------------------------
------%%%%%--------------|||||||||||--------|||||||||||-----|||||-------%%%-----------------|||||||||---||||||||---------||||||||||||||||||||||||||||||||||||||||||-----%%%%%%%%%%%---------------------
XXXXXX|||||XXXXXXXXXXXXXX|||||||||||XXXXXXXX|||||||||||---XXXXXXXXX-----|||----XXXXXXXXXXXXX|||||||||---||||||||XXXXXXXXX||||||||||||||||||||||||||||||||||||||||||-----|||||||||||-----XXXXXXXXXXXXXFXX