--------------------------------------------------------------------------------------------------------------------------------------------------------------------------------------------------------
--------------------------------------------------------------------------------------------------------------------------------------------------------------------------------------------------------
--------------------------------------------------------------------------------------------------------------------------------------------------------------------------------------------------------
--------------------------------------------------------------------------------------------------------------------------------------------------------------------------------------------------------
--------------------------------------------------------------------------------------------------------------------------------------------------------------------------------------------------------
--------------------------------------------------------------------------------------------------------------------------------------------------------------------------------------------------------
--------------------------------------------------------------------------------------------------------------------------------------------------------------------------------------------------------
--------------------------------------------------------------------------------------------------------------------------------------------------------------------------------------------------------
--------------------------------------------------------------------------------------C22S--------------------------------------------------------------------------------------------------------------
--------------------------g------------g--g-------------------------------------------------------------------------------------------------------------------------------------------------------------
---------------------------------------------------------------------------%%%%%%%%-g-g-r-------k-------------------------------------------------------------------------------------------------------
----------------------------------------------------U---gggkkgggg----------||||||||-------------------------------r------------%%%%%-----SSCS2CSC--------------S2CSSSCCS-----C2CSS----------------------
------------------------------------------------------------C2S------------||||||||%%%%%%%%%%-------------------------%%%%%----|||||--------------------------------------------------------------------
-----------------------------------------------------------------%%%%%%%%%%||||||||||||||||||----%%%%%%%%%%%%%%-------|||||----|||||---------------------------------------r--------r------------F------
------%%%%%------------------------------------------------------||||||||||||||||||||||||||||----||||||||||||||-------|||||----|||||------------------------------------------------------------- ------
XXXXXX|||||XXXXXXXXXXXXXX-----XXXXXXXX----XXXXXXXXXXXXXXXXXXXXXXX||||||||||||||||||||||||||||----||||||||||||||-----XXXXXXXXXXXXXXXXXXXXXXXXXXXXXXXXXXXXXXXXXXXXXXXXXXXXXXXXXXXXXXXXX----XXXXXXXXXXXXFXX