--------------------------------------------------------------------------------------------------------------------------------------------------------------------------------------------------------
--------------------------------------------------------------------------------------------------------------------------------------------------------------------------------------------------------
--------------------------------------------------------------------------------------------------------------------------------------------------------------------------------------------------------
--------------------------------------------------------------------------------------------------------------------------------------------------------------------------------------------------------
--------------------------------------------------------------------------------------------------------------------------------------------------------------------------------------------------------
--------------------------------------------------------------------------------------------------------------------------------------------------------------------------------------------------------
--------------------------------------------------------------------------------------------------------------------------------------------------------------------------------------------------------
--------------------------------------------------------------------------------------------------------------------------------------------------------------------------------------------------------
--------------------------------------------------------------------------------------------------------------------------------------------------------------------------------------------------------
------------------------------------Tt------------------------------------------------------------------------------------------------------------------------------------------------------------------
------------K----------------------GttK-K---------------------------------------------------------------------------------------------------------------------------------------------------------------
------------%%%%%------------------UTU2CCK----------------------------------------------------------------------------------------F-----------------------------------------G---------------------------
------------|||||-------------------tt%%%%%%%%%-------%%%%G-----G-------------------------------------------------------%%%%%%----%---------------------------------%%%%%%%%%%%--K----------------------
------------|||||----%%%--%%%%-%%%%%%%%%%%|||||-------|%%%%%%%%%%%%-------------------------------G---------------------||||||----|---------------------------------|||||||||||%%%%%%%%%%%--------F-----
------------|||||----|||--||||-|||||||||||||%%%%%-----|||||||||||||------------------------------%%%%------%%%%%--------||||||----|---------------------------------||||||||||||||||||||||-------- -----
XXXXXXXXXXXXXXXXXXXXX|||--||||XXXXXXXXXXXXXX|||||XXXXXXXXXXXXXXXXXXXXXXXXXXXXXXXXXXXXXXXXXXXXXXXX||||------|||||XXXXXXXX||||||XXXXXXXXXXXXXXXXXXXXXXXXXXXXXXXXXXXXXX|||||||||||XXXXXXXXXXXXXXXXXXXXXXXXX