--------------------------------------------------------------------------------------------------------------------------------------------------------------------------------------------------------
--------------------------------------------------------------------------------------------------------------------------------------------------------------------------------------------------------
--------------------------------------------------------------------------------------------------------------------------------------------------------------------------------------------------------
--------------------------------------------------------------------------------------------------------------------------------------------------------------------------------------------------------
--------------------------------------------------------------------------------------------------------------------------------------------------------------------------------------------------------
--------------------------------------------------------------------------------------------------------------------------------------------------------------------------------------------------------
--------------------------------------------------------------------------------------------------------------------------------------------------------------------------CUC2SS2-----------------------
--------------------------------------------------------------------------------------------------------------------------------------------------------------------------------------------------------
------------------------------U-------------------------------------------------------------------------------------------------------------------------------------------------------------------------
-----------------------------------------------------------------------------------------------------------------------------------------------CCCUSS2SS2-%%%%%%%%%%%%%%--------------------------------
------------------------------------%%%%-------------------------------%%%%%%-----------------gkgggkk-----------------------------------------------------||||||||||||||%%%%%%%%%%%%--------------------
----------------------------------gggkgggk-----------------------------||||||---------------r--|||||--------------------------------------UC--------------||||||||||||||||||||||||||--------------------
-------------------------%%%%%%%%%--||||-------------------------------||||||---%%%%%%%%%%%%%--|||||-%%%%%%%%%%%%%%---------------------------------------||||||||||||||||||||||||||----%%%%%%%%%%    %%
-------------------------|||||||||--||||--%%%%%%%%%----%%%%%%%%%-g-----||||||---|||||||||||||--|||||-||||||||||||||---------------------------------------||||||||||||||||||||||||||----||||||||||||| ||
------%%%%%--------------|||||||||--||||--|||||||||----|||||||||-----%%%%%%%%%%%|||||||||||||%%%%%%%%||||||||||||||---------------------------------------||||||||||||||||||||||||||----||||||||||||||||
XXXXXX|||||XXXXXXXXXXXXXX|||||||||XXXXXXXX|||||||||----|||||||||-----||||||||||||||||||||||||||||||||||||||||||||||---XXXXXXXXXXXXXXXXXXXXXXXXXXXXXXXXXXXX||||||||||||||||||||||||||----||||||||||||||||