--------------------------------------------------------------------------------------------------------------------------------------------------------------------------------------------------------
--------------------------------------------------------------------------------------------------------------------------------------------------------------------------------------------------------
--------------------------------------------------------------------------------------------------------------------------------------------------------------------------------------------------------
--------------------------------------------------------------------------------------------------------------------------------------------------------------------------------------------------------
--------------------------------------------------------------------------------------------------------------------------------------------------------------------------------------------------------
--------------------------------------------------------------------------------------------------------------------------------------------------------------------------------------------------------
--------------------------------------------------------------------------------------------------------------------------------------------------------------------------------------------------------
--------------------------------------------------------------------------------------------------------------------------------------------------------------------------------------------------------
----------------------------------------------------------gg------g---------------------------------------------------------U---------------------------------------------------------------------------
--------------------------------------------------------------------------------------------------------------------------------------------------------------------------------------------------------
----------------------------------------------------------------------------------------------------------------------------------%%%%------------------------------------------------------------------
-------------------------------------ggggkkggkkgk---------------%%%%%-----------------------------------------------------------gggggggg--------------------------------------------------C2SSSS--------
----------------------------------------------------------------|||||------------------------------------------------%%%%%%%%%%%--||||------------------------------k-----------------------------------
-----------------------------------r-------------%%%%%%%%------%%%|||------g------g-----------------%%%--------------|||||||||||--||||--%%%%%%%%----g---------------------------------------------------
------%%%%%--------------%%%%%%%%%%%-------------||||||||-----%%%%%%%%------------------------------|||----%%%%%%%%%%|||||||||||--||||--||||||||-------------------%%%%%%%%%%----------------------%%F%%
    XX|||||XXX X  XXX  XX|||||||||||X XXX X   X X||||||||-----||||||||----XXX XXXX XXXX  XX  XX-----|||----|||||||||||||||||||||XXX XXXX||||||||--- XX XX   XXXXXXX||||||||||X X  XXXXXX  XXXXX XX ||X||