--------------------------------------------------------------------------------------------------------------------------------------------------------------------------------------------------------
--------------------------------------------------------------------------------------------------------------------------------------------------------------------------------------------------------
--------------------------------------------------------------------------------------------------------------------------------------------------------------------------------------------------------
--------------------------------------------------------------------------------------------------------------------------------------------------------------------------------------------------------
--------------------------------------------------------------------------------------------------------------------------------------------------------------------------------------------------------
--------------------------------------------------------------------------------------------------------------------------------------------------------------------------------------------------------
--------------------------------------------------------------------------------------------------------------------------------------------------------------------------------------------------------
--------------------------------------------------------------------------------------------------------------------------------------------------------------------------------------------------------
------------------------------------------------------CCSSSCSS------------------------------------------------------------------------------%%%%%%%-----------------------------------------------------
----------------------------------------------------gkgggkgkggkg------------------------------------SSUCS222-%%%%%%%%%%---------------------|||||||-------SSSSC2S---------------------------------------
--------------------------------------------------r----------------------------------------------------------||||||||||---------------------|||||||-----------------------------------------------------
--------------------------------------%%%%%%%%%%%%%-------------%%%%%%%%----------------------SCU2S----------||||||||||-----%%%%%%%%%%%%%%%%%%%%%%%%%%%-k-----------------------------------------------
--------------------------------------|||||||||||||-------------||||||||-------------------------------------||||||||||-----|||||||||||||||||||||||||||-------------------------------------------------
-------------------------------%%%%%--|||||||||||||%%%%%%%%%%%%%||||||||----gg-------g-----------------------||||||||||-----|||||||||||||||||||||||||||%%%%%%%%%%%%--------r---------------------F------
------%%%%%--------------------|||||--||||||||||||||||||||||||||||||||||-------------------------------------||||||||||-----|||||||||||||||||||||||||||||||||||||||------------------------------ ------
XXXXXX|||||XXXXXXXXXXXXXX----XXXXXXXXX||||||||||||||||||||||||||||||||||---XXXXXXXXXXXXXXXXXXXXXXXXXXXXXXXXXX||||||||||-----|||||||||||||||||||||||||||||||||||||||-----XXXXXXXXXXXXXX---XXXXXXXXXXXXFXX