--------------------------------------------------------------------------------------------------------------------------------------------------------------------------------------------------------
--------------------------------------------------------------------------------------------------------------------------------------------------------------------------------------------------------
--------------------------------------------------------------------------------------------------------------------------------------------------------------------------------------------------------
--------------------------------------------------------------------------------------------------------------------------------------------------------------------------------------------------------
---------------------------------------------------------------------------------------------------------------------------------U----------------------------------------------------------------------
--------------------------------------------------------------------------------------------------------------------------------------------------------------------------------------------------------
---------------------------------------------------------------------------------------------------------------------CC----------------%%%%%%-----------------------------------------------------------
-----------------------------------------------------------------------------------SCCU22--%%%%%%%%%%%%%-----------------------------kggkgkgkgk---------------------------------------------------------
-------------------------------------------------------------------------------------------|||||||||||||-----------gg-----%%%%%%%%%%%--||||||-----------------r---k-------------------------------------
------------------------------------------------------------------------------SU2----------|||||||||||||------------------|||||||||||--||||||--%%%%%%%%%%-----------------------------------------------
-------------------------------------------------------------------------------------------|||||||||||||%%%%%%%%%%%%%%%%%%|||||||||||--||||||--||||||||||---%%%%%%%%%%%%------%%%%%%%----%%%%%%%%%    %%
-------------------------------------------------------------------------------------------||||||||||||||||||||||||||||||||||||||||||%%%%%%%%%%||||||||||---||||||||||||------|||||||----|||||||||||| ||
-------------------------------------------g-----------------------------------------------||||||||||||||||||||||||||||||||||||||||||||||||||||||||||||||---||||||||||||------|%%%|||----|||||||||||||||
------------------------------g--------g--------------------------------%%%%%%%%%%---------||||||||||||||||||||||||||||||||||||||||||||||||||||||||||||||---||||||||||||----%%%%%%%%%%%%%|||||||||||||||
------%%%%%-------------------------------------------------------------||||||||||%%%%%%%%%||||||||||||||||||||||||||||||||||||||||||||||||||||||||||||||---||||||||||||----||||||||||||||||||||||||||||
XXXXXX|||||XXXXXXXXXXXXXX----XXXXXXXXXXXXXX---XXXXXXXXXXXXX----XXXXXXXXX|||||||||||||||||||||||||||||||||||||||||||||||||||||||||||||||||||||||||||||||||---||||||||||||----||||||||||||||||||||||||||||