--------------------------------------------------------------------------------------------------------------------------------------------------------------------------------------------------------
--------------------------------------------------------------------------------------------------------------------------------------------------------------------------------------------------------
--------------------------------------------------------------------------------------------------------------------------------------------------------------------------------------------------------
--------------------------------------------------------------------------------------------------------------------------------------------------------------------------------------------------------
--------------------------------------------------------------------------------------------------------------------------------------------------------------------------------------------------------
--------------------------------------------------------------------------------------------------------------------------------------------------------------------------------------------------------
--------------------------------------------------------------------------------------------------------------------------------------------------------------------------------------------------------
--------------------------------------------------------------------------------------------------------------------------------------------------------------------------------------------------------
--------------------------------------------------------------------------------------------------------------------------------------------------------------------------------------------------------
------------------------------------------------------------------------------------------------------------------------------------------U-------------------------------------------------------------
--------------------------------------------------------------------------------------------------------------------------------------------------------------------------------------------------------
---------------------------------------------------------------------------------------%%%%%%%------CSUSC------2SCSCS22-----------------------kgkgkrkkk------------------------------CUCSCCCS-----------
--------------------------------------------------------------%%%----g--------g--------|||||||--------------------------------------------------|||||---------------%%%%%%%%%%%%%%----------------------
-------------------------------g------------------------------|||----------------------|||||||-----g-------g------------------g-g-----%%%%%%%%--|||||--%%%%%%%%%%%%%||||||||||||||----------------F-----
------%%%%%---------------------------------------------------|||----%%%%%%%%%%%-------|||||||----------------------------------------||||||||--|||||--|||||||||||||||||||||||||||---------------- -----
XXXXXX|||||XXXXXXXXXXXXXX----XXXXXXXXXXXXXX----XXXXXXXXXX-----|||----|||||||||||-----XXXXXXXXXXXXXXXXXXXXXXXXXXXXXXXXXXXX----XXXXXXXXX||||||||XXXXXXXXX|||||||||||||||||||||||||||XXXXXXXXXXXXXXXXXXXFXX