------------------------------------------------------------------------------------------------ -------------------------------------------------------------------------------------------------------
------------------ ---------------------------------------- ---------------------------------------------------- ---------------------------------------------------------------------------------------
--------------------------------------------------------------------------------------------------------------------------------------------------------------------------------------------------------
---------------------------------------------------------------------------------------------------------------------------- --------------------------------------------------- -----------------------
--------------------------------------------------------------------------------- ----------------------------------------------------------------------------------------------------------------------
---------------------------------------------------------------------------------------------------------------------------- ---------------------------------------------------------------------------
-------------------------------------------------------------------------------- --------- ---------------------------------------------------------------------------------------------- --------------
------------------------------- ------------------------------------------------------------ -------------------------------------------------  S   S  --%%%  % %  %------------- ----------------------
---------------------------------------------------------------------------------------- ------------------------------------------------------ ---------|||||||||||------------------------------------
----------------------------------------------------------------------------------- - --------------------------tt------------------------U--------------|||||||||||------------------------------------
---------------------------------- ----------------------- ---------------------- -------- C------------------- tt-----%     %% % % ---------------------|||||||||||----- %     %  % ------------- -----
-------------------------------- ------------------------------------------------------        -----------%%%   %      |||||||||||||------------------ --|||||||||||-----||||||||||||-------------------
-------------------------------------------------- ---- -- ------ ----- ----------------------------------||||||||||||||||||| ||||||---------------------|||||||||||-----||||||||||||---%  %    % %%%F %
--- --------------------------------------%  ----------------------------- %% %  %%    -------- % % %     ||||||||||||||||||||||||||%       -------------|||||||||| -----||||||||||||---|||||||||||||%||
------% % %-------------------------------|||----  % %  %  %   -----------|||||||||||||--------|||||||||||||||||||||||||||||||||||||||||||||------- -----|||||||||||-----||||||||||||---||||||||||||||||
 XXX X|||||XX XX XXXXX XX---  XXXX  X-----|||----||||||||||||||---XXXX  X |||||||||||||XXXX  XX||||||||||||||||||||||||||||||||||||| ||||||| XXXX XXX  XX|||||||||||-----||||||||||||---||||||||||||||| 