--------------------------------------------------------------------------------------------------------------------------------------------------------------------------------------------------------
--------------------------------------------------------------------------------------------------------------------------------------------------------------------------------------------------------
--------------------------------------------------------------------------------------------------------------------------------------------------------------------------------------------------------
--------------------------------------------------------------------------------------------------------------------------------------------------------------------------------------------------------
--------------------------------------------------------------------------------------------------------------------------------------------------------------------------------------------------------
--------------------------------------------------------------------------------------------------------------------------------------------------------------------------------------------------------
--------------------------------------------------------------------------------------------------------------------------------------------------------------------------------------------------------
--------------------------------------------------------------------------------------------------------------------------------------------------------------------------------------------------------
------------------------Tt------------------------------------------------------------------------------------------------------------------------------------------------------------------------------
------------------------tt------------------------------------------------------------------------------------------------------------------------------------------------------------------------------
------------------------%%------------------------------------------------------------------------------------------------------------------------------------------------------------Tt----------------
------------------------||-------------------------------S22-------------------------------------------------------------------GTtF---------------------------------------------------tt----------------
---------------------%%%||%G%%-----------------------------------------------------------------------------------------------%%%tt%%%%%G--------------%%%%---%%%%%-G------------------tt----------------
--------------------2||||||%||%--%%%%%%-------%%%-------------------%%%%%%%%%----------------------------------GS2----------G|||tt|%%%%%-%%%%-----%%%-||||---|||||%%%%-----%%%%%-%%%%%%%%%%%----------F-
---------------------||||||||||--||||||-------|||-------------------|||||%%%%%%%%%%--------------%%%%%------%%%%-----------%%%%%%%%%%%%|-||||-----|||-||||---|||||||||-----|||||-|||||||||||---------- -
XXXXXXXXXXXXXXXXXXXXX||||||X||XXXXXXXXXXXXXXXXXXXXXXXXXXXXXXXXXXXXXXXXXXX||||||||||XXXXXXXXXXXXXX|||||------||||XXXXXXXXXXX||||||||||||XX||||-----|||X||||---|||||||||-----|||||X|||||||||||XXXXXXXXXXXX