---------------------------------------------------------------------------------------------------------------------------------      -----------------------------------------------------------------
---------------------------------------------------------------------------------------------------------------------------------      -----------------------------------------------------------------
---------------------------------------------------------------------------------------------------------------------------------      -----------------------------------------------------------------
---------------------------------------------------------------------------------------------------------------------------------      -----------------------------------------------------------------
---------------------------------------------------------------------------------------------------------------------------------      -----------------------------------------------------------------
---------------------------------------------------------------------------------------------------------------------------------      -----------------------------------------------------------------
---------------------------------------------------------------------------------------------------------------------------------      -----------------------------------------------------------------
---------------------------------------------------------------------------------------------------------------------------------      -----------------------------------------------------------------
---------------------------------------------------------------------------------------------------------------------------------      -----------------------------------------------------------------
---------------------------------------------------------------------------------------------------------------------------------      -----------------------------------------------------------------
---------------------------------------------------------------------------------------------------------------------------------      ---------------------------------------------------------------K-
-------------K------------------K------------------------------%%%%%%%%%%%%-----------%%%---G------------------------------------      --------------------------------------------------------------%%%
----------K--S2SS-SCS2C-------%%%%%%%%%%%---------SS-----------||||||||||||--------%%%%%%%G-%%---K-------------------------------      ---------------------------%%%%-----------%%%-----%%%%%-------|||
---------%%%%-----US--C-------|||||||||||----------------------||||||||||||--------||||%%%%%%%%%%%-------------------------------      ----%%%%%%%%%%%------------||||-----------|||-----|||||-------%%%
---------||||-----------------|||||||||||------------------%%%%%|||||||||||--------|||||||||||||||-------------------------------      ----|||||||||||------------||||%%%%%%%%%%%|||-----|||||-------|||
XXXXXXXXX||||XXXXXXXXXXXXXXXXX|||||||||||XXXXXXXXXXXXXXXXXX|||||XXXXXXXXXXXXXXXXXXXXXXXXXXXXXXXXXXXXXXXXXXXXXXXXXXXXXXXXXXXXXXXXX      XXXXXXXXXXXXXXXXXXXXXXXXXXXXXXX||||||||||||||-----|||||XXXXXXX|||