--------------------------------------------------------------------------------------------------------------------------------------------------------------------------------------------------------
--------------------------------------------------------------------------------------------------------------------------------------------------------------------------------------------------------
--------------------------------------------------------------------------------------------------------------------------------------------------------------------------------------------------------
--------------------------------------------------------------------------------------------------------------------------------------------------------------------------------------------------------
--------------------------------------------------------------------------------------------------------------------------------------------------------------------------------------------------------
--------------------------------------------------------------------------------------------------------------------------------------------------------------------------------------------------------
--------------------------------------------------------------------------------------------------------------------------------------------------------------------------------------------------------
--------------------------------------------------------------------------------------------------------------------------------------------------------------------------------------------------------
---------------------------------------------------------------------------------------------------------------------------------------------------------------------------Tt---------------------------
---------------------------------------------------------------------------------------------------------------------------------------------------------------------------tt---------------------------
----------------------------------------------------------------------------------------------------------------------------------------Tt------------Tt-------------------tt---------------------------
----------------------------------------------------------------------------------------UCGUS22----------------------------------- -----tt------------tt----------------%%%%%%%%%-----------------------
---------------G-------K---------------------------------%%%-----------------------------SS---------------------------%%%%-------GK-----tt------------tt----------------|||||||||------------G-------K--
-------------%%%----%%%%---------------------------------|||--------------G-----------%%%-----------------------------||||-----2U2S-----tt--------%%%%%%%%%%%-----------|||||||||------------%%%%---- %%
-------------|||----||||---------------------------------|||-------------%%%%%--------|||----------------------%%%%---||||----------%%%%%%%%%%%---|||||||||||-----------|||||||||------------||||----|||
XXXXXXXXXXXXX|||----||||XXXXXXXXXXXXXXXXXXXXXXXXXXXXXXXXX|||XXXXXXXXXXXXX|||||XXXXXXXXXXXXXXXXXXXXXXXXXXXXXXXXX||||XXX||||XXXXXXXXXX|||||||||||XXX|||||||||||XXXXXXXXXXXXXXXXXXXXXXXXXXXXXXXX||||----|||