--------------------------------------------------------------------------------------------------------------------------------------------------------------------------------------------------------
--------------------------------------------------------------------------------------------------------------------------------------------------------------------------------------------------------
--------------------------------------------------------------------------------------------------------------------------------------------------------------------------------------------------------
--------------------------------------------------------------------------------------------------------------------------------------------------------------------------------------------------------
--------------------------------------------------------------------------------------------------------------------------------------------------------------------------------------------------------
--------------------------------------------------------------------------------------------------------------------------------------------------------------------------------------------------------
--------------------------------------------------------------------------------------------------------------------------------------------------------------------------------------------------------
--------------------------------------------------------------------------------------------------------------------------------------------------------------------------------------------------------
---------------------------------------------------------------------------------------------------------------------------------------------------------------------------------------Tt---------------
---------------------------------------------------------------------------------------------------------------------------------------------------------------------------------------tt---------------
-----------------------------------------------------------------------------------------------------------Tt--------------------------------------------------------------------------tt---------------
---------------------------%%%%Tt%%------------------------------------------K-----------------------------tt---------------------F------------------------------------------------%%%%%%%%%%%----------
---------------------------||||tt||----------------------------------------UU2S----------------------------tt-------%%%------%%%%%UUU2USC-----------------------%%%%%%%%%%%--------|||||||||||----------
----------K--K------------%%%%%%%%%%%%-----------%%%%%%%%%%----%%%----%%%-2----------------------------%%%%%%%%%%%--|||------|||||-----%%%%%%%%%---%%%%%---%%%%-|||||||||||%%%%%%%-|||||||||||-----F----
---------%%%%%---%%%%%----||||||||||||-----------||||||||||----|||----|||---%%%%%----------------------|||||||||||--|||------|||||-----|||||||||---|||||---||||-||||||||||||||||||-|||||||||||----- ----
XXXXXXXXX|||||---|||||XXXXXXXXXXXXXXXXXXXXXXXXXXXXXXXXXXXXXXXXX|||----|||XXX|||||XXXXXXXXXXXXXXXXXXXXXXXXXXXXXXXXXXX|||------|||||XXXXXXXXXXXXXXXXX|||||---||||X|||||||||||XXXXXXXXXXXXXXXXXXXXXXXXXXXXX