--------------------------------------------------------------------------------------------------------------------------------------------------------------------------------------------------------
--------------------------------------------------------------------------------------------------------------------------------------------------------------------------------------------------------
--------------------------------------------------------------------------------------------------------------------------------------------------------------------------------------------------------
--------------------------------------------------------------------------------------------------------------------------------------------------------------------------------------------------------
--------------------------------------------------------------------------------------------------------------------------------------------------------------------------------------------------------
--------------------------------------------------------------------------------------------------------------------------------------------------------------------------------------------------------
--------------------------------------------------------------------------------------------------------------------------------------------------------------------------------------------------------
--------------------------------------------------------------------------------------------------------------------------------------U-----------------------------------------------------------------
-------------------------------------------------------g--------------------------------------------------------------------------------------SSSS2-----------------------------------------------------
--------------------------------------------------------------------------------------------------------------------------------------------------------------------------------------------------------
------------------------------------------------------------------------------------------------------------------------------------------kggkkggggggg--------------------------------------------------
------------------------------------gkgggkkg--------------------------------------------------------------------------g-----%%%%%%%%%%%%%%--------------------------------------------------------------
----------------------------------r--||||||---------------------------------------------------------------------------------||||||||||||||------------%%%%%%%%%%%%------%%%%%%%%------------------------
-------------------------%%%%%%%%%%--||||||-%%%%%%%%%%%-------------------------------g---g%g%%%%----g---gg-g----%%%%%%%%%%%||||||||||||||------------||||||||||||-----%%%%%%|||------------------------
------%%%%%--------------||||||||||--||||||-|||||||||||-----------------------------------|||||||----------------|||||||||||||||||||||||||%%%%%%%%%%%%||||||||||||-----|||||||||----%%%%%%%%%%%%%-------
XXXXXX|||||XXXXXXXXXXXXXX||||||||||XXXXXXXXX|||||||||||-----XXXXXXXXX----XXXXXXXXXXXX---XXXXXXXXXXXX-----XXXXXXXX|||||||||||||||||||||||||||||||||||||||||||||||||----XXXXXXXXXXXXXX|||||||||||||X    XX