------------------------------------------------------------------------------- ------------ ------------------ -------------------------------------------------------------------- -------------------
--------------------------------------------------------- -------------------------------------------------------------------------- ---------------------------------------------- --------------------
--------------------- --------------------------------------------------------------------------------------- ------------------------------------------------------------------------------------------
 ---------- -------------- ---------------------------------------------------- ------------------------------------------------------ - ---------------------------------------------------------------
---------------------------------------------------- --------------------------------------------------------------------------------------------- ------------ ----------------------------------------
------------------------------------------------------------------------------------ ---------------------- ---------------------------------------------------------- ------ --------------------------
--------------------------- -- ---------------------------------- ----- ------------- ----- ----------------- ------------------------------------------------------------------------------------------
--------------------------------------- ---------- -Tt----------------------------- ----------------------------------------------------------------------------------------------- -------- -----------
----------------------------------------------------t --- --------------------------------------------------------------------- ------------------------------ -----------------------------------------
 -----------------------------------Tt--------------tt--- ---------------------------------------------------------------------------------------------------------------------------------- -----------
------------------------------------tt--------------tt--- ------------- --------------------------------------------------------------------------- ----------------------------------------------------
---------------------G--------------tt---------- %  %%% % %------------------ --------------------------------------------          -----------------K------- ---G-------- -----------------------------
-------------------- %%--%%  2CC2--  %%%%-% %----||||||||||----K------------------%%%%%%------------------------------------------%--------------%%%%%-----%% -%%%%%------%%% %---- --------------%%%%--
- ---------- -------|||--||||----% |||||| %||----%%| ||||||----% %%%------%% %%---||||||%%% %----------------------------% %%%%%% % -------------|||||-----|||-|||||------|||||----K----------G---|| |--
--------------------|||--||||----||||||||||||----||||||||||----|||||----- |||||---|||||||||||------%%%%---%%%%---- ------|||||||||||-------------|||||-----|||-|||||------|||||--  %%-----%%%%%---||||--
XXXXXXXXX XXXXXXXXXX|||--||||XXXXXX||||||XXXXXXXX XXXXXXXXXXXXX|||||---- -|||||XXX||||||XXXXXXXXXXX||||---||||XXXXXXXXXXXXXXXXXXXXXXXXXXXXXXXXXXX|||||-----|||X|||||------|||||XX||||-----|||||XXX||||--