--------------------------------------------------------------------------------------------------------------------------------------------------------------------------------------------------------
--------------------------------------------------------------------------------------------------------------------------------------------------------------------------------------------------------
--------------------------------------------------------------------------------------------------------------------------------------------------------------------------------------------------------
--------------------------------------------------------------------------------------------------------------------------------------------------------------------------------------------------------
--------------------------------------------------------------------------------------------------------------------------------------------------------------------------------------------------------
--------------------------------------------------------------------------------------------------------------------------------------------------------------------------------------------------------
--------------------------------------------------------------------------------------------------------------------------------------------------------------------------------------------------------
--------------------------------------------------------------------------------------------------------------------------------------------------------------------------------------------------------
----------Tt--------------------------------------------------------------------------------------------------------------------------------------------------------------------------------------------
----------tt--------------------------------------------------------------------------------------------------------------------------------------------------------------------------------------------
----------tt------Tt---------------------------------------------------Tt-------------------------------------------------------------------------------------------------------------------------------
----------tt------tt------------------Tt-------------------------------tt--------------------------G-------------SCCS------------- ---------------------------------------------------------------------
------%%%%%%%%%---tt------------------tt-------------------------%%%%%%tt%%----------------------%%%%-----%%%-------------------K-%------%%%%----%%%-------------------------------------------%%%  ---%
------|||||||||---tt------%%%%%%------tt-------------%%%%--%%%%%-||||||tt||----------------------||||-----|||--------%%%%%----%%%-|------||||----|||-----%%%----%%%%---%%%----%%%%-------------||||| --|
------|||||||||%%%%%%%%---||||||-%%%%%%%%%%%%--------||||--|||||-||%%%%%%%%%%--------------------||||-----|||--------|||||----|||-|------||||----|||-----|||----||||---|||----||||-------------||||||--|
XXXXXXXXXXXXXXX||||||||XXX||||||X||||||||||||XXXXXXXX||||--|||||XXX||||||||||XXXXXXXXXXXXXXXXXXXX||||-----|||XXXXXXXX|||||----|||XXXXXXXX||||----|||XXXXX|||----||||XXX|||----||||XXXXXXXXXXXXX|||||  X|