--------------------------------------------------------------------------------------------------------------------------------------------------------------------------------------------------------
--------------------------------------------------------------------------------------------------------------------------------------------------------------------------------------------------------
--------------------------------------------------------------------------------------------------------------------------------------------------------------------------------------------------------
--------------------------------------------------------------------------------------------------------------------------------------------------------------------------------------------------------
--------------------------------------------------------------------------------------------------------------------------------------------------------------------------------------------------------
--------------------------------------------------------------------------------------------------------------------------------------------------------------------------------------------------------
--------------------------------------------------------------------------------------------------------------------------------------------------------------------------------------------------------
------------------------------------------------------------------------------------------------2SSSSSC2SU2--%%%%%%%%%%%%%%-----------------------------------------------------------------------------
-------------------------------------------------------------------------------------------------------------||||||||||||||-r----r--r-------------------------------------------------------------------
------------------------------------------------------------------------------------------2UCCC--------------||||||||||||||---------------------%%%%%%%%-------------r----------------------------------
----------k--------------------------------------------------------------------------------------------------||||||||||||||-----%%%%%%%%%-------||||||||------------------------------------------------
----------------------------------------------%%%%%%---------------------SSSCSSSU----------------------------||||||||||||||-----|||||||||-----%%%%%%%%%%%%%%-------%%%%%%%------------------------------
----------------------------------------------||||||------------tt-------------------------------------------||||||||||||||-----|||||||||-----||||||||||||||-------|||||||------------------------------
--------------------------r--------------r----||||||------------tt-----------------%%%%%%%%%%%%--------------||||||||||||||-----|||||||||-----||||||||||||||-----%%%%%%%%%%%%---------------------------
------%%%%%-----------------------------------||||||------------tt-----------------||||||||||||%%%%%%%%%%%%%%||||||||||||||-----|||||||||-----||||||||||||||-----||||||||||||-----%%%%%%%%%%%-----------
XXXXXX|||||XXXXXXXXXXXXXX----XXXXXXXXXXX----XXXXXXXXXX---XXXXXXXXXXXXXXXXXXXXXXXXXX||||||||||||||||||||||||||||||||||||||||-----|||||||||-----||||||||||||||-----||||||||||||-----|||||||||||XXXXX    XX