--------------------------------------------------------------------------------------------------------------------------------------------------------------------------------------------------------
--------------------------------------------------------------------------------------------------------------------------------------------------------------------------------------------------------
--------------------------------------------------------------------------------------------------------------------------------------------------------------------------------------------------------
--------------------------------------------------------------------------------------------------------------------------------------------------------------------------------------------------------
--------------------------------------------------------------------------------------------------------------------------------------------------------------------------------------------------------
--------------------------------------------------------------------------------------------------------------------------------------------------------------------------------------------------------
--------------------------------------------------------------------------------------------------------------------------------------------------------------------------------------------------------
--------------------------------------------------------------------------------------------------------------------------------------------------------------------------------------------------------
--------------------------------------------------------------------------------------------------------------------------------------------------------------------------------------------------------
--------------------------------------------------------------------------------------------------------------------------------------------------------------------------------------------------------
---------------------------------------------------------------------------------------------------------------------------------------------Tt---------------------------------------------------------
-----------------------------T--------------------------------------------------------------------------------------G------%-%G---F----------tt--------------------------------------------------------G
-------------------K---------tt-------------------K--------------2CSC2U-----------%%%%%%-----------------%%%%------%%%%%---|-%%%%%%----------tt---------------------------------------------------%%%%%%
----------------%%%%---------tt------------%%%%%%%%%%-----------------------------||||||-----------------||||------|||||---|-|%%%%%%%%%%%%%GKtt---------------------------------------------------|||F||
----------------||||------%%%%%%%%---------|||%%%%|||-----------------------------||||||-----------------||||------|||||%%%%%%%%%%%||||||%%%%%%%%%%-----------------------------------------------||| ||
XXXXXXXXXXXXXXXX||||XXXXXX||||||||XXXXXXXXXXXX||||XXXXXXXXXXXXXXXXXXXXXXXXXXXXXXXX||||||XXXXXXXXXXXXXXXXX||||------||||||||||||||||XXXXXX||||||||||XXXXXXXXXXXXXXXXXXXXXXXXXXXXXXXXXXXXXXXXXXXXXXXXXXXXX