--------------------------------------------------------------------------------------------------------------------------------------------------------------------------------------------------------
--------------------------------------------------------------------------------------------------------------------------------------------------------------------------------------------------------
--------------------------------------------------------------------------------------------------------------------------------------------------------------------------------------------------------
--------------------------------------------------------------------------------------------------------------------------------------------------------------------------------------------------------
--------------------------------------------------------------------------------------------------------------------------------------------------------------------------------------------------------
--------------------------------------------------------------------------------------------------------------------------------------------------------------------------------------------------------
--------------------------------------------------------------------------------------------------------------------------------------------------------------------------------------------------------
--------------------------------------------------------------------------------------------------------------------------------------------------------------------------------------------------------
--------------------------------------------------------------------------------------------------------------------------------------------------------------------------------------------------------
--------------------------------------------------------------------U----------------------------------------------------------------------g------------------------------------------------------------
---------------------------------------------------------------------------SSSS2---------------------------------------------------------------------------g--------k-----------------------------------
--------------------------------------gggggkgg--------------------------ggggkggkggg----------------------------------------------------------------------------------------r--k-------------------------
------------------------------------r--||||||-------------------------------------------------------------------------------------------------------------%%%%%%%%%%%%----------------------------------
-------------------------%%%%%%%%%%%%--||||||-%%%%%%%%----%%%%%%%%%%%%%%-----------%%%%%%%%%%%%%%---------------------g----g------%%%%%%%%----------------||||||||||||----%%%%%%%%----------------------
------%%%%%--------------||||||||||||--||||||-||||||||----||||||||||||||-----------||||||||||||||---------------------------------||||||||----------------||||||||||||----||||||||----------------------
XXXXXX|||||XXXXXXXXXXXXXX||||||||||||XXXXXXXXX||||||||----||||||||||||||XXXXXXXXXXX||||||||||||||-----XXXXXXXXXXXX---XXXXXXXXXXXXX||||||||---XXXXXXXXXXXXX||||||||||||----||||||||XXXXXXXXXXXXXXXX    XX