|||||||||||||||||||||||||||||||||||||||||||||||||||||||||||||||||||||||||||||||||||||||||||||||||||||||||||||||||||||||||||||||||||||||||||||||||||||||||||||||||||||||||||||||||||||||||||||Tt|||||||||
||||||||||||||||||Tt|||||||||||||||||||||||||||||||||||||||||||||||||||||||||||||||||||||Tt||||||||||||||||||||||||||||||||||||||||||Tt||||||||||||||||||||||||||||||||||||||||||||||||||||||tt|||||||||
||||||||||||||||||tt|||||||||||||||||||||||||||||||||||||||||||||||||||||||||||||||||||||tt||||||||||||||||||||||||||||||||||||||||||tt||||||||||||||||||||||||||||||||||||||||||||||||||||||tt|||||||||
||||||||||||||||||tt|||||||||||||||||||||||||||||||||||||||||||||||||||||||||||||||||||||tt|||||||||||||||||||||||||||||||||||||||F||tt|||||||||%%%%%||||||||||||||||||||||||||||||G|||||||G|tt|||||||||
||||||||||||||%%%%%%%%%|||||||||||||%%%%%%%%%%%||||||||||||||||||||||||||||||||||%%%%%%%%%%%%%%%|||||||||||||||||||%%%|||%%%||||||%||tt||||||||||||||||||||||||||%%%%%|||||||%%%||%%%|||%%%%%%%%%%%|||||
|||||||||||||||||||||||2C2S|||||||||||||||||||||||||||||||||||||||||||||||||||||||||||%%%%%%%%%%||||||||||||||||||||||||||||||||%%%%%%%%%%||||||||||||||||||||||||||||||%%%%||||||||||||||||||||||||||||
|||||||||||||||||||||||||||||||||||||||||||||||||||||||||||||||||||||||||||||||||||||||||||||||||||||||||||||||||||||||||||||||||||||||||||||||%%%%%|||||||||%%%%|||||||||||||||||||||||||||||||||||||||
XXXXXXXXXXXXXX|||||||||XXXXXXXXXXXXX|||||||||||XXXXXXXXXXXXXXXXXXXXXXXXXXXXXXXXXXXXXXXXXXXXXXXXXXXXXXXXXXXXXXXXXXXX|||||||||XXXX||||||||||XXXXX|||||XXXXXXXXX||||XXXXXXXXXXXX||||||||XXX|||||||||||XXXXX
