--------------------------------------------------------------------------------------------------------------------------------------------------------------------------------------------------------
--------------------------------------------------------------------------------------------------------------------------------------------------------------------------------------------------------
--------------------------------------------------------------------------------------------------------------------------------------------------------------------------------------------------------
--------------------------------------------------------------------------------------------------------------------------------------------------------------------------------------------------------
--------------------------------------------------------------------------------------------------------------------------------------------------------------------------------------------------------
--------------------------------------------------------------------------------------------------------------------------------------------------------------------------------------------------------
--------------------------------------------------------------------------------------------------------------------------------------------------------------------------------------------------------
--------------------------------------------------------------------------------------------------------------------------------------------------------------------------------------------------------
--------------------------------------------------------------------------------------------------------------------------------------------------------------------------------------------------------
--------------------------------------------------------------------------------------------------------------------------------------------------------------------------------------------------------
--------------------Tt------------------------------------------------------------------------------------------------------------------Tt--------------------------------------------------------------
--------------------tt-------------------------------------------------------------------------------Tt---------------------------F-----tt----K---------------------------------Tt----------------------
----------%%%G-----G%%%%%%%-%%%%%%--------%%%%%------%%%-----------------------------------G---------tt---------------------------%-----tt----%%%----%%%%------------%%%%%%%%%%-tt----------------------
----------|||C--%%%%%%%%%%%-||||||--------|||||------|||---K-----------------%%%----%%%%%%%%%--------tt------%%%%%-----%%%%--%%%%%|-----tt----|%%%%%%%%%%------------||||||||||-tt--------------F-------
----------|||---|||||||||||-||||||--------|||||------|||---%%%%---%%%%-------|||----|||||||||---%%%%%%%%%%---|||||-----||||--||||||--%%%%%%%%%|||||||||||------------||||||||%%%%%%%%%%%%%%%%%%% -------
XXXXXXXXXX|||XXXXXXXXXXXXXXX||||||XXXXXXXX|||||------|||XXX||||---||||XXXXXXX|||----|||||||||XXX||||||||||XXX|||||-----||||XXXXXXXXXX|||||||||X||||||||||XXXXXXXXXXXXXXXXXXXX|||||||||||||||||||XXXXXXXX