--------------------------------------------------------------------------------------------------------------------------------------------------------------------------------------------------------
--------------------------------------------------------------------------------------------------------------------------------------------------------------------------------------------------------
--------------------------------------------------------------------------------------------------------------------------------------------------------------------------------------------------------
--------------------------------------------------------------------------------------------------------------------------------------------------------------------------------------------------------
--------------------------------------------------------------------------------------------------------------------------------------------------------------------------------------------------------
--------------------------------------------------------------------------------------------------------------------------------------------------------------------------------------------------------
--------------------------------------------------------------------------------------------------------------------------------------------------------------------------------------------------------
--------------------------------------------------------------------------------------------------------------------------------------------------------------------------------------------------------
----------------------------------------------------------------------gg----g---------------------------------------------------------------------------------------------------------------------------
--------------------------------------------------------------------------------------------------------------------------------------------------------------------------------------------------------
-----------------------------------------------------------------------------------------------------------U--------------------------------------------------------------------------------------------
-----------------------------------ggkggkgkg-------------------------------------------------------------------ggggggkgggggkk--------------------%%%%%%%------------------------------------------------
---------------------------------r--|||||||----------------------------------------------------------------------%%%%%%%%%%----------------------|||||||------------------------------------------------
-------------------------%%%%%%%%%--|||||||-%%%%%%%%---%%%%%%%%%%%%%%----------tt---------g-----------g----------||||||||||--%%%%%%%%%%%%%%------|||||||------------------------------------------------
------%%%%%--------------|||||||||--|||||||-||||||||---||||||||||||||----------tt----------------------%%%%%%%%--||||||||||--||||||||||||||------|||||||------------------------------------------------
XXXXXX|||||XXXXXXXXXXXXXX|||||||||XXXXXXXXXX||||||||---||||||||||||||---XXXXXXXXXXXXXX---XXXXXXXXXXXXXX||||||||XXXXXXXXXXXXXX||||||||||||||----XXXXXXXXXXXX---XXXXXXXXXXXX-----XXXXXXXXXXXXXXXXXXX    XX