----------------------------------------------------------------------------------------------------------------------------------------------------    ------------------------------------------------
----------------------------------------------------------------------------------------------------------------------------------------------------    ------------------------------------------------
----------------------------------------------------------------------------------------------------------------------------------------------------    ------------------------------------------------
----------------------------------------------------------------------------------------------------------------------------------------------------    ------------------------------------------------
----------------------------------------------------------------------------------------------------------------------------------------------------    ------------------------------------------------
----------------------------------------------------------------------------------------------------------------------------------------------------    ------------------------------------------------
----------------------------------------------------------------------------------------------------------------------------------------------------    ------------------------------------------------
----------------------------------------------------------------------------------------------------------------------------------------------------    ------------------------------------------------
----------------------------------------------------------------------------------------------------------------------------------------------------    ------------------------------------------------
----------------------------------------------------------------------------------------------------------------------------------------------------    ------------------------------------------------
---------------------------------tt-------------------------------------------------------------------------------------------------SSCU------------    ------------------------------------------------
---------------------------------tt-----------------------------------------------------------------------------------------------------------------    ------------------------------------------------
-------------#---#--------------%%%%%%%%%------%%%%%--%%%%%--#--#--%%%%---%%%%----------------------------------------------------------------------    ------------------------------------------------
-----------%%%---%%%------------|||||||||------|||||--|||||%%%--%%%||||---||||--------------%%%%%---%%%%%%%--%%------%%%%%---%%%%%----r-----%%%%%%%%    %%%%%%%%%%%%%%%%%%%%%%%%%%%%%%%%%%%%%%%%%%%%%%%%
-----------|||---|||%%%%%--%%%%%|||||||||------|||||--||||||||--|||||||---||||--------%%--%%|||||---|||||||--||------|||||---|||||%%%%%%%%%%||||||||    ||||||||||||||||||||||||||||||||||||||||||||||||
XXXXXXXXXXX|||---||||||||--||||||||||||||XX--XX|||||--||||||||--|||||||---||||XXX--XXX||--|||||||---|||||||--||XX--XX|||||---|||||||||||||||||||||||    ||||||||||||||||||||||||||||||||||||||||||||||||