--------------------------------------------------------------------------------------------------------------------------------------------------------------------------------------------------------
--------------------------------------------------------------------------------------------------------------------------------------------------------------------------------------------------------
--------------------------------------------------------------------------------------------------------------------------------------------------------------------------------------------------------
--------------------------------------------------------------------------------------------------------------------------------------------------------------------------------------------------------
--------------------------------------------------------------------------------------------------------------------------------------------------------------------------------------------------------
--------------------------------------------------------------------------------------------------------------------------------------------------------------------------------------------------------
--------------------------------------------------------------------------------------------------------------------------------------------------------------------------------------------------------
--------------------------------------------------------------------------------------------------------------------------------------------------------------------------------------------------------
---------------------------------------------------------------------------------------------------------------------------------------------Tt---------------------------------------------------------
-----------------------Tt----------------------------------------Tt--------------------------------------------------------------------------tt---------------------------------------------------------
-----------------------tt----------------------------------------tt--------------------------------------------------------------------------tt---------------------------------------------------------
-----------------------tt-------------------------------G--------tt--------------------------------------------------------------- --------GGtt--G-S2----------------------------%%%--------------------
--------------------%%%%%%%%------------------------%%%-%------K-tt--G---------------------------%%%%%%---------------%%%%%---%%%-%-------%%%%%%%%%-----%%%%---------------------|||--------------------
--------------------||||||||------------------------%%%%%%%%--%%%%%%%%%--------------------------||||||---------------|||||---|||-|-------|||||||||-----||||----%%%%%%%%%%%------|||--------------------
--------------------||||||||------------------------||||||||--|||||||||--------------------------||||||---------------|||||---|||-|-------|||||||||-----||||----|||||||||||------|||-------------%   ---
XXXXXXXXXXXXXXXXXXXXXXXXXXXXXXXXXXXXXXXXXXXXXXXXXXXX||||||||XX|||||||||XXXXXXXXXXXXXXXXXXXXXXXXXX||||||XXXXXXXXXXXXXXX|||||---|||XXXXXXXXX|||||||||XXXXXXXXXXXXXXXXXXXXXXXXXXXXXXXXXXXXXXXXXXXXXX||||---