--------------------------------------------------------------------------------------------------------------------------------------------------------------------------------------------------------
--------------------------------------------------------------------------------------------------------------------------------------------------------------------------------------------------------
--------------------------------------------------------------------------------------------------------------------------------------------------------------------------------------------------------
--------------------------------------------------------------------------------------------------------------------------------------------------------------------------------------------------------
--------------------------------------------------------------------------------------------------------------------------------------------------------------------------------------------------------
----------------------------------------------------S SC S S-% %%%%%%%% % %-----------------------------------------------------------------------------------------------------------------------------
-------------------------------------------------------------||||||||||||||-----%% %%% %----------------------------------------------------------------------------------------------------------------
---------------------------------------------CSC U-----------||||||||||||||-----||||||||----------------------------------------------------------------------------------------------------------------
-------------------------------------------------------------||||||||||||||-----||||||||----------------------------------------------------------------------------------------------------------------
-------------------------------------------------------------||||||||||||||-----||||||||------------ ---------------------------------------------------------------------------------------------------
-------------------------------------------------------------||||||||||||||---%%% %%%%%%% %%--------------------------------------------------------ggkgggk-----------%%%%%%% %%  %%--------------------
----------------------------------------%%%%%%%%%%%----------||||||||||||||---||||||||||||||------------kgkggkkgggg-------------------------------r--|||||------------||||||||||||||g-------------------
----------------------------------------|||||||||||----------||||||||||||||---||||||||||||||--------------|||||||---------------gg---------%% %%%%%--|||||-%%%%%%%% % ||||||||||||||-----  %%%%%% %% F%%
--------------------------gg------------||||||||||| %%%%%%% %||||||||||||||---||||||||||||||---%%   %%% --|||||||--%% % % %----------------||||||||--|||||-|||||||||||||||||||||||||-----||||||||||||%||
------%%%% -----------------------------|||||||||||||||||||||||||||||||||||---||||||||||||||---|||||||||--|||||||--||||||||---%% %%%% %%% %||||||||%%%%%%  |||||||||||||||||||||||||-----|||||||||||||||
 X  XX|||||XXXXXXX X  X  -----XXXXXXXXXX|||||||||||||||||||||||||||||||||||---||||||||||||||---|||||||||X  XXXXX XX||||||||---||||||||||||||||||||||||||||||||||||||||||||||||||||||-----|||||||||||||||