--------------------------------------------------------------------------------------------------------------------------------------------------------------------------------------------------------
--------------------------------------------------------------------------------------------------------------------------------------------------------------------------------------------------------
--------------------------------------------------------------------------------------------------------------------------------------------------------------------------------------------------------
--------------------------------------------------------------------------------------------------------------------------------------------------------------------------------------------------------
--------------------------------------------------------------------------------------------------------------------------------------------------------------------------------------------------------
--------------------------------------------------------------------------------------------------------------------------------------------------------------------------------------------------------
--------------------------------------------------------------------------------------------------------------------------------------------------------------------------------------------------------
--------------------------------------------------------------------------------------------------------------------------------------------------------Tt----------------------------------------------
--------------------------------------------------------------------------------------------------------------------------------------------------------tt----------------------------------------------
--------------------------------------Tt---------------------------------------------------------------------------------Tt-----------------------------tt----------------------------------------------
--------------------------------------tt-------------Tt------------------------------------------------------------------tt-----------------------------tt----------------------------------------------
--------------------------------------tt-------------tt-----------------------------------------------%%%%K--------------tt-------F----------------%%%%%%%%%%%---------------------------------------G--
----------------G-----------------%%%%%%%%%----------tt------KG--------%%%%%-----%%%%%----------------||||%%%------------tt-------%----------------|||||||||||-------------------------------%%%%%%%%%--
--------%%%%%%%%%%----%%%%---%%%%%|||||||||--------K-tt----%%%%--------|||||-----|||||----------------|||||||%%%-2UC--%%%%%%%%%---|----------------|||||||||||-------------------------------||||||||F%%
--------||||||||||----||||---||||||||||||||------%%%%%%%%%%||||%%%%----|||||-----|||||----------------||||||||||------|||||||||---|----------------|||||||||||------%%%%------%%%%-----------|||||||| ||
XXXXXXXX||||||||||XXXX||||---||||||||||||||XXXXXX||||||||||||||||||XXXX|||||-----|||||XXXXXXXXXXXXXXXXXXXXXXXXXXXXXXXXXXXXXXXXXXXXXXXXXXXXXXXXXXXXXXXXXXXXXXXXXXXXXX||||------||||XXXXXXXXXXXXXXXXXXXXXX