--------------------------------------------------------------------------------------------------------------------------------------------------------------------------------------------------------
--------------------------------------------------------------------------------------------------------------------------------------------------------------- ----------------------------------------
------------------------------------------------------------------------------------------------------------------------------------------------------------ -------------------------------------------
------------------------------------------------------------------------------------------------------------------------------------------------------------------------------------------------------ -
-------------------------------- ------------------ ----------------------------------------------------------------------------------------------- ----------------------------------------------------
------------------------------------------------------------------------------------------ -------------------------------------------------------------------------------------------------------------
--------------------------------------------------------------------------------------------------------------------------------------------------------------------------------------------------------
-------------- ------------------------------------------------------------------------------- ----------------------------------- ------------------------ --------------------------------------------
-------------------- -------------------------------------------------------------------------------------------------------------------------------------------- --------------------------------------
-------------------------------------------------------------------------------------------------------------- -----------------------------------------------------------------------------------------
-----------------------------------------------------------------------K-------------------------------------K------------------------------------------------------Tt----------------------------------
-------% %%%%% --------------Tt---S----------------------------------S2S2-------------------%%% %  % ------%%%% %---Tt------------F-----Tt------------- ------------tt---------------- -----%%  %-% %%--
-------||||||||--------------tt-------------------------%%%----%%%------- -----  %---%%%%---|||||||||------||||||---tt------------%-----tt--------------------------tt------%%%% %%%  ------|||||-||||--
-------||||||||-------- -----tt-------------------------|||----|||-%%%%%%% %%--|||---||||---|||||||||------||||||--Ktt---GK-------|-----tt----K---------------------tt -----||||||||||------|||||-||||G-
-------||||||||----------% % % %%%----------------------|||----||| %   ||||||--|||---||||---|||||||||------||||%%% % %%%  %-------|- %% %%%%  %------------------%%%%%% %---||||||||||------|%%%%%%%% %%
 X XXX     X XXX XXXX XXX|||||||||XXXX   XX XXX XX XX XX|||---- ||||||X XXXX X |||-- ||||XX XXXX   XXX XXXX  X |||||||||| |X  XXX   |||||||||||  XX XX X XXXXXXXX||||||||X X||||||||||XXXX X |||||||||||