--------------------------------------------------------------------------------------------------------------------------------------------------------------------------------------------------------
--------------------------------------------------------------------------------------------------------------------------------------------------------------------------------------------------------
--------------------------------------------------------------------------------------------------------------------------------------------------------------------------------------------------------
--------------------------------------------------------------------------------------------------------------------------------------------------------------------------------------------------------
--------------------------------------------------------------------------------------------------------------------------------------------------------------------------------------------------------
--------------------------------------------------------------------------------------------------------------------------------------------------------------------------------------------------------
--------------------------------------------------------------------------------------------------------------------------------------------------------------------------------------------------------
--------------------------------------------------------------------------------------------------------------------------------------------------------------------------------------------------------
--------------------------------------------------------------------------------------------------------------------------------------------------------------------------------------------------------
---------------------------------------------------SSCCS2USCS2-%%%%%%%%%%%%%---------------------------------------------------r---------k--------------------------------------------k-----------------
---------------------------------------------------------------|||||||||||||--------------------------------------------------------------%%%%%%%%%%%--CSSSSSC------------------------------------------
---------------------------------------------SCU2--------------|||||||||||||-----g---------------U---gggggkkgkk--------------%%%%%%%%%%%%%|||||||||||---------------------------------------------------
--------------------------g-----%%g%%%-------------------------|||||||||||||-----------------------------2SS-----------------||||||||||||||||||||||||---------------------------------------------------
--------------------------------||||||-------------------------|||||||||||||----%%%%%%%%-----------------------%%%%%%%%%%%%%%||||||||||||||||||||||||--------------------------------------------F------
------%%%%%---------------------||||||-------------------------|||||||||||||----||||||||-----------------------||||||||||||||||||||||||||||||||||||||%%%%%%%%%%%--------------------------------- ------
XXXXXX|||||XXXXXXXXXXXXXX-----XXXXXXXXXXXXXXXXXXXXXXXXXXXXXXXXX|||||||||||||----||||||||---XXXXXXXXXXXXXXXXXXXX|||||||||||||||||||||||||||||||||||||||||||||||||XXXXXXXXXXXXXXXXXXXXX---XXXXXXXXXXXXXFXX