------------------------------------------------------------------------------------------------------------------------------        ------------------------------------------------------------------
------------------------------------------------------------------------------------------------------------------------------        ------------------------------------------------------------------
------------------------------------------------------------------------------------------------------------------------------        ------------------------------------------------------------------
------------------------------------------------------------------------------------------------------------------------------        ------------------------------------------------------------------
------------------------------------------------------------------------------------------------------------------------------        ------------------------------------------------------------------
------------------------------------------------------------------------------------------------------------------------------        ------------------------------------------------------------------
------------------------------------------------------------------------------------------------------------------------------        ------------------------------------------------------------------
------------------------------------------------------------------------------------------------------------------------------        ------------------------------------------------------------------
------------------------------------------------------------------------------------------------------------------------------        ------------------------------------------------------------------
------------------------------------------------------------------------------------------------------------------------------        ------------------------------------------Tt----------------------
-----------G-G----------------------------------------------------------------------------------------------------------------        ----------------------------------G-------tt----------------------
---------%%%%%%%%%%-------------------------Tt---------------------------------%%%%%%%%--------------------K------------------        ----------------S2U2-------------SC-------tt----G-----------------
---------||||||||||S2-----------------K-----tt--------------%%%%%%---22U-------||||||||--------------------%%%-----%%%%%------        ---------------------G---------GG------%%%%%%%%%%-----------------
---------|||||%%%%%%%%%%%----%%%%%%%%%%-----tt--G-----------||||||-------------||||||||--------------------|||-----|||||------        --------------------%%%%------%%%------||||||||||----------------U
---------||||||||||||||||----||||||||||-%%%%%%%%%%%---------||||||-------------||||||||--------------------|||-----|||||------        --------------------||||------|||------||||||||||-----------------
XXXXXXXXXXXXXXXXXXXXXXXXXXXXX||||||||||X|||||||||||XXXXXXXXXXXXXXXXXXXXXXXXXXXXXXXXXXXXXXXXXXXXXXXXXXXXXXXX|||-----|||||XXXXXX        XXXXXXXXXXXXXXXXXXXX||||------|||XXXXXXXXXXXXXXXXXXXXXXXXXXXXXXXXX