--------------------------------------------------------------------------------------------------------------------------------------------------------------------------------------------------------
--------------------------------------------------------------------------------------------------------------------------------------------------------------------------------------------------------
--------------------------------------------------------------------------------------------------------------------------------------------------------------------------------------------------------
--------------------------------------------------------------------------------------------------------------------------------------------------------------------------------------------------------
--------------------------------------------------------------------------------------------------------------------------------------------------------------------------------------------------------
--------------------------------------------------------------------------------------------------------------------------------------------------------------------------------------------------------
--------------------------------------------------------------------------------------------------------------------------------------------------------------------------------------------------------
--------------------------------------------------------------------------------------------------------------------------------------------------------------------------------------------------------
--------------------------------------------------------------------------CSCS--------------------------------------------------------------------------------------------------------------------------
--------------------------g-----------------------------------------------------------------------------------------------------------------------------------------------------------------------------
-----------------------------------------------------------------------------------rk------------------------------------------------------------------------------------------------%%  ---------------
------------------------------------------------- %%% %----------------------------------------------------------------------------------------------------------------------------- %%%%---------------
-------------------------------% %%--------------||||||------------------%  % %---------% % %%% ----------------------------------------------------------------------- %  % %%%% --|||||---------------
-------------------------------|   %%%%----gg----||||||---------g--------||||||--------    |||||--------------------------k-----------------rr---------r----k----------|||||||||||--|||||---------------
------ %% %--------------------||||||||----------|XXX  ----------------%%%  %% % %----% % % %% %%%% -------------------------------------------------------------------|||||||||||    % %%%-------------
 X XXX|||||X X  X XXX X X----- X XX   XX XX----X   X X XXX-----XXXXXX X|||||||||||----||||||||||||||-----  X----XXXX X XX-----X  X   X X  XX  XXX  XXXX --- X X XXX    ||||||||||||||||||||XXXXXXX  XFX 