--------------------------------------------------------------------------------------------------------------------------------------------------------------------------------------------------------
--------------------------------------------------------------------------------------------------------------------------------------------------------------------------------------------------------
--------------------------------------------------------------------------------------------------------------------------------------------------------------------------------------------------------
--------------------------------------------------------------------------------------------------------------------------------------------------------------------------------------------------------
--------------------------------------------------------------------------------------------------------------------------------------------------------------------------------------------------------
-------------------------------------------------------------------------------------------------U------------------------------------------------------------------------------------------------------
--------------------------------------------------------------------------------------------------------------------------------------------------------------------------------------------------------
-------------------------------------------------------------------------------------------------------%%%%%%%------------------------------------------------------------------------------------------
-----------------------------------------------------------------------------------------------------gggkgggkkkk-------------k----------r------%%%%%%%%-------------------------------------------------
----------------------------------------------------------CSCCSCCU2SS--%%%%%%%%--------------%%%%%%%%--|||||||---------------------------------||||||||-------------------------------------------------
-----------------------------------------------------------------------||||||||--------------||||||||--|||||||--%%%%%%%%%---%%%%%%%%%%%%%%-----||||||||------SSSSU--------------------------------------
--------------------------------------------------CSUSSSS--------------||||||||--------------||||||||--|||||||--|||||||||---||||||||||||||-----||||||||------------------------------------------%    %%
-----------------------------------------------------------------------||||||||-----%%%%%%%%%||||||||%%%%%%%%%%%|||||||||---||||||||||||||---%%%%%%%%%%%%%%--------------------------------------|||| ||
-------------------------g-g-------------------------------------------||||||||-----|||||||||||||||||||||||||||||||||||||---||||||||||||||---||||||||||||||-------------------------%%%%%%%%%%%%%|||||||
------%%%%%------------------------------------------------------------||||||||-----|||||||||||||||||||||||||||||||||||||---||||||||||||||---||||||||||||||%%%%%%%%%---%%%%%%%%%%%%%||||||||||||||||||||
XXXXXX|||||XXXXXXXXXXXXXX-----XXXXXXXXXXXXXXXXXXXXXXXXXXXXXXXXXXXXXXXXX||||||||-----|||||||||||||||||||||||||||||||||||||---||||||||||||||---|||||||||||||||||||||||---|||||||||||||||||||||||||||||||||