--------------------------------------------------------------------------------------------------------------------------------------------------------------------------------------------------------
--------------------------------------------------------------------------------------------------------------------------------------------------------------------------------------------------------
--------------------------------------------------------------------------------------------------------------------------------------------------------------------------------------------------------
--------------------------------------------------------------------------------------------------------------------------------------------------------------------------------------------------------
--------------------------------------------------------------------------------------------------------------------------------------------------------------------------------------------------------
--------------------------------------------------------------------------------------------------------------------------------------------------------------------------------------------------------
--------------------------------------------------------------------------------------------------------------------------------------------------------------------------------------------------------
-----------------------------------------------------Tt-------------------------------------------------------------------------------------------------------------------------------------------------
-----------------------------------------------------tt---------------Tt--------------------------------------------------------------------------------------------------------------------------------
-----------------------------------------------------tt---------------tt--------------------------------------------------------------------------------------------------------------------------------
--------------------------------------------------K-Gtt---------------tt---------------------------------------------------------------------------------------------------------------------Tt---------
------------------------------------------------%%%%%%%%%%-------%%%%%%%%%%%%--------------------------------------------Tt-------F----------------------------------------------------------tt---------
----------------------------------------%%%%%%--||||||||||-------||||||||||||---------------G------------------US2-------tt-------%--------G-------------------------------------------------tt---------
----------%%%---------------------------||||||--||||||||||-------|||||||||||SUU---%%%-----%%%%--------%%%%%%%%%%---------tt---K---%%%%%%%%%%---------UC22CS-------------------------------%%%%%%%%%%---G
----------|||---------------------------||||||--||||||||||-------||||||||||||-----|||-----||||--------||||||||||----%%%%%%%%%%%%--||||||||||----------------------------------------------||||||||||---%
 XXXXXXX X|||XXXXXX XXX XX  XXXX X XXXX ||||||X  XXXXXXXX XXXXXXXXXXXXXXXXXXXXX XX|||-----||||XX XXX X XXXXX XXXXX X||||||||||||XX||||||||||X X XXXXXX XX X X  XXX  X XXXXXX XXXXX X XXXXXXXXXXXXX XXX |