---------------------------------------------------------------------------------------------------------------------------------------------         --------------------------------------------------
---------------------------------------------------------------------------------------------------------------------------------------------         --------------------------------------------------
---------------------------------------------------------------------------------------------------------------------------------------------         --------------------------------------------------
---------------------------------------------------------------------------------------------------------------------------------------------         --------------------------------------------------
---------------------------------------------------------------------------------------------------------------------------------------------         --------------------------------------------------
---------------------------------------------------------------------------------------------------------------------------------------------         --------------------------------------------------
---------------------------------------------------------------------------------------------------------------------------------------------         --------------------------------------------------
---------------------------------------------------------------------------------------------------------------------------------------------         --------------------------------------------------
---------------------------------------------------------------------------------------------------------------------------------------------         --------------------------------------------------
-------------------------------------------------------------------------------------------------r-------------------------------------------         --------------------------------------------------
---------------------------------------------------------------------SCS-------------#--#-------%%%------------------------------------------         --------------------------------------------------
------------------------------------------------------------------------------------##--##------|||------------------------------------------         --------------------------------------------------
-------------%%--%%%%%---%%%----------------------------------------%--------------###--###-----|||--g----------------k-----%%%%%--%%%%%-----         --------------------------------------------------
-------------||--|||||---|||--#---#-----------------%%--%%%%%---%%%-|---k-%%---%%%%%%%--%%%%%%%%%%%%%%%%%%%%%------%%%%%%%%%|||||--|||||-----         --------------------------------------------------
-------------||--|||||---|||%%%---%%%%%%------------||--|||||---|||%%%%%%%||---|||||||--|||||||||||||||||||||------||||||||||||||--|||||%%%%%         %%%%%%%%%%%%%%%%%%%%%%%%%%%%%%%%%%%%%%%%%%%%%%%%%%
XXXXXXXXXXXXX||--|||||---||||||---||||||XXXXX--XXXXX||--|||||---||||||||||||---|||||||--|||||||||||||||||||||XX--XX||||||||||||||--||||||||||         ||||||||||||||||||||||||||||||||||||||||||||||||||