--------------------------------------------------------------------------------------------------------------------------------------------------------------------------------------------------------
--------------------------------------------------------------------------------------------------------------------------------------------------------------------------------------------------------
--------------------------------------------------------------------------------------------------------------------------------------------------------------------------------------------------------
--------------------------------------------------------------------------------------------------------------------------------------------------------------------------------------------------------
--------------------------------------------------------------------------------------------------------------------------------------------------------------------------------------------------------
--------------------------------------------------------------------------------------------------------------------------------------------------------------------------------------------------------
--------------------------------------------------------------------------------------------------------------------------------------------------------------------------------------------------------
--------------------------------------------------------------------------------------------------------------------------------------------------------------------------------------------------------
--------------------------------------------------------------------------------------------------------------------------------------------------------------------------------------------------------
--------------------------------------------------------------------------------------------------------------------------------------------------------------------------------------------------------
-----------------------------------------------------------------U--------------------------------------------------------------------------------------------------------------------------------------
--------------------------------------gg-----------------------------ggkkggkgggggg--------------------------------------------------%%%%%----------------SSSSU---------------SSCSU----------------------
-----------------------------------------------------------------------%%%%%%%%%----------------------------------------------------|%%%|---------------------------------------------------------------
-------------------------------------%%%%%%%%%%------------------------|||||||||--%%%%%%%%%------------------------------g---k------|||||---r---r-r---------------------------------------------F-------
------%%%%%-------------------%%%----||||||||||--------------%%%%%%%%--|||||||||--|||||||||-----------------------------------------|||||------------------------%%%%%%%%%---------------------- -------
XXXXXX|||||XXXXXXXXXXXXXX-----|||----||||||||||----XXXXXXXXXX||||||||XXXXXXXXXXXXX|||||||||-----XXXXXXXXXXXXX---XXXXXXXXXXXXXXXXXXXXXXXXXXXXXXXXXXXXXXXXXXXXXXXXX|||||||||XXXXXXXXXXX---XXXXXXXXXXXXXFXX