--------------------------------------------------------------------------------------------------------------------------------------------------------------------------------------------------------
--------------------------------------------------------------------------------------------------------------------------------------------------------------------------------------------------------
--------------------------------------------------------------------------------------------------------------------------------------------------------------------------------------------------------
--------------------------------------------------------------------------------------------------------------------------------------------------------------------------------------------------------
--------------------------------------------------------------------------------------------------------------------------------------------------------------------------------------------------------
--------------------------------------------------------------------------------------------------------------------------------------------------------------------------------------------------------
--------------------------------------------------------------------------------------------------------------------------------------------------------------------------------------------------------
---------------------------------------------------------------------------U----------------------------------------------------------------------------------------------------------------------------
----------------------------------------------------------------------------------C S------------------ --------------------------------------- C2S2CSS-------------------------------------------------
---------------------------------------------------------------------------------------------------------------------%%%%%%%%-----------------           -----------------------------------------------
-------------------------------------------------------------------------------         ----------%%%%%% %% %%-------||||||||--------------- -------------------------------------- --------------------
-------------------------------------------------------------------%%%%% %%%%%%-------------------||||||||||||-------||||||||----%%%% %%%%%%%------------%%% %%%%%%% %----------------------------------
-------------------------- - -%% %%%-------------------------------||||||||||||--------- %%%%% % %||||||||||||-------||||||||----||||||||||||------------|||||||||||||---%%%%  %%%-------------%%% %%F%%
------------------------------||||||----------%%%%%%---------------||||||||||||---------||||||||||||||||||||||----- %%%%  % %%%%%||||||||||||% %%%%%%%% %|||||||||||||---|||||||||----% % %%%%%||||||%||
------%%%% ------------------XX X|||----------||||||---------------|||||||||||| %%% %% %||||||||||||||||||||||-----|||||||||||||||||||||||||||||||||||||||||||||||||||---|||||||||----||||||||||||||||||
 XXXXX|||||XXXX X XXXXXXX---XXXX X XXX -----X XXX XXXXX---XXX XXX X|||||||||||||||||||||||||||||||||||||||||||-----|||||||||||||||||||||||||||||||||||||||||||||||||||---|||||||||----||||||||||||||||||