--------------------------------------------------------------------------------------------------------------------------------------------------------------------------------------------------------
--------------------------------------------------------------------------------------------------------------------------------------------------------------------------------------------------------
--------------------------------------------------------------------------------------------------------------------------------------------------------------------------------------------------------
--------------------------------------------------------------------------------------------------------------------------------------------------------------------------------------------------------
--------------------------------------------------------------------------------------------------------------------------------------------------------------------------------------------------------
--------------------------------------------------------------------------------------------------------------------------------------------------------------------------------------------------------
--------------------------------------------------------------------------------------------------------------------------------------------------------------------------------------------------------
--------------------------------------------------------------------------------------------------------------------------------------------------------------------------------------------------------
---------------------------Tt-------------------------------------------------------------------------------------------------------------------------------------------------------------------Tt------
-------------------Tt------t--------------------------------------------------------------------------------------------------------------------------------------------------------------------tt------
-------------------ttK-----t----------K-----Tt----------------------------------------------------------------------------------Tt--------------------------------------K-----K-------------G-G-tt------
-----------------%%Tt%%----t-------%%%%%----tt----------------------------------------------------------------------------------ttF----------------------------------S2CS22--%%%%%%--------%%%%%%%%%%%--
-----------------||tt|%%%%%%-%%%%%-|||||U22-tt----------------------------------------------------------------%%%%%------%%%----tt%---------------------G--------------------||||||--------|||||||||||--
--------------%%%%%%%%%%%%%%%%%%%%-||||%%%%%%%%%%%-----------K---------------%%%%%%%%%%---%%%%%--%%%%---------|||||------|||----tt|----U2CC2----------%%%%----%%%%-----------|%%%%%%%%%%%%-||||||||F||--
------------%%%%||||||||||||||||||-|||||||||||||||-----------%%%%%-----%%%---||||||||||---|||||--||||---------|||||------|||-%%%%%%%%-----------------||||----||||-----------|||||||||||||-|||||||| ||--
XXXXXXXXXXXX||||XXXXXXXX||||||||||XXXXXXXXXXXXXXXXXXXXXXXXXXX|||||-----|||XXX||||||||||XXX|||||--||||XXXXXXXXX|||||------|||X||||||||XXXXXXXXXXXXXXXXX||||----||||XXXXXXXXXXXX||||||||||||XXXXXXXXXXXXXX