--------------------------------------------------------------------------------------------------------------------------------------------------------------------------------------- ----------------
---- ----------------------- ------------------------------------------------------------------------------------------------------ -- ------ --------------------- ------------------------------------
--------------------------------------------------------------------------------------------------------------------------------------------------------------------------------------------------------
-------------------------- --------- ---------- --------------------------- ----------------------------------------------------------------------------------------------------------------------------
---- -------------------------------------------------- --------------------------- --------------------------------------------------------------------------------------------------------------------
--------------- ------------------------------------------------------------------------------------------------------------------------ ------------------------ --------------------------------------
 ----------- ------------------------------------------------------------------------------------------------------------------ ------------------------------------------------------------------------
------------- --------------------------------------------------------------------------------------- ------------------------------------------------------------------------------------------ -------
-------------- ------------------------ - -------------------------------------------------- ------------------------------------- ------------------ -------------------------------% %%%%-------------
-------- -------------------------------------------------------------------------------------------------------------------------S2CCCSS2-------------------------------------------|| |||-------------
------------------------------------------- ------------2CS2--------------------------------------------------- -----------------gkggggggggg-----------------------------------------|%% %%--% %%%%%% %%
----------------------------------------- -------------kgggkgkk----------------------------------------------------------------r------------------ --------------------------------%%%%%%%%%%|||| |||%||
------------------------------------ ----------------r----------------- -------g--g --g-- ----- ------------------------%%% % %%------------%% %%  %%-- ---------------------------|||||||||||||||||||||
-----------------------------gg---g------%%%%% %%%%% % -------- % %%% %% %%--------------------g---g-g------gg---------g|||||||| ------- ---||| |||||----g-------- ------%XXX%% ---|||||||||||||||||||||
--- --%% %%--------------------------- --|||||||||||||---------||||||||||||---%%%%%% %%%%%------------------------------||||||||%%   %%  %%%|||||||||--------------------|XXX|||---|||||||||||||||||||||
XXX XX|||||XXXXXXXXXXXXXX--- XXXXXXXXXXXX|||||||||||||XXXXXXXXX||||||||||||---||||||||||||-- -XXXXXXXXXX---XXXXXXXXXXXXX|||||||||||||||||||||||||||||---XXXXXXXXXXX---- XXXXXXXXXXX|||||||||||||||||||||