--------------------------------------------------------------------------------------------------------------------------------------------------------------------------------------------------------
--------------------------------------------------------------------------------------------------------------------------------------------------------------------------------------------------------
--------------------------------------------------------------------------------------------------------------------------------------------------------------------------------------------------------
--------------------------------------------------------------------------------------------------------------------------------------------------------------------------------------------------------
--------------------------------------------------------------------------------------------------------------------------------------------------------------------------------------------------------
--------------------------------------------------------------------------------------------------------------------------------------------------------------------------------------------------------
--------------------------------------------------------------------------------------------------------------------------------------------------------------------------------------------------------
-------------------------------------------------------------------------------------SSSSUCS2S2S-%%%%%%%%%%---------------------------------------------------------------------------------------------
----------------------------------------------------------g--------------------------------------||||||||||-g-------------r-----------------------------------------------------------------------------
---------------------------------------------------------------------------------S2U-------------||||||||||---------------------------------------------------------------------------------------------
-------------------------------------SSCS--------------------------------------------------------||||||||||-----%%%%%%%%%%%%%%%%%%%%--------------------------------------------------------------------
-----------------------------------gggggkgg------------------------------------------------------||||||||||-----||||||||||||||||||||---------------------------SCC--------------------------------------
---------------------------------r---------------------------------------------------------------||||||||||-----||||||||||||||||||||-----------------------------------------------------%%%%%----------
-------------------------%%%%%%%%%---------%%%%%%%%%%%%%%------------------%%%%%%%%%-------------||||||||||-----||||||||||||||||||||-----------------k--k------------k------------r------|||||----------
------%%%%%--------------|||||||||---------||||||||||||||------------------|||||||||-------------||||||||||-----||||||||||||||||||||-----%%%---------------------------------------------|||||----------
XXXXXX|||||XXXXXXXXXXXXXX|||||||||XXXXXXXXX||||||||||||||-----XXXXXXXXXXXXX|||||||||XXXXXXXXXXXXX||||||||||-----||||||||||||||||||||-----|||----XXXXXXXXXXXXXXXXXXXX-----XXXXXXXXXXXXXXXXXXXXXXXXX    XX