-------------------------------------------------------------------------------------------------------------------------------        -----------------------------------------------------------------
-------------------------------------------------------------------------------------------------------------------------------        -----------------------------------------------------------------
-------------------------------------------------------------------------------------------------------------------------------        -----------------------------------------------------------------
-------------------------------------------------------------------------------------------------------------------------------        -----------------------------------------------------------------
-------------------------------------------------------------------------------------------------------------------------------        -----------------------------------------------------------------
-------------------------------------------------------------------------------------------------------------------------------        -----------------------------------------------------------------
-------------------------------------------------------------------------------------------------------------------------------        -----------------------------------------------------------------
-------------------------------------------------------------------------------------------------------------------------------        -----------------------------------------------------------------
-------------------------------------------------------------------------------------------------------------------------------        -----------------------------------------------------------------
-------------------------------------------------------------------------------------------------------------------------------        -----------------------------------------------------------------
------------------------------------------------------------------------------------------------Tt-----------------------------        ----------------------------K------------------------------------
------------------------------------------------------------------------------------------------tt--------K--------------------        ---K----------%%%%%%%%%-CC2CC-G----------------------------------
------------------------------------------------------------------------------------------------tt-------%%%%%%%%%%%---G-------        ---%%%%--%%%-%%%%||||%%%%%%%%%%------S2SS2C----------------------
---------------------K----K------------------------K---------------------------------2S-----G---tt-G-----|||||||||||--%%%%%----        ---||||--|||-||||||||||||||||||------------%%%%-----%%%%%--------
-----------%%%%-----%%%-%%%%------%%%%%------------%%%------%%%%---------------------------%%%%%%%%%%----|||||||||||--|||||----        ---||||--|||-||||||||||||||||||------------||||-----|||||--------
XXXXXXXXXXX||||-----|||X||||------|||||XXXXXXXXXXXX|||------||||XXXXXXXXXXXXXXXXXXXXXXXXXXX||||||||||XXXX|||||||||||XX|||||----        XXX||||--|||XXXXXXXXXXXXXXXXXXXXXXXXXXXXXXX||||-----|||||XXXXXXXX