--------------------------------------------------------------------------------------------------------------------------------------------------------------------------------------------------------
--------------------------------------------------------------------------------------------------------------------------------------------------------------------------------------------------------
--------------------------------------------------------------------------------------------------------------------------------------------------------------------------------------------------------
--------------------------------------------------------------------------------------------------------------------------------------------------------------------------------------------------------
--------------------------------------------------------------------------------------------------------------------------------------------------------------------------------------------------------
--------------------------------------------------------------------------------------------------------------------------------------------------------------------------------------------------------
---------------------------------------------------------------------------------------------------------------------------------------------%%%%%%----SS222SC------------------------------------------
---------------------------------------------------------------------------------------------------------------------------------------------|%%%%|-----------------------------------------------------
----------------------------------------------------------------------------------------%%%%%%%-----------------SSSUSSSC-%%%%%%%%%%%%%%---g--||||||---g-----------------g----g--------------------------
-----------------------------------ggkkkkkkggg------------------------------------------|||||||--------------------------||||||||||||||------||||||-----------------------------------------------------
---------------------------------r--|||||||||------------------------------g----g-----%%%%%%%%%%%%%-----SSUCSS-----------||||||||||||||----%%%%%%%%%%%%%%%%%%%%%-----%%%%%%%%%--------------------------
-------------------------%%%%%%%%%--|||||||||-%%%%%%%%%%---%%%%%%%%%%%----------------|||||||||||||----------------------||||||||||||||----|||||||||||||||||||||-----|||||||||---%%%%%%%%%%%%%----------
-------------------------|||||||||--|||||||||-||||||||||---|||||||||||----%%%%%%%%%%%%|||||||||||||----------------------||||||||||||||----|||||||||||||||||||||-----|||||||||---|||||||||||||%%%%    %%
-------------------------|||||||||%%%%%%%%%%%%||||||||||---|||||||||||----|||||||||||||||||||||||||----------------------||||||||||||||----|||||||||||||||||||||-----|||||||||---|||||||||||||||||||| ||
------%%%%%--------------|||||||||||||||||||||||||||||||---|||||||||||----|||||||||||||||||||||||||%%%%%%%%%%%-----------||||||||||||||----|||||||||||||||||||||-----|||||||||---|||||||||||||||||||||||
XXXXXX|||||XXXXXXXXXXXXXX|||||||||||||||||||||||||||||||---|||||||||||----||||||||||||||||||||||||||||||||||||XXXXXXXXXXX||||||||||||||----|||||||||||||||||||||-----|||||||||---|||||||||||||||||||||||