-----------------------------------------------------------------------------------------------------------------------------       --------------------------------------------------------------------
-----------------------------------------------------------------------------------------------------------------------------       --------------------------------------------------------------------
-----------------------------------------------------------------------------------------------------------------------------       --------------------------------------------------------------------
-----------------------------------------------------------------------------------------------------------------------------       --------------------------------------------------------------------
-----------------------------------------------------------------------------------------------------------------------------       --------------------------------------------------------------------
-----------------------------------------------------------------------------------------------------------------------------       --------------------------------------------------------------------
-----------------------------------------------------------------------------------------------------------------------------       --------------------------------------------------------------------
-----------------------------------------------------------------------------------------------------------------------------       -------------Tt-----------------------------------------------------
---------------------------------------------------------------------------------------------------------Tt------------------       -------------tt-----------------------------------------------------
---------------------------------------------------------------------------------------------------------tt------------------       -------------tt-----------------------------------------------------
---------------------------------------------------------------------------------------------------------tt------------------       -------------tt-----------------------------------------------------
-----------------------------------------K-G------------%%%%%%%%%%--------------------------------------Ktt---G---------K----       ---------%%%%%%%%%--------------------------------------------------
-----------------------------------%%%%%%%%%%SS---------||||||||||-------%%%%------%%%-%%%----%%%%%---%%%%%%%%%%-----%%%%--%%       ---------|||||||||--------------------------K---------------------%%
-------%%%------%%%%-%%%%----------||||||||||-----------||||||||||-------||||------|||-|||----|||||---||||||||||-----||||--||       ---------%||||||||-------------------%%%%%%%%%---%%%------%%%%%---||
-------|||------||||-||||----------||||||||||-----------||||||||||-------||||------|||-|||----|||||---||||||||||-----||||--||       ---------|||||||||-------------------|||||||||---|||------|||||---%%
XXXXXXX|||------||||X||||XXXXXXXXXXXXXXXXXXXXXXXXXXXXXXXXXXXXXXXXXXXXXXXX||||------|||X|||----|||||XXXXXXXXXXXXXXXXXX||||--||       XXXXXXXXXXXXXXXXXXXXXXXXXXXXXXXXXXXXXXXXXXXXXXXXX|||------|||||XXX||