--------------------------------------------------------------------------------------------------------------------------------------------------------------------------------------------------------
--------------------------------------------------------------------------------------------------------------------------------------------------------------------------------------------------------
--------------------------------------------------------------------------------------------------------------------------------------------------------------------------------------------------------
--------------------------------------------------------------------------------------------------------------------------------------------------------------------------------------------------------
--------------------------------------------------------------------------------------------------------------------------------------------------------------------------------------------------------
--------------------------------------------------------------------------------------------------------------------------------------------------------------------------------------------------------
--------------------------------------------------------------------------------------------------------------------------------------------------------------------------------------------------------
--------------------------------------------------------------------------------------------------------------------------------------------------------------------------------------------------------
--------------------------------------------------------------------------------------------------------------------------------------------------------------------------------------------------------
--------------------------------------------------------------------------------------------------------------------------------------------------------------------------------------------------------
------------------------------------------------------------------------------------------------------------------------------------------K-KG-------------------G-Tt-----------------------------------
---------------------------------------------------------G---------------------------%%%%%%---------------------------------------F-------%%%%%-------%%%%%%%%%%%%-tt%%---------------------------------
---------------------UUU-------------------------------%%%%%---%%%%-2SCCSU2----------||||||---------------------------------------%-------|||||-------||||||||||||-tt||---------------------------------
-----------------------------------%%%------%%%--------|||||---||||------------------||||||%%%-----%%%%%---------------------%%%--|---%%%-|||%%-------||||||||||K|-tt||-------%%%------%%%%%-----F------
------------------------%%%%--%%%%-|||------|||--------|||||---||||------------------|||||||||-----|||||---------------------|||--|---|||-|||||-------|%%%%%||%%%%%%%%%%%%----|||------|||||----- ------
XXXXXXXXXXXXXXXXXXXXXXXX||||--||||X|||------|||XXXXXXXX|||||---||||XXXXXXXXXXXXXXXXXXXXXXXX|||-----|||||XXXXXXXXXXXXXXXXXXXXX|||--|---|||XXXXXXXXXXXXXX|||||XX||||||||||||XXXX|||------|||||XXXXXXXXXXXX