--------------------------------------------------------------------------------------------------------------------------------------------------------------------------------------------------------
--------------------------------------------------------------------------------------------------------------------------------------------------------------------------------------------------------
--------------------------------------------------------------------------------------------------------------------------------------------------------------------------------------------------------
--------------------------------------------------------------------------------------------------------------------------------------------------------------------------------------------------------
--------------------------------------------------------------------------------------------------------------------------------------------------------------------------------------------------------
--------------------------------------------------------------------------------------------------------------------------------------------------------------------------------------------------------
--------------------------------------------------------------------------------------------------------------------------------------------------------------------------------------------------------
--------------------------------------------------------------------------------------------------------------------------------------------------------------------------------------------------------
--------------------------------------------------------------------------------------------------------------------------------------------------------------------------------------------------------
--------------------------------------------------------------------------------------------------------------------------------------------------------------------------------------------------------
--------------------------------------------------------------------------------------------------------------------------------------------------------------------------------------------------------
---------------------------------UU-------------------------SS2U2-------------------G---------------------------------------------F------------------------------%%%%%%%%-%%----------------------------
-------------------------------------------------------------------------%%%----%%%%%--------%%%%%%%%-----------------------------%-----G---------%%%%-%%%%%%%%%-|||||||G-||----------------------------
----------------------------------------G-----K--------------------------|||----|||||--------||||||||-----------------------------|---%%%%%%%%%22C||||-|||||||||-|||||%%%%%%%%------------%%%%%%%%%-F---
---------------------%%%------%%%------%%%----%%%%-----------------------|||----|||||--------||||||||--------------%%%%--%%%%%----|---|||||||||---||||-|||||||||-|||||||||||||------------|||||||||- ---
XXXXXXXXXXXXXXXXXXXXX|||------|||XXXXXX|||----||||XXXXXXXXXXXXXXXXXXXXXXX|||----|||||XXXXXXXXXXXXXXXXXXXXXXXXXXXXXX||||--|||||XXXXXXXX|||||||||XXX||||XXXXXXXXXXXXXXXXXXXXXXXXXXXXXXXXXXXXXXXXXXXXXXXXXX