----------------------------------------------------------------------------------------------------------------------------------        --------------------------------------------------------------
----------------------------------------------------------------------------------------------------------------------------------        --------------------------------------------------------------
----------------------------------------------------------------------------------------------------------------------------------        --------------------------------------------------------------
----------------------------------------------------------------------------------------------------------------------------------        --------------------------------------------------------------
----------------------------------------------------------------------------------------------------------------------------------        --------------------------------------------------------------
----------------------------------------------------------------------------------------------------------------------------------        --------------------------------------------------------------
----------------------------------------------------------------------------------------------------------------------------------        --------------------------------------------------------------
----------------------------------------------------------------------------------------------------------------------------------        --------------------------------------------------------------
----------------------------------------------------------------------------------------------------------------------------------        --------------------------------------------------------------
----------------------------------------------------------------------------------------------------------------------------------        --------------------------------------------------------------
-----------------------------------------------------------Tt---------------------------------------------------------------------        --------------------------------------------------------------
-------------------------------------------------G---------tt----------------------------------------K----------------------------        ----------------------------------------------------------%%%%
------------------------------%%%%-------%%%%%%%%%%--------tt----------------------------------------%%%%%--%%%%-%%%--------------        -------------------------------%%%%--------------%%%%%%%%%||||
---------------------%%%%%%%%-||||-------||||||||||-----%%%%%%%%%--------------------%%%%%%%%%%%-----|||||--||||-|||-%%%%%-%%%%%%%        --------------G----------------||||-------------G|||||||||%%%%
---------------------||||||||-||||-------||||||||||-----|||||||||--------------------|||||||||||-----|||||--||||-|||-|||||-|||||||        --%%%%%-----%%%%%--------------||||---%%%%--%%%%%|||||||||||||
XXXXXXXXXXXXXXXXXXXXX||||||||X||||XXXXXXX||||||||||XXXXX|||||||||XXXXXXXXXXXXXXXXXXXX|||||||||||XXXXX|||||--||||X|||XXXXXXX|||||||        XX|||||-----|||||XXXXXXXXXXXXXX||||XXX||||--||||||||||||||XXXX