--------------------------------------------------------------------------------------------------------------------------------------------------------------------------------------------------------
--------------------------------------------------------------------------------------------------------------------------------------------------------------------------------------------------------
--------------------------------------------------------------------------------------------------------------------------------------------------------------------------------------------------------
--------------------------------------------------------------------------------------------------------------------------------------------------------------------------------------------------------
--------------------------------------------------------------------------------------------------------------------------------------------------------------------------------------------------------
--------------------------------------------------------------------------------------------------------------------------------------------------------------------------------------------------------
--------------------------------------------------------------------------------------------------------------------------------------------------------------------------------------------------------
-----------------------------------------------U--------------------------------------------------------------------------------------------------------------------------------------------------------
-----------------------------------------------------------------------------------------------------------------------------------------------------------------------------------%%%%%----------------
-----------------------------------------------------%%%%%%%%%%---------------g----------------------------------------------------------------------------------------------------|||||----------------
---------------------------------------------------ggkgkkkggkggkg--------------------------g-----g%%%%%--------------------------------------------------------------------------%%%%%%%%%%%%%%%%%    %%
------------------------------------------%%%%%%%%%--||||||||||----------------------------------||||||----g--------g----------------------2CSS2U-----------------------%%%%%%%%%|||||||||||||||||||| ||
------------------------------------------|||||||||--||||||||||--%%%%%%%%%%%%-----%%%%%%%%-------||||||------------------------------------------------------------tt---||||||||||||||||||||||||||||||||
------------------------------------------|||||||||--||||||||||--||||||||||||-----||||||||-----%%%%%%%%%%%%%%%%%%%%%%%%%---------tt------g-------k-----------------tt---||||||||||||||||||||||||||||||||
------%%%%%-------------------------------|||||||||%%%%%%%%%%%%%%||||||||||||-----||||||||-----|||||||||||||||||||||||||---------tt--------------------------------tt---||||||||||||||||||||||||||||||||
XXXXXX|||||XXXXXXXXXXXXXX----XXXXXXXXXXXXX|||||||||||||||||||||||||||||||||||-----||||||||-----|||||||||||||||||||||||||---XXXXXXXXXXXXXXXXXXXXXXXXXXXXXXXXXXXXXXXXXXXXX||||||||||||||||||||||||||||||||