--------------------------------------------------------------------------------------------------------------------------------------------------------------------------------------------------------
--------------------------------------------------------------------------------------------------------------------------------------------------------------------------------------------------------
--------------------------------------------------------------------------------------------------------------------------------------------------------------------------------------------------------
--------------------------------------------------------------------------------------------------------------------------------------------------------------------------------------------------------
--------------------------------------------------------------------------------------------------------------------------------------------------------------------------------------------------------
--------------------------------------------------------------------------------------------------------------------------------------------------------------------------------------------------------
---------------------------------------------------------------------------------------------------------------kggkgkgggg------------2SCCCCC2SU---------------------------------------------------------
----------------------------------------------------------------U--------------------------------------------r--||||||||--------------------------------------------------------------------------------
-----------------------------------------------------------------------------------------g----------g%%%%%%%%%--||||||||-%%%%%%%%%%---------------------------------------------------------------------
----------------------------------------------------------------------%%%%%--------------------------|||||||||--||||||||-||||||||||---------------------------------------------------------------------
--------------------------------------------------------------------kkggggggk-----------%%%%%%%%%%%%%|||||||||%%%%%%%%%%%||||||||||%%%%%%%%%%%%%%-------------------------------------------------------
------------------------------------------------------------%%%%%%%%--|||||-------------|||||||||||||||||||||||||||||||||||||||||||||||||||||||||-------------------------------------------------------
------------------------------------------------------------||||||||--|||||--%%%%%%%%%%%|||||||||||||||||||||||||||||||||||||||||||||||||||||||||-g-g-%%%g%%%%%%%%--------------------------------------
-------------------------g-----------------g-----g----------||||||||--|||||--||||||||||||||||||||||||||||||||||||||||||||||||||||||||||||||||||||-----||||||||||||----------------g---g-g---------------
------%%%%%-------------------------------------------------||||||||%%%%%%%%%||||||||||||||||||||||||||||||||||||||||||||||||||||||||||||||||||||-----||||||||||||----%%%%%%%%%%%-----------------------
XXXXXX|||||XXXXXXXXXXXXXX----XXXXXXXXXXXXX----XXXXXXXXXXXXXX|||||||||||||||||||||||||||||||||||||||||||||||||||||||||||||||||||||||||||||||||||||-----||||||||||||----|||||||||||XXXXXXXXXXXXXXXXX    XX