--------------------------------------------------------------------------------------------------------------------------------------------------------------------------------------------------------
--------------------------------------------------------------------------------------------------------------------------------------------------------------------------------------------------------
--------------------------------------------------------------------------------------------------------------------------------------------------------------------------------------------------------
--------------------------------------------------------------------------------------------------------------------------------------------------------------------------------------------------------
--------------------------------------------------------------------------------------------------------------------------------------------------------------------------------------------------------
--------------------------------------------------------------------------------------------------------------------------------------------------------------------------------------------------------
--------------------------------------------------------------------------------------------------------------------------------------------------------------------------------------------------------
--------------------------------------------------------------------------------------------------------------------------------------------------------------------------------------------------------
-----------------------------------------------------------------k--------------------------------------------------------------------------------------------------------------------------------------
-----------------------------------------SU22SCCCC--%%%%%%%%%%%%----------------------------------------------------------------------------------------------------------------------------------------
----------r-k---------------------------------------||||||||||||-----------------------%%%%%-----------------------------------------------------------r------------------------------------------------
---------------------------------CS2CCCU------------||||||||||||-----%%%%%%%%%%%-------|||||-------------------------------------2CSCS------------------------------------------------------------------
----------------------------------------------------||||||||||||-----|||||||||||-------|||||----------------------------------------------------------%%%%%%%%%%%--%%%%%%%------------------------------
----------------------------------------------------||||||||||||-----|||||||||||-------|||||------------------------r---------------------------------|||||||||||--|||||||--------------kk------------F-
------%%%%%-----------------------------------------||||||||||||-----|||||||||||-----%%%%%%%%%--------------------------------------------------------|||||||||||--|||||||---------------------------- -
XXXXXX|||||XXXXXXXXXXXXXXXXXXXXXXXXXXXXXXXXXXXXXXXXX||||||||||||-----|||||||||||-----|||||||||----XXXXXXXXXXXXX----XXXXXXXXXXXXXXXXXXXXXXXXXXXXXXXXXXX|||||||||||XXXXXXXXXXXXXXXXXXXXXX----XXXXXXXXXXFXX