--------------------------------------------------------------------------------------------------------------------------------------------------------------------------------------------------------
--------------------------------------------------------------------------------------------------------------------------------------------------------------------------------------------------------
--------------------------------------------------------------------------------------------------------------------------------------------------------------------------------------------------------
--------------------------------------------------------------------------------------------------------------------------------------------------------------------------------------------------------
--------------------------------------------------------------------------------------------------------------------------------------------------------------------------------------------------------
--------------------------------------------------------------------------------------------------------------------------------------------------------------------------------------------------------
--------------------------------------------------------------------------------------------------------------------------------------------------------------------------------------------------------
----------------------------------------------Tt--------------------------------------------------------------------------------------------------------------------------------------------------------
----------------------------Tt----------------tt--------------------------------------------------------------------------------------------------------------------------------------------------------
----------------------------tt----------------tt----------------------------------------------------Tt--------------------------------------------------------------------------------------------------
----------------------------tt--K-------------tt--K-------------------------------------------------tt---------------------------------------------------------------------------------------Tt---------
-------C22---------------%%%%%%%%--------%%%%%%%%%%%------Tt----------------------------------------tt----------------------------F----------------------------------------------------------tt---------
-------------------------||||||||--------|||||||||||------tt------------G----------U2%%%%%%%%----G--tt-----------------------%%%--%---%%%-----------%%%%%%%%%%%%--------K--G-----------------tt---------
-------------------------||||||||--------|||||||||||----%%tt%----------%%%-----------||||||||--%%%%%%%%%%%%------------U22U--|||--|---|||2CC--------||||||||||||--C2SSUUS-%%%%%%%%%%----%%%%%%%%F%%-----
-------------------------||||||||--------|||||||||||-%%%%%%%%%%%%------|||-----------||||||||--||||||||||||------------------|||--|---|||-----------||||||||||||----------||||||||||----|||||||| ||-----
XXXXXXXXXXXXXXXXXXXXXXXXXXXXXXXXXXXXXXXXXXXXXXXXXXXXX||||||||||||XXXXXX|||XXXXXXXXXXX||||||||XXXXXXXXXXXXXXXXXXXXXXXXXXXXXXXX|||--|---|||XXXXXXXXXXX||||||||||||XXXXXXXXXX||||||||||XXXXXXXXXXXXXXXXXXXX