--------------------------------------------------------------------------------------------------------------------------------------------------------------------------------------------------------
--------------------------------------------------------------------------------------------------------------------------------------------------------------------------------------------------------
--------------------------------------------------------------------------------------------------------------------------------------------------------------------------------------------------------
--------------------------------------------------------------------------------------------------------------------------------------------------------------------------------------------------------
--------------------------------------------------------------------------------------------------------------------------------------------------------------------------------------------------------
--------------------------------------------------------------------------------------------------------------------------------------------------------------------------------------------------------
--------------------------------------------------------------------------------------------------------------------------------------------------------------------------------------------------------
--------------------------------------------------------------------------------------------------------------------------------------------------------------------------------------------------------
------------------------------------------------------------------CSC------------g------g---------------------------------------------------------------------------------------------------------------
----------------------------------------------------------------gggggkgk--------------------------------------------------------------------------------------------------------------------------------
--------------------------------------------------------------r----------------------%%%---------g------------------------------------------------------------------------------------------------------
--------------------------------------------------%%%%%%%%%%%%%---------%%%%%%%%-----|%%%%%%%----------%%%%%---CUSCSCS-----CSSCSSC--------------------%%%%%--------SCSS---------------------------------
--------------------------------------------------|||||||||||||---------||||||||-----||||||||----------|||||------------------------------------------|||||---------------------------------------------
------------------------------%%%-----------------|||||||||||||%%%%%%%%%||||||||----%%%%%%%%%%%%-------|||||--g--g-----------------------g--k-r-------|%%%%%%%-------------r-----r----------------------
------%%%%%-------------------|||-----------------||||||||||||||||||||||||||||||----||||||||||||-------|||||------------------------------------------||||||||------------------------------------------
  XX X|||||XXXXXXXXX   XX-----|||---- XXXXX XXXXXX||||||||||||||||||||||||||||||----||||||||||||-----XXXXXXXX XXXXX X XXX XXX XXXX X----X X  XX XX---XXXXXX XX  XXXXXXX XXXXXX  XX XX XXXX XXXX   XXXFXX