--------------------------------------------------------------------------------------------------------------------------------------------------------------------------------------------------------
--------------------------------------------------------------------------------------------------------------------------------------------------------------------------------------------------------
--------------------------------------------------------------------------------------------------------------------------------------------------------------------------------------------------------
--------------------------------------------------------------------------------------------------------------------------------------------------------------------------------------------------------
--------------------------------------------------------------------------------------------------------------------------------------------------------------------------------------------------------
--------------------------------------------------------------------------------------------------------------------------------------------------------------------------------------------------------
--------------------------------------------------------------------------------------------------------------------------------------------------------------------------------------------------------
--------------------------------------------------------------------------------------------------------------------------------------------------------------------------------------------------------
--------------------------------------------------------------------------------------------Tt----------------------------------------------------------------------------------------------------------
--------------------------------------------------------------------------------------------tt----------------------------------------------------------------------------------------------------------
----------------------------------------------------G-------------------------------------K-tt---K------------------------------------------------------------------------------------------------------
--------------------------------------------------%%%%%%%%%%%---------------------------%%%%%%%%%%----------------------------%%%%F---------------------------------------------------------------------
-----------------------------K--------------G-----|||||||||||----%%-%%%%G%%%G-----------||||||||||----K-----------------------||||%-G--------------------------------------------------%%%%%%-----------
-------------%%%%%%%%%-------%%%--%%%%----%%%%%---|%%%%||||||---%%%%%%%%%|%%%%%%--------US||||||||%%%%%-----%%%---------------||||%%%-----%%%%%%%%%%------------------------------K----||||||---F-------
-------------|||||||||-------|||--||||----|||||---|||||||||||---||||||||||||||||--------|||||||||||||||-----|||---------------|||||||-----||||||||||-----------------%%%%%-----%%%%%---||||||--- -------
XXXXXXXXXXXXX|||||||||XXXXXXX|||XX||||----|||||XXXX||||XXXXXXXXX|||||||||X||||||XXXXXXXXXXXXXXXXXX|||||-----|||XXXXXXXXXXXXXXXXXXXXXXXXXXX||||||||||XXXXXXXXXXXXXXXXX|||||-----|||||XXXXXXXXXXXXXXXXXXXX