--------------------------------------------------------------------------------------------------------------------------------------------------------------------------------------------------------
--------------------------------------------------------------------------------------------------------------------------------------------------------------------------------------------------------
--------------------------------------------------------------------------------------------------------------------------------------------------------------------------------------------------------
--------------------------------------------------------------------------------------------------------------------------------------------------------------------------------------------------------
--------------------------------------------------------------------------------------------------------------------------------------------------------------------------------------------------------
--------------------------------------------------------------------------------------------------------------------------------------------------------------------------------------------------------
--------------------------------------------------------------------------------------------------------------------------------------------------------------------------------------------------------
---------------------------------------------------------------------------------------------------------------------------------------------Tt---------------------------------------------------------
---------------------------------------------------------------------------------------------------------------------------------------------tt---------------------------------------------------------
---------------------------------------------------------------------------------------------------------------------------------------------tt---------------------------------------------------------
-------------------------------Tt---------------------------------------Tt----------K-------Tt-----------------------------------------------tt-K-------------------------------------------------------
-------------------------------tt-----------Tt--------------------------tt%%%%-----SU-------tt------------------------------------ ------%%%%%%%%%%------------------SUUUUU-----------------------------
----------KG-------------------tt-----------t------%%%%%%%%%------------tt||||-----------%%%tt%-----%%%%-%%%------------G---------%------||||||||||-----------------------------------------------------
----------%%%%---%%%-------%%%%%%%%%%-------tt---G-|||||||||-------%%%%%%%%%%%-----------|G|tt|-----G|||-|||G-----%%%%%%%%--------|------||%%%%%|||-----------------------------------------------------
----------||||---|||-------||||||||||--%%%%%%%%%%%%|||||||||-------|||||||||||-----------%%%%%%%%--%%%%%%%%%%%%---||||||||--------|------||||||||||-----------------------------------------------------
XXXXXXXXXX||||---|||XXXXXXX||||||||||XX|||||||||||||||||||||XXXXXXX|||||||||||XXXXXXXXXXX||||||||XX||||||||||||XXXXXXXXXXXXXXXXXXXXXXXXXXXXXXXXXXXXXXXXXXXXXXXXXXXXXXXXXXXXXXXXXXXXXXXXXXXXXXXXXXX    XX