--------------------------------------------------------------------------------------------------------------------------------------------------------------------------------------------------------
--------------------------------------------------------------------------------------------------------------------------------------------------------------------------------------------------------
--------------------------------------------------------------------------------------------------------------------------------------------------------------------------------------------------------
--------------------------------------------------------------------------------------------------------------------------------------------------------------------------------------------------------
--------------------------------------------------------------------------------------------------------------------------------------------------------------------------------------------------------
--------------------------------------------------------------------------------------------------------------------------------------------------------------------------------------------------------
----------------------------------------------------------------------------------------------------------------------------------------------UCCS222SSC--%%%%%%%%%%--CSC2S22---------------------------
----------------------------------------------------------------------------------------------------------------------------------------------------------||||||||||------------------------------------
-----------------------------------------------------------------------------------------------------------------------------------------USCS-------------||||||||||-------------r----------------------
----------------------------------------------------------------------------------------------------------------------------------------------------------||||||||||------------------------------------
----------------------------------ggkgkgkggg--------------------------------------------------------------------------------------------------------------||||||||||%%%%%%%%%%%%%%%%%%%%%%%%%%%%%%    %%
--------------------------------r--||||||||--------------------------------------------------------CCSC2SSSC----------------------------------------------||||||||||||||||||||||||||||||||||||||||||| ||
-------------------------%%%%%%%%--||||||||-%%%%%%%%%%------------------------------------------------------------------------------%%%%%%%%%-------------||||||||||||||||||||||||||||||||||||||||||||||
-------------------------||||||||--||||||||-||||||||||------------------g--------------%%%%%%%----gg----g-----------------r--------k|||||||||-------------||||||||||||||||||||||||||||||||||||||||||||||
------%%%%%--------------||||||||%%%%%%%%%%%||||||||||---------------------------------|||||||--------------------------------------|||||||||%%%%%%%%%%%%%||||||||||||||||||||||||||||||||||||||||||||||
XXXXXX|||||XXXXXXXXXXXXXX|||||||||||||||||||||||||||||----XXXXXXXXX----XXXXXXXXXXX---XXXXXXXXXXXXXXXXXXXXXXXXX-----XXX----XXXXXXXXXX||||||||||||||||||||||||||||||||||||||||||||||||||||||||||||||||||||