--------------------------------------------------------------------------------------------------------------------------------------------------------------------------------------------------------
--------------------------------------------------------------------------------------------------------------------------------------------------------------------------------------------------------
--------------------------------------------------------------------------------------------------------------------------------------------------------------------------------------------------------
--------------------------------------------------------------------------------------------------------------------------------------------------------------------------------------------------------
--------------------------------------------------------------------------------------------------------------------------------------------------------------------------------------------------------
--------------------------------------------------------------------------------------------------------------------------------------------------------------------------------------------------------
--------------------------------------------------------------------------------------------------------------------------------------------------------------------------------------------------------
--------------------------------------------------------------------------------------------------------------------------------------------------------------------------------------------------------
------------------------------------Tt---------------------------------------------------------------------------------------------------------------------Tt-------------------------------------------
------------------------------------tt---------------------------------------------------------------------------------------------------------------------tt-------------------------------------------
------------------------------------tt--------------------------------------------------------------------------------------------------------------------Gtt-KG----------------------------------------
---------------------------------%%%%%%%%%%-------K---------------------------------------------------------------------------K--- -------------------%%%%%%%%%%------------------------------K---------
---------------------------------||||||||||-----%%%-----%%%-------%%%%---------G-K-------------------------------------------%%%%%%-------------------||||||||||----%%%%--%%%%-------------U2U22--------
---------------------------------||||||||||-----|||-----|||-------||||---%%%%%%%%%-------------------------------------------||||||-------------------||||||||||----||||--||||2USS2S2-------------------
---------------------------------||||||||||-----|||-----|||-------||||---|||||||||-------------------------------------------||||||-------------------||||||||||----||||--||||--------------------------
XXXXXXXXXXXXXXXXXXXXXXXXXXXXXXXXXXXXXXXXXXXXXXXX|||-----|||XXXXXXX||||XXXXXXXXXXXXXXXXXXXXXXXXXXXXXXXXXXXXXXXXXXXXXXXXXXXXXXX||||||XXXXXXXXXXXXXXXXXXXXXXXXXXXXXXXXX||||--||||XXXXXXXXXXXXXXXXXXXX    XX