--------------------------------------------------------------------------------------------------------------------------------------------------------------------------------------------------------
--------------------------------------------------------------------------------------------------------------------------------------------------------------------------------------------------------
--------------------------------------------------------------------------------------------------------------------------------------------------------------------------------------------------------
--------------------------------------------------------------------------------------------------------------------------------------------------------------------------------------------------------
--------------------------------------------------------------------------------------------------------------------------------------------------------------------------------------------------------
--------------------------------------------------------------------------------------------------------------------------------------------------------------------------------------------------------
--------------------------------------------------------------------------------------C2SS2C------------------------------------------------------------------------------------------------------------
------------------------------------------------------------------------------------kggggggggg----------------------------------------------------------------------------------------------------------
--------------------------------------SSCSCSS---------------g---------------------r-----------------------------------------------U--------------------------tt--------------g-----------%%%%%----------
------------------------------------gggkgkgggkk-----------------------%%%%%%%%%%%%%-----------%%%%%%%%------------------------------------SC2SC--------------tt--------------------------|||||----------
----------------------------------r-----------------------------%%%%%-|||||||||||||-----------||||||||-------------------------------------------------------tt---%%%%%%%%%%%%%%%%%%-----|||||--%%    %%
-------------------------%%%%%%%%%%------------%%%%%%%%%%%%-----|||||-|||||||||||||%%%%%%%%%%%||||||||--------------------------------ggggggggggg--------%%%%%%%%%||||||||||||||||||-----|%%%%%-||||| ||
-------------------------||||||||||------------||||||||||||---%%%%%%%%||||||||||||||||||||||||||||||||---%%%%%%%%%%%%%%----%%%%%%%%%%%-------------------|||||||||||||||||||||||||||---%%%%%%%%%||||||||
-------------------------||||||||||%%%%%%%%%%%%||||||||||||---||||||||||||||||||||||||||||||||||||||||---||||||||||||||----|||||||||||-----------%%%%%%%%|||||||||||||||||||||||||||---|||||||||||||||||
------%%%%%--------------||||||||||||||||||||||||||||||||||---||||||||||||||||||||||||||||||||||||||||---||||||||||||||----|||||||||||-----------|||||||||||||||||||||||||||||||||||---|||||||||||||||||
XXXXXX|||||XXXXXXXXXXXXXX||||||||||||||||||||||||||||||||||---||||||||||||||||||||||||||||||||||||||||---||||||||||||||----|||||||||||XXXXXXXXXXX|||||||||||||||||||||||||||||||||||---|||||||||||||||||