---------------------------------------------------------------------------------------------------------------------------------       ----------------------------------------------------------------
---------------------------------------------------------------------------------------------------------------------------------       ----------------------------------------------------------------
---------------------------------------------------------------------------------------------------------------------------------       ----------------------------------------------------------------
---------------------------------------------------------------------------------------------------------------------------------       ----------------------------------------------------------------
---------------------------------------------------------------------------------------------------------------------------------       ----------------------------------------------------------------
---------------------------------------------------------------------------------------------------------------------------------       ----------------------------------------------------------------
---------------------------------------------------------------------------------------------------------------------------------       ----------------------------------------------------------------
---------------------------------------------------------------------------------------------------------------------------------       ----------------------------------------------------------------
---------------------------------------------------------------------------------------------------------------------------------       ----------------------------------------------------------------
---------------------------------------------------------------------------------------------------------------------------------       -----------------Tt---------------------------------------------
----------------K---G-------------------Tt---------------------------------------------------------Tt----------------------------       -----------------tt---------------------------------------------
----------------2UCSSU------------------tt-------------------------------K-------------------------tt----------------------------       --------%%%%%%%%%Tt-%%%-----------------------------------------
----------------------------------------tt----------S2S--------------%%%%%-------------------------tt------G------------------2%%       --------|||||||||tt-|||-%%%-----%%%%%---------------------------
------------------------------------%%%%%%%%%------------------------|||||------------------G------tt-----SU2UUS---------------||       --------|||||%%%%%%%%%%%|||-----|||||---------------------------
------------------------------------|||||||||---------------%%%%%----|||||--------%%%%---%%%%%%%%%%%%%%%%%---------------------||       --------|||||||||||||||||||-----|||||-%%%--%%%%-----------------
XXXXXXXXXXXXXXXXXXXXXXXXXXXXXXXXXXXX|||||||||XXXXXXXXXXXXXXX|||||XXXX|||||XXXXXXXX||||---|||||||||||||||||XXXXXXXXXXXXXXXXXXXXX||       XXXXXXXXXXXXXXXXXXXXXXXX|||-----|||||X|||--||||XXXXXXXXXXXXXXXXX