--------------------------------------------------------------------------------------------------------------------------------------------------------------------------------------------------------
--------------------------------------------------------------------------------------------------------------------------------------------------------------------------------------------------------
--------------------------------------------------------------------------------------------------------------------------------------------------------------------------------------------------------
--------------------------------------------------------------------------------------------------------------------------------------------------------------------------------------------------------
--------------------------------------------------------------------------------------------------------------------------------------------------------------------------------------------------------
--------------------------------------------------------------------------------------------------------------------------------------------------------------------------------------------------------
--------------------------------------------------------------------------------------------------------------------------------------------------------------------------------------------------------
--------------------------------------------------------------------------------------------------------------------------------------------------------------------------------------------------------
----------------------------------------------------------------------------------------------------------------------------------------------------------Tt--------------------------------------------
---------------Tt--------------------Tt----------------------------------------------------Tt-------------------------------------------------------------tt--------------------------------------------
---------------tt--------------------tt----------------------------------------------------tt-K-----------------------------------------------------------tt--------------------------------------------
------------K--tt--------------------tt--------------------------------------------------K%%%%%%%%%%%----------------------------- --------------G--------tt--G-----------------------------------------
---------C%%%%%%%%%%%----------------tt---------------------------------G-------------%%%%%%%%%%%K|||-----------------------------%--%%%%------%%%%%-%%%%%%%%%%-----G-----------------------------------
----------|||||||||||--------S2S%%%%%%%%%%------%%%%%------------------%%%%%%%%%%-----|||||||||||SCSU----------%%%%%%%%%%---------|--||||------|||||-||||||||||-----UUS2C-------------------------------
----------|||||||||||-----------||||||||||------|||||---%%%%%----------||||||||||-----|||||||||||||||----------||||||||||---------|--||||------|||||-||||||||||-----------------------%%%--%%%%%--------
XXXXXXXXXX|||||||||||XXXXXXXXXXXXXXXXXXXXXXXXXXX|||||XXX|||||XXXXXXXXXXXXXXXXXXXXXXXXXXXXXXXXXXXXXXXXXXXXXXXXXXXXXXXXXXXXXXXXXXXXXXXX||||------|||||X||||||||||XXXXXXXXXXXXXXXXXXXXXXX|||--|||||XX    XX