--------------------------------------------------------------------------------------------------------------------------------------------------------------------------------------------------------
--------------------------------------------------------------------------------------------------------------------------------------------------------------------------------------------------------
--------------------------------------------------------------------------------------------------------------------------------------------------------------------------------------------------------
--------------------------------------------------------------------------------------------------------------------------------------------------------------------------------------------------------
--------------------------------------------------------------------------------------------------------------------------------------------------------------------------------------------------------
--------------------------------------------------------------------------------------------------------------------------------------------------------------------------------------------------------
--------------------------------------------------------------------------------------------------------------------------------------------------------------------------------------------------------
--------------------------------------------------------------------------------------------------------------------------------------------------------------------------------------------------------
--------------------------------------------------------------------------------------------------------------------------------------------------------------------------------------------------------
--------------------------------------------------------------------------------------------------------------------------------------------------------------------------------------------------------
--------------------------------------------------------------------------------------------------------------------------------------------------------------------------------------------------------
-----------------------------------------------%%-%%%%%%%%------------------------------------------------------------------------F--------------------------------------------------------------------%
-------------G--------2U2-----------------%%%%%G%-%G||||||-----2SC----%%-%%G%%%-----------------G----------K----------------------%----K------------------------------------%%%%%%%%-------------------|
-------------S22S---------------------%%%%%%%%%%%-|%%%%%||-----------%%%%%%%%||-----------------%%%-----%%%%%----------------%%%%%|----%%%%%------------------------SSSCS22-||||||||------------F-----G|
--------------------------------------||||||%%%%%%%%%%%|||-----------||||||||||-----------------|||-----|||||----------------||||||----|||||--------------------------------||||||||------------ -%%%%%|
XXXXXXXXXXXXXXXXXXXXXXXXXXXXXXXXXXXXXXXXXXXX|||||||||||XXXXXXXXXXXXXX||||||||XXXXXXXXXXXXXXXXXXX|||-----|||||XXXXXXXXXXXXXXXX||||||----|||||XXXXXXXXXXXXXXXXXXXXXXXXXXXXXXXX||||||||XXXXXXXXXXXXXX|||||X