--------------------------------------------------------------------------------------------------------------------------------------------------------------------------------------------------------
--------------------------------------------------------------------------------------------------------------------------------------------------------------------------------------------------------
--------------------------------------------------------------------------------------------------------------------------------------------------------------------------------------------------------
--------------------------------------------------------------------------------------------------------------------------------------------------------------------------------------------------------
--------------------------------------------------------------------------------------------------------------------------------------------------------------------------------------------------------
--------------------------------------------------------------------------------------------------------------------------------------------------------------------------------------------------------
--------------------------------------------------------------------------------------------------------------------------------------------------------------------------------------------------------
--------------------------------------------------------------------------------------------------------------------------------------------------------------------------------------------------------
--------------------------------------------------------------------------------------------------------------------------------------------------------------------------------------------------------
---------------------------------------------------------------------------------------Tt---------------------------------------------------------------------------------------------------------------
---------------------------------------------------------------------------------------tt----------------------------------------------------------------------------------------Tt---------------------
-------------------------------------------------------------------------%%----------%%%%%-------------------------------%-%%%%%%% %---------------------------------------------tt-----------G---------
---------------------------U22UCSS---------------------%%%%%%%%----------||--------%%%%%%%%%----------------------%%%%%%-|-|||||||%|---------------------------------------------tt---%%%%%%%%%%%-------
-------------------------------------------------------||||||||-----%%%%%%%%%------|||||||||----------------------||||||-|-|||||||||--------------------------------------%%%----tt---|||||||||||-------
-----------------%%%-----------------%%%%%-----%%%%%---||||||||-----|||||||||------|||||||||----------------------||||%%%%%%%%%%||||----------------%%%%%%%%%%------------||%%%%%%%%%%%||||||||||-------
XXXXXXXXXXXXXXXXX|||XXXXXXXXXXXXXXXXX|||||-----|||||XXX||||||||XXXXX|||||||||XXXXXXXXXXXXXXXXXXXXXXXXXXXXXXXXXXXXXXXXX||||||||||XXXXXXXXXXXXXXXXXXXX||||||||||XXXXXXXXXXXXXX|||||||||||XXXXXXXXXXX    XX