--------------------------------------------------------------------------------------------------------------------------------------------------------------------------------------------------------
--------------------------------------------------------------------------------------------------------------------------------------------------------------------------------------------------------
--------------------------------------------------------------------------------------------------------------------------------------------------------------------------------------------------------
--------------------------------------------------------------------------------------------------------------------------------------------------------------------------------------------------------
--------------------------------------------------------------------------------------------------------------------------------------------------------------------------------------------------------
--------------------------------------------------------------------------------------------------------------------------------------------------------------------------------------------------------
--------------------------------------------------------------------------------------------------------------------------------------------------------------------------------------------------------
--------------------------------------------------------------------------------------------------------------------------------------------------------------------------------------------------------
--------------------------------------------------------------------------------------------------Tt----------------------------------------------------------------------------------------------------
--------------------------------------------------------------------------------------------------tt---------------------------------------Tt-----------------------------------------------------------
------------------------------------------------------Tt------------------------------------------tt-------K-------------------------------tt---------------------G-------------------------------------
------------------------------------------------U2C---tt------------------------------------------tt------S2SS22U-----------------F-----G--tt---------------------UC--------%%%---------------G---------
-----------%%%%%---%%%%%----------K-------KK----------tt-------------------------------------%%%%%%%%%%%--------------------------%---%%%%%%%%%%%%--------------------------|||-------%%%%%%%%%%%-------
-----------|||||---|||||----------%%%%--%%%%---------Ktt---------------------------------SUCS|||||||||||--------------------------|---||||||||||||--------------------------|||-------|||||||||||F------
-----------|||||---|||||----------||||--||||-------%%%%%%%%----------------------------------|||||||||||---%%%%%--------%%%--%%%--|---||||||||||||--------------------------|||-------||||||||||| ------
XXXXXXXXXXX|||||---|||||XXXXXXXXXX||||--||||XXXXXXX||||||||XXXXXXXXXXXXXXXXXXXXXXXXXXXXXXXXXX|||||||||||XXX|||||XXXXXXXX|||--|||XXXXXXXXXXXXXXXXXXXXXXXXXXXXXXXXXXXXXXXXXXXXXXXXXXXXXXXXXXXXXXXXXXXXXXXX