--------------------------------------------------------------------------------------------------------------------------------------------------------------------------------------------------------
--------------------------------------------------------------------------------------------------------------------------------------------------------------------------------------------------------
--------------------------------------------------------------------------------------------------------------------------------------------------------------------------------------------------------
--------------------------------------------------------------------------------------------------------------------------------------------------------------------------------------------------------
--------------------------------------------------------------------------------------------------------------------------------------------------------------------------------------------------------
--------------------------------------------------------------------------------------------------------------------------------------------------------------------------------------------------------
--------------------------------------------------------------------------------------------------------------------------------------------------------------------------------------------------------
--------------------------------------------------------------------------------------------------------------------------------------------------------------------------------------------------------
--------------------------------------------------------------------------------------------------------------------------------------------------------------------------------------------------------
--------------------------------------------------------------------------------------------------------------------------------------------Tt----------------------------------------------------------
-------------------------------------------------------------------------------------------------------------G---Tt-------------------------tt----------------------------------------------------------
----------------------------------------------USC---Tt-------------------------------------------SCUUC2S-----%%%-tt---------------F--USU----tt----------------------------------------------------------
----------%%%-----%%%%------------------------------tt------------------------------%%%%-%%%%%K%-------------|||-t---KK-----------%----%%%%%%%%%%%-----------------------------G------------------------
----------|||-----||||%%%%%%%%%---------------------tt-K----------------------------||||%|||||%|------------%%%%%%%%%%%%----------|----|||||||%%%%%%%%%%%--------------------C2SS----------------%%%%%F-
----------|||-----|||||||||||||------------------%%%%%%%%---------------------------||||||||||||------------||||||||||||----------|----||||||||||||||||||-------%%%------------------------------||||| -
XXXXXXXXXX|||-----||||XXXXXXXXXXXXXXXXXXXXXXXXXXX||||||||XXXXXXXXXXXXXXXXXXXXXXXXXXX||||X|||||XXXXXXXXXXXXXXXXXXXXXXXXXXXXXXXXXXXXXXXXXXXXXXXXXXXXXXXXXXXXXXXXXX|||XXXXXXXXXXXXXXXXXXXXXXXXXXXXXXXXXXXXX