--------------------------------------------------------------------------------------------------------------------------------------------------------------------------------------------------------
--------------------------------------------------------------------------------------------------------------------------------------------------------------------------------------------------------
--------------------------------------------------------------------------------------------------------------------------------------------------------------------------------------------------------
--------------------------------------------------------------------------------------------------------------------------------------------------------------------------------------------------------
--------------------------------------------------------------------------------------------------------------------------------------------------------------------------------------------------------
--------------------------------------------------------------------------------------------------------------------------------------------------------------------------------------------------------
----------------------------------------------------------------------------------------------------------------------------------U---------------------------------------------------------------------
--------------------------------------------------------------------------------------------------------------------------------------------------------------------------------------------------------
----------------------------------------------------------------------------------------------------------------------------------------%%%%%%%-----------gg----------CUCS------------------------------
---------------------------------------------------------------------------------------------------------tt---------------------------gkggkgggggg-------------------------------------------------------
---------------------------------------------------------------------------------------------------------tt----------------%%%%%%%%%%%--|||||||----------%%%%%%%%%%%----------------------%%%%%%%%    %%
--------------------------gg----------------------------------------------------ggggkkggggk--------%%%%%%%%%%%%------------|||||||||||--|||||||--%%%%%%%%|||||||||||----------gr----------||||||||||| ||
---------------------------------------------------------------------------------------------------||||||||||||------%%%%%-|||||||||||--|||||||--|||||||||||||||||||%%%%%%%%%-------------||||||||||||||
-------------------------------%%%%%%%--------g---g---------------------------r------------%%%%%%%%||||||||||||------|||||-|||||||||||%%%%%%%%%%%||||||||||||||||||||||||||||%%%%%%%%%%%%%||||||||||||||
------%%%%%--------------------|||||||------------------------------%%%%%%%%%%%------------||||||||||||||||||||----%%%%%%%%|||||||||||||||||||||||||||||||||||||||||||||||||||||||||||||||||||||||||||||
XXXXXX|||||XXXXXXXXXXXXXX----XXXXXXXXXXXX----XXXXXXXXX----XXXXXXXXXX|||||||||||XXXXXXXXXXXX||||||||||||||||||||----|||||||||||||||||||||||||||||||||||||||||||||||||||||||||||||||||||||||||||||||||||||