---------------------------------------------------------------------------------------------------------------------------------        ---------------------------------------------------------------
---------------------------------------------------------------------------------------------------------------------------------        ---------------------------------------------------------------
---------------------------------------------------------------------------------------------------------------------------------        ---------------------------------------------------------------
---------------------------------------------------------------------------------------------------------------------------------        ---------------------------------------------------------------
---------------------------------------------------------------------------------------------------------------------------------        ---------------------------------------------------------------
---------------------------------------------------------------------------------------------------------------------------------        ---------------------------------------------------------------
---------------------------------------------------------------------------------------------------------------------------------        ---------------------------------------------------------------
---------------------------------------------------------------------------------------------------------------------------------        ---------------------------------------------------------------
---------------------------------------------------------------------------------------------------------------------------------        ---------------------------------------------------------------
---------------Tt-----------------------------------------------------------------Tt------------------------Tt-------------------        ---------------------------------------------------------------
---------------tt--------------------------------------------------------------Tt-tt------------------------tt-------------------        ---------------------------------------------------------------
--------------Gtt--------------------------------------------------------------t-Kt-------------------------tt-------------------        ------------------------------------SCSCCU2--------------------
----------%%%%%%%%%%%%-------------------------------------------------------%%%%%%%%%%-----------------%%%%%%%%%----------------        ------------------------------G--------------%%%------------%%%
----------||||||||||||G------------%%%%---%%%%%-----------%%%%%--%%%------%%%%%%%%%%%%|-----------------|||||||||-----%%%%%--%%%%        --------------------%%%%-----%%%%%-----------|||------------|||
----------||||||||||||%%%%%---%%%%%||||---|||||-----------|||||--|||------|||||||||||||----%%%%%--------|||||||||-----|||||--||||        ----%%%%------------||||-----|||||-----------|||------------|||
XXXXXXXXXX|||||||||||||||||---|||||||||---|||||XXXXXXXXXXX|||||--|||XXXXXXXXXXXXXXXXXXXXXXX|||||XXXXXXXX|||||||||XXXXX|||||--||||        ----||||XXXXXXXXXXXX||||-----|||||XXXXXXXXXXXXXXXXXXXXXXXXXX|||