--------------------------------------------------------------------------------------------------------------------------------------------------------------------------------------------------------
--------------------------------------------------------------------------------------------------------------------------------------------------------------------------------------------------------
--------------------------------------------------------------------------------------------------------------------------------------------------------------------------------------------------------
--------------------------------------------------------------------------------------------------------------------------------------------------------------------------------------------------------
--------------------------------------------------------------------------------------------------------------------------------------------------------------------------------------------------------
--------------------------------------------------------------------------------------------------------------------------------------------------------------------------------------------------------
--------------------------------------------------------------------------------------------------------------------------------------------------------------------------------------------------------
--------------------------------------------------------------------------------------------------------------------------------------------------------------------------------------------------------
----------------------------------------------------------------------------------------------------------------------------------------------Tt--------------------------------------------------------
----------------------------------------------------------------------------------------------------------------------------------------------tt--------------------------------------------------------
----------------------------------------------------------------------------------------------------------------------------------------------tt--------------------------------------------------------
--------------K----------------------------------------------------------------G-------------------------------K------------------ ----------Gtt---G----------------------------------------G-----------
-----------UC22UU-------------K-------------K------K%%%%%%%%%--------------%%%%%%%%%%%----------------------2SUUS-----------------%--------%%%%%%%%%----------------------------------------C-----------
-----------------------------%%%-----%%%%%-%%%%%%%%%%||||||||--------------|||||||||||--------------------------------------------|--------|||||||||---------K------------------------------%%%%%-------
-----------------------------|||-----|||||-||||||||||||||||||--------------|||||||||||--------------------------------------------|--------|||||||||--%%%--%%%----------------------%%%%%%%%||||%%    --
XXXXXXXXXXXXXXXXXXXXXXXXXXXXX|||-----|||||XXXXXXXXXXXXXXXXXXXXXXXXXXXXXXXXX|||||||||||XXXXXXXXXXXXXXXXXXXXXXXXXXXXXXXXXXXXXXXXXXXXXXXXXXXXX|||||||||XX|||--|||XXXXXXXXXXXXXXXXXXXXXX||||||||XXXX||||||XX