--------------------------------------------------------------------------------------------------------------------------------------------------------------------------------------------------------
--------------------------------------------------------------------------------------------------------------------------------------------------------------------------------------------------------
--------------------------------------------------------------------------------------------------------------------------------------------------------------------------------------------------------
--------------------------------------------------------------------------------------------------------------------------------------------------------------------------------------------------------
--------------------------------------------------------------------------------------------------------------------------------------------------------------------------------------------------------
--------------------------------------------------------------------------------------------------------------------------------------------------------------------------------------------------------
--------------------------------------------------------------------------------------------------------------------------------------------------------------------------------------------------------
--------------------------------------------------------------------------------------------------------------------------------------------------------------------------------------------------------
------------------------------------------------------------g-------------------------gggggggg----------------------------------------------------------------------------------------------------------
------------------------------------------------------------------------------------r--||||||-----------------------------------------------------g---------------k-----------------tt------------------
---------------------------------------SSS2SS--------------------------%%%%%%%%%%%%%%--||||||-%%%%%%%%%%%---------------------------------------------------------------------------tt------------------
-------------------------------------ggkkgggkggg-----------------%%%%%-||||||||||||||--||||||-|||||||||||--------------U---kgggggggggg----------------------------------------------tt------------------
-----------------------------------r-----------------------------|||||-||||||||||||||%%%%%%%%%|||||||||||---------------------CSSCSS-------------------------------------------%%%%%%%%%%---------------
-------------------------%%%%%%%%%%%------------%%%%%%%%%%%%----%%%|||-||||||||||||||||||||||||||||||||||-----------------------------%%%%%%%%%%%------------------------------||||||||||%%%%%%%%%    %%
------%%%%%--------------|||||||||||------------||||||||||||---%%%%%%%%||||||||||||||||||||||||||||||||||-----------------------------|||||||||||-----%%%%%%%%%%%--------------|||||||||||||||||||||| ||
XXXXXX|||||XXXXXXXXXXXXXX|||||||||||XXXXXXXXXXXX||||||||||||---||||||||||||||||||||||||||||||||||||||||||-----XXXXXXXXXXXXXXXXXXXXXXXX|||||||||||-----|||||||||||---XXXXXXXXXXX|||||||||||||||||||||||||