||||||||||||||||||||||||||||||||||||||||G|||||||||||||||||||||||||||||||||||||||||||||||||||||||||||||||||||||||||||||||||||||Tt||||||||||||||||||||||||||||||||||||||||||||||||||||||||||||||||||||||||
||||||||||||||||||||||||||||||||||UUS22SC|||||||||||%%%%%%%%%%%||||||||||||||||||||||||||||||||UUCCC||||||||||K|||||||||||||||tt||F|||||||||||||||||||||||||||||||||||||||||||||||||||||||||||||||||||||
||||||||||||||||||||||||||||||||||||||K|%%%%%%||||||||||||||||||||||||||||||||||||GG|||||||||||||||||%%%%||%%%%%||||||||||||||tt||%|||||||||||||||||%%%%%||||||||||K||||||||||||||||||||||||||||||||||||
||||||||||||||K|||%%%%%%|||||||||||||%%%%%%||||||||||||||||||||||||||G||||||||||%%%%|||%%%||||||||||||||||||||||||||||||||||||tt||K||||||||||%%%%%%%%%%%%||||||||||%%%%|||||%%%%|||||||||||||||||K|||||||
||||||%%%||%%%%%||||||%%%%%%%%%%|||||||||||||||||||||||||||||||||||%%%%%|||%%%|||||||||||||||||||||||||||||||||||||||||||||%%%%%%%%%%|||||||||||||||||||||||||||||||||||||||||||||||||||||%%%%|||%%%%%||
XXXXXX||||||||||XXXXXX||||||||||XXXXXXXXXXXXXXXXXXXXXXXXXXXXXXXXXXX|||||||||||XX||||||||||XXXXXXXXXXX|||||||||||XXXXXXXXXXX||||||||||XXXXXXXX||||||||||||XXXXXXXXXX|||||||||||||XXXXXXXXXX||||||||||||XX
