--------------------------------------------------------------------------------------------------------------------------------------------------------------------------------------------------------
--------------------------------------------------------------------------------------------------------------------------------------------------------------------------------------------------------
--------------------------------------------------------------------------------------------------------------------------------------------------------------------------------------------------------
--------------------------------------------------------------------------------------------------------------------------------------------------------------------------------------------------------
--------------------------------------------------------------------------------------------------------------------------------------------------------------------------------------------------------
--------------------------------------------------------------------------------------------------------------------------------------------------------------------------------------------------------
--------------------------------------------------------------------------------------------------------------------------------------------------------------------------------------------------------
--------------------------------------------------------------------------------------------------------------------------------------------------------------------------------------------------------
------------------------------------------------------------------U--------------------------g-----gr---------------------------------------------------------------------------------------------------
-------------------------------------------------------------------------SSSSCCC-----------------------------USSC22CS---------------------------------------------------------k-k-------k---------------
--------------------------------------------------------------------------------------------%%%%%%%%%%%%%%----------------------------------------------------------------------------------------------
--------------------------------%%%%%%--------------------------------gggkggggkggk----------||||||||||||||----------------------------------------------------------------------------------%%%%%%%%%F%%
--------------------------------||||||--------------------%%%%%%%%%%%%----------------------||||||||||||||--------------------------------------------------------%%%%%%%-------------------|||||||||%||
--------------------------------||||||-----g------tt------||||||||||||------------%%%%%%%%%%||||||||||||||%%%%%%%%%%%%%%-----------------------------------------%%%%||||-------------------||||||||||||
------%%%%%---------------------||||||------------tt------||||||||||||------------||||||||||||||||||||||||||||||||||||||-----------------------------------------||||||||-------------------||||||||||||
 XX X |||||X    XX  XX X -----XXX XX XXXX----- XX XXX  ---|||||||||||| XX XXXX X X||||||||||||||||||||||||||||||||||||||--- XXX  XXXXX XX-----XXX---- XX  XXX  XX X X    X   -----  X  X  XX||||||||||||