--------------------------------------------------------------------------------------------------------------------------------------------------------------------------------------------------------
--------------------------------------------------------------------------------------------------------------------------------------------------------------------------------------------------------
--------------------------------------------------------------------------------------------------------------------------------------------------------------------------------------------------------
--------------------------------------------------------------------------------------------------------------------------------------------------------------------------------------------------------
--------------------------------------------------------------------------------------------------------------------------------------------------------------------------------------------------------
--------------------------------------------------------------------------------------------------------------------------------------------------------------------------------------------------------
--------------------------------------------------------------------------------------------------------------------------------------------------------------------------------------------------------
--------------------------------------------------------------------------------------------------------------------------------------------------------------------------------------------------------
--------------------------------------------------------------------------------------------------------------------------------------------------------------------------------------------------------
--------------------------------------------------------------------------------------------------------------------------------------------------------------------------------------------------------
-------------------------------------------------------------------------------------------------------------------------------------------Tt--------------------------------------------------Tt-------
-----------------------------------CSUU--------------------------------------------------SC2--------------------------------------F--------tt----------------------%%%%%%-%%%------------------tt-F-----
---------------------UCCU22U------------%%%%%%%%%-----------------------------------------2SUS-------------------------------USCS2%-------Ktt--K-------------------||||KG-|||------------------tt- K---G
----------------------------------------|||||||||---------------------------------------------------------------------------------|---%%%%%%%%%%%------------------||%%%%%%%%%%--------CSS2%%%%%%%%%---S
----------------------------------------|||||||||--------------------%%%%%%%%%%%%%%%%%%%%---------------------%%%%%-----%%%-------|---|||||||||||------------------||||||||||||------------|||||||||----
XXXXXXXXXXXXXXXXXXXXXXXXXXXXXXXXXXXXXXXX|||||||||XXXXXXXXXXXXXXXXXXXX||||||||||||||||||||XXXXXXXXXXXXXXXXXXXXX|||||-----|||XXXXXXXXXXXXXXXXXXXXXXXXXXXXXXXXXXXXXXXXXXXXXXXXXXXXXXXXXXXXXXXX|||||||||XXXX