--------------------------------------------------------------------------------------------------------------------------------------------------------------------------------------------------------
--------------------------------------------------------------------------------------------------------------------------------------------------------------------------------------------------------
--------------------------------------------------------------------------------------------------------------------------------------------------------------------------------------------------------
--------------------------------------------------------------------------------------------------------------------------------------------------------------------------------------------------------
--------------------------------------------------------------------------------------------------------------------------------------------------------------------------------------------------------
--------------------------------------------------------------------------------------------------------------------------------------------------------------------------------------------------------
--------------------------------------------------------------------------------------------------------------------------------------------------------------------------------------------------------
--------------------------------------------------------------------------------------------------------------------------------------------------------------------------------------------------------
-------------------------------Tt---------------------------------------------------Tt------------------------Tt----------------------------------------------------------------------------------------
-------------------------Tt----tt---------------------------------------------------tt------------------------tt-----------------------Tt---------------------------------------------------------------
-------------------------tt----tt---------------------------------------------------tt------------------------tt-----------------------tt---------------------------------------------------------------
-------------------------tt%%%%%%%%%----------------------G-KSCU----------------G-US22SC----------------------tt------------------F----tt---------------------------------------------------------------
--------------K----------tt|||%G%%%|-%%%------------------%%%---%%%%%----%%%%--%%%%%%%%%%%%---------------%%%%%%%%%%--------------%-%-%%%%%%--------------------G---------------------------------------
-------%%%--%%%------%%%%%%%%%%%||||-|||------------------|||---|||||----||||--||||||||||||-%%%---%%%%----||||||||||--------------|-|-||||||-U---K--------------%%%%-------------------------------F----
-------|||--|||------|||||||||||||||-|||------------------|||---|||||----||||--||||||||||||-|||---||||----||||||||||--------------%%%%||||||--%%%%-----%%%%%----||||------------------------------- ----
XXXXXXX|||--|||XXXXXXXXXXXXXXXXXXXXXX|||XXXXXXXXXXXXXXXXXX|||XXX|||||----||||XXXXXXXXXXXXXXX|||---||||XXXXXXXXXXXXXXXXXXXXXXXXXXXX||||||||||XX||||-----|||||XXXXXXXXXXXXXXXXXXXXXXXXXXXXXXXXXXXXXXXXXXXX