--------------------------------------------------------------------------------------------------------------------------------------------------------------------------------------------------------
--------------------------------------------------------------------------------------------------------------------------------------------------------------------------------------------------------
--------------------------------------------------------------------------------------------------------------------------------------------------------------------------------------------------------
--------------------------------------------------------------------------------------------------------------------------------------------------------------------------------------------------------
--------------------------------------------------------------------------------------------------------------------------------------------------------------------------------------------------------
--------------------------------------------------------------------------------------------------------------------------------------------------------------------------------------------------------
--------------------------------------------------------------------------------------------------------------------------------------------------------------------------------------------------------
--------------------------------------------------------------------------------------------------------------------------------------------------------------------------------------------------------
--------------------------------------------------------------------------------------------------------------------------------------------------------------------------------------------------------
--------------------------------------------------------------------------------------------------------------------------------------------------------------------------------------------------------
--------------------------------------------------------------------------------------------------------------------------------------------------------------------------------------------------------
--------USSCC2-------------------------------------------------------------------------------------------------------------------- -GK---------------------------------------------------------G--------
-------------------------------------%%%%------%%%%----------------U2UC----------------------------------%%%%%%%%%%---------------%%%%%%------%%%--------------%%%%%-----------K--------%%%%%%%%%%------
--------------------K----------------||||------||||---------------------------------------------------%%%||||||||||-US2SSC%%%%----||||||------|||--------------|||||----%%%%%%%%%%-----G||||||||||------
-----------%%%%--%%%%%%-%%%-----%%%%-||||------||||-----%%%%%--%%%%----%%%------%%%-------------------|||||||||||||-------||||----||||||------|||--------------|||||----||||||||||--%%%%%%||||||||------
XXXXXXXXXXX||||XX||||||X|||-----||||X||||------||||XXXXX|||||--||||XXXX|||------|||XXXXXXXXXXXXXXXXXXX|||||||||||||XXXXXXXXXXXXXXXX|||||------|||XXXXXXXXXXXXXX|||||XXXX||||||||||XX||||||XXXXXXXX    XX