--------------------------------------------------------------------------------------------------------------------------------------------------------------------------------------------------------
--------------------------------------------------------------------------------------------------------------------------------------------------------------------------------------------------------
--------------------------------------------------------------------------------------------------------------------------------------------------------------------------------------------------------
--------------------------------------------------------------------------------------------------------------------------------------------------------------------------------------------------------
--------------------------------------------------------------------------------------------------------------------------------------------------------------------------------------------------------
--------------------------------------------------------------------------------------------------------------------------------------------------------------------------------------------------------
-------------------------------------------------------------------------------------------------------------------------------------------------SSSSS2CSUS-%%%%%%%%%-----------------------------------
------------------------------------------------------------------------------------------------------------------------------------------------------------|||||||||-----------------------------------
---------------------------------------------------------------------------------------------------------------------------------------------SUS------------|||||||||--g--------------------------------
--------------------------------------------------------------g--g-------------------------------U----------------------------------------------------------|||||||||-----------------------------------
--------------------------------------gggggkggggk----------------------------gg-------------------------SCSS2--------------------g--------------------------|||||||||---%%%%%%%%%%----------------------
------------------------------------r--|||||||||-----------------------------------------------------kkkkggggggg--------------------------------------------|||||||||---||||||||||----------------------
-------------------------%%%%%%%%%%%%--|||||||||-%%%%%%%%%%%%-----------------------------------------------------------------%%%%%%%%%%%%%%%%%%------------|||||||||---||||||||||----------------------
-------------------------||||||||||||--|||||||||-||||||||||||---------------------%XXX%-----%%%%%%%%%-----------%%%%%%%%%%%%%%||||||||||||||||||------------|||||||||---||||||||||---%%%%%%%%%%%%%    %%
------%%%%%--------------||||||||||||%%%%%%%%%%%%||||||||||||---------------------|XXX|-----|||||||||-----------||||||||||||||||||||||||||||||||%%%%%%%%%%%%|||||||||---||||||||||---|||||||||||||||| ||
XXXXXX|||||XXXXXXXXXXXXXX||||||||||||||||||||||||||||||||||||----XXXXXXXXXXX----XXXXXXXX----|||||||||XXXXXXXXXXX|||||||||||||||||||||||||||||||||||||||||||||||||||||---||||||||||---|||||||||||||||||||