-------------------------------------------------------------------------------------------------------------------------------------------------    ---------------------------------------------------
-------------------------------------------------------------------------------------------------------------------------------------------------    ---------------------------------------------------
-------------------------------------------------------------------------------------------------------------------------------------------------    ---------------------------------------------------
-------------------------------------------------------------------------------------------------------------------------------------------------    ---------------------------------------------------
-------------------------------------------------------------------------------------------------------------------------------------------------    ---------------------------------------------------
-------------------------------------------------------------------------------------------------------------------------------------------------    ---------------------------------------------------
------------------g---------------------------------------------------------------------------------SCU2-----------------------------------------    ---------------------------------------------------
------------------%%%%---------------------------------------------------------------------------------------------------------------------------    ---------------------------------------------------
------------------||||-----------------------------------------------------------------------------------------SCCSS-----------------------------    ---------------------------------------------------
------------------||||------------------y----------------------------------------------------------gyr-------------------------------------------    ---------------------------------------------------
------------------||||---------------%%%%%%%------------------------------------------------tt-----%%%%%%%---------------------------------------    ---------------------------------------------------
----------------%%%%||-------CCCS----|||||||------------------------------------------------tt-----|||||||---------------------------------------    ---------------------------------------------------
----------------||||||--------------%%%%%%%%%%--------------%%%-------------------------%%%%%%%----||||k|g---%%%%%%%%%%%%%--%%%%-----------------    ---------------------------------------------------
----------------|||y||-k------------||||||||||--------------|||-------------------------|||||||%%%%%%%%%%%%%%|||||||||||||--||||-----------%%%%%%    %%%%%%%%%%%%%%%%%%%%%%%%%%%%%%%%%%%%%%%%%%%%%%%%%%%
----------%%%%%%%%%%%%%%%%----------||||||||||%%%%--%%%%---r|||---------%%%---%%%-------||||||||||||||||||||||||||||||||||--||||-----------||||||    |||||||||||||||||||||||||||||||||||||||||||||||||||
XXXXXXXXXX||||||||||||||||XXXXXXXXXX||||||||||||||--||||XXXXXXXXXXXXXXXX|||---|||XX---XX||||||||||||||||||||||||||||||||||--||||XXXX---XXXX||||||    |||||||||||||||||||||||||||||||||||||||||||||||||||