--------------------------------------------------------------------------------------------------------------------------------------------------------------------------------------------------------
--------------------------------------------------------------------------------------------------------------------------------------------------------------------------------------------------------
--------------------------------------------------------------------------------------------------------------------------------------------------------------------------------------------------------
--------------------------------------------------------------------------------------------------------------------------------------------------------------------------------------------------------
--------------------------------------------------------------------------------------------------------------------------------------------------------------------------------------------------------
--------------------------------------------------------------------------------------------------------------------------------------------------------------------------------------------------------
--------------------------------------------------------------------------------------------------------------------------------------------------------------------------------------------------------
--------------------------------------------------------------------------------------------------------------------------------------------------------------------------------------------------------
--------------------------------------------------------------------------------------------------------------------------------------------------------------------------------------------------------
--------------------------------------------------------------------------------------------------------------------------------------------------------------------------------------------------------
--------------------------------------------------------------------------------------------------------------------------------------------------------------------------------------------------------
----------------------K---G--K-------------------------G-------------------------------------------------------------------------- -----K--------G------------------------------------------------------
--------------------%%%%%%%%%%---G-G--UC2SU2---%%%%%%%%%%-------------------------------------------------------------------------%-%%%%%------%%%%------------------------------------------------K----
--------------------||||||||||---%%%-----------||||||||||-------------------------------------------------------------------------|-|||||------||||---------------------------------------------%%  - %%
--------------------||||||||||---|||-----------||||||||||-------------------------------------------------------------------------|-|||||------||||---------------------------------------------||||-|||
XXXXXXXXXXXXXXXXXXXX||||||||||XXXXXXXXXXXXXXXXX||||||||||XXXXXXXXXXXXXXXXXXXXXXXXXXXXXXXXXXXXXXXXXXXXXXXXXXXXXXXXXXXXXXXXXXXXXXXXXXX|||||------||||XXXXXXXXXXXXXXXXXXXXXXXXXXXXXXXXXXXXXXXXXXXXX||||  XX