--------------------------------------------------------------------------------------------------------------------------------------------------------------------------------------------------------
--------------------------------------------------------------------------------------------------------------------------------------------------------------------------------------------------------
--------------------------------------------------------------------------------------------------------------------------------------------------------------------------------------------------------
--------------------------------------------------------------------------------------------------------------------------------------------------------------------------------------------------------
--------------------------------------------------------------------------------------------------------------------------------------------------------------------------------------------------------
--------------------------------------------------------------------------------------------------------------------------U-----------------------------------------------------------------------------
---------------------------------------------------------------------------------------------------------------------------------- C S------------------------------------------------------------------
--------------------------------------------------------------------------------------------------------------------------------------------------------------------------------------------------------
--------------------------------------------------------------------------------- S2S-----------------------------------------ggggkkkgkg-------------g---------------------------r--r-------------------
--------------------------------------------------------------------------------ggggggg----------------------------%%%% %%%% %--------------------------------------------------------------------------
---------------------------------------------------------g-----g--------------r------------------------------------|||||||||||---------- %% %%   %%%----------------------tt---- %%%%%  %---------------
---------------------------------------------- %%% % ---------------% %%%  %%  --------%%%%   %%%%  ---------------|||||||||||----------||||||||||||----------------------  ----|||||||||---------------
----------------------------------------------|||||||---% %%%%% %%% |||||||||||--------|||||||||||||--- %%%  %%%%%%|||||||||||%%%  %%%  ||||||||||||----------------------  ----|||||||||---------------
----------------------------------------------|||||||---|||||||||||||||||||||||% %% % %|||||||||||||---|||||||||||||||||||||||||||||||||||||||||||||-----------------%% %  % %%%|||||||||%% %%%%%%%%%F% 
------ %%%%-----------------------------------|||||||---||||||||||||||||||||||||||||||||||||||||||||---|||||||||||||||||||||||||||||||||||||||||||||-----%% %%%% %%%%|||||||||||||||||||||||||||||||| ||
  XXXX|||||  X X XX X X X----XX X X X X  --- XX  XXXX X ||||||||||||||||||||||||||||||||||||||||||||---|||||||||||||||||||||||||||||||||||||||||||||-----|||||||||||||||||||||||||||||||||||||||||||||||