--------------------------------------------------------------------------------------------------------------------------------------------------------------------------------------------------------
--------------------------------------------------------------------------------------------------------------------------------------------------------------------------------------------------------
--------------------------------------------------------------------------------------------------------------------------------------------------------------------------------------------------------
--------------------------------------------------------------------------------------------------------------------------------------------------------------------------------------------------------
--------------------------------------------------------------------------------------------------------------------------------------------------------------------------------------------------------
--------------------------------------------------------------------------------------------------------------------------------------------------------------------------------------------------------
--------------------------------------------------------------------------------------------------------------------------------------------------------------------------------------------------------
--------------------------------------------------------------------------------------------------------------------------------------------------------------------------------------------------------
--------------------------------------------------------------------------------------------------------------------------------------------------------------------------------------------------------
----------------------------------------------------------------------Tt--------------------------------------------------------------------------------------------------------------------------------
----------------------------------------------------------------------tt--------------------------------KKGG-----------------------------------------------G--------------------------------------------
----------------------------------------------------------------------tt----US2S------------------------%%%%----------------------F-------------------U2USUCS------------------------------------------%
--------------------------------U-------------------------------------tt-----U2SC--------------------%%%%%%|----------------------%--------------------------K-----------------------------------------|
----------------------------------------------------%%%----------%%%%%%%%%%%-------------------------|||||||----------------------|-----222------------------%%%%%%-------------------------------F---%%
---------------------------------%%%%%%%%%%---------|||----------|||||||||||-------%%%%%--%%%--------|||||||---------------%%%%%%%%%%------------------------||||||------------------------------- ---||
XXXXXXXXXXXXXXXXXXXXXXXXXXXXXXXXX||||||||||XXXXXXXXX|||XXXXXXXXXX|||||||||||XXXXXXX|||||--|||XXXXXXXXXXXXXXXXXXXXXXXXXXXXXX||||||||||XXXXXXXXXXXXXXXXXXXXXXXX||||||XXXXXXXXXXXXXXXXXXXXXXXXXXXXXXXXXXXXX