---------------------------------------------------------------------------------------------------------------------------        ---------------------------------------------------------------------
---------------------------------------------------------------------------------------------------------------------------        ---------------------------------------------------------------------
---------------------------------------------------------------------------------------------------------------------------        ---------------------------------------------------------------------
---------------------------------------------------------------------------------------------------------------------------        ---------------------------------------------------------------------
---------------------------------------------------------------------------------------------------------------------------        ---------------------------------------------------------------------
---------------------------------------------------------------------------------------------------------------------------        ---------------------------------------------------------------------
---------------------------------------------------------------------------------------------------------------------------        ---------------------------------------------------------------------
---------------------------------------------------------------------------------------------------------------------------        ---------------------------------------------------------------------
----------------------------------------------------------------------------------------------------------------Tt---------        --------------------------------------------------------------------T
----------------------------------------------------------------------------------------------------------------tt---------        --------------------------------------------------------------------t
----------------------------------------------------------------------------------------------------------------tt---------        ----------------------------------------------G-----------K---------t
----------------------------------------------------------------------------------------------------------------tt---------        ----------------S2USS22----------------%%-%%%%%%%------%%%%------KG-t
----------------------------------------CSUUUU-------------------------------------------------------------%%%%%%%%%%%%----        ---------------------K-----------------K|-|||||||------||||-----%%%%%
-------------------------------------------------------%%%%%%%%%%------------------------------------------||||||||||||----        ---------------S2S2SSS----------------%%%%%%%%%||------||||-----|||||
-------------------------------------------------------||||||||||------------------------------------------||||||||||||----        --------------------------------------|||||||||||------||||-----|||||
XXXXXXXXXXXXXXXXXXXXXXXXXXXXXXXXXXXXXXXXXXXXXXXXXXXXXXX||||||||||XXXXXXXXXXXXXXXXXXXXXXXXXXXXXXXXXXXXXXXXXX||||||||||||XXXX        XXXXXXXXXXXXXXXXXXXXXXXXXXXXXXXXXXXXXXXXXXXXXXXXXXXXXXXXXXXXXXXX|||||