--------------------------------------------------------------------------------------------------------------------------------------------------------------------------------------------------------
--------------------------------------------------------------------------------------------------------------------------------------------------------------------------------------------------------
--------------------------------------------------------------------------------------------------------------------------------------------------------------------------------------------------------
--------------------------------------------------------------------------------------------------------------------------------------------------------------------------------------------------------
-----------------------------------------------------------------------------------------------------------------------------------------SCSSS----------------------------------------------------------
--------------------------------------------------------------------------------------------------------------------------------------------------------------------------------------------------------
--------------------------------------------------------------------------------------------------------------------------------------------------------------------------------------------------------
--------------------------------------------------------------------------------------------------------------------------------------------------------------------------%%%%%%----%%%%%%%%------------
-----------------------------------------------------g--------------g-------------------------------------------------------------------%%%%%%%---------------------------|%%%%|----||||||||------------
------------------------------------CSSCUS-%%%%%%%%%%--------------------------------------------gkgkkrk--------------------------------|||||||---------------------------||||||----||||||||------------
-------------------------------------------||||||||||----%%%%%%%%%%%%%%------------------------r--|||||----------%%%%%%%%-------------%%%%%%%%%%%%%%%%%%%%%%%-------------||||||----||||||||------------
-------------------------------US----------||||||||||----||||||||||||||----------------%%%%%%%%%--|||||-%%%%%%%%%||||||||-------------|||||||||||||||||||||||----k------%%%%%%%%%%%%%%%%%%%%%%%%--------
-------------------------------------------||||||||||----||||||||||||||----------------|||||||||--|||||-|||||||||||||||||-------------|||||||||||||||||||||||-----------||||||||||||||||||||||||--------
-------------------------------------------||||||||||----||||||||||||||----------------|||||||||%%%%%%%%|||||||||||||||||----%%%%%%%%%|||||||||||||||||||||||---%%%%%%%%||||||||||||||||||||||||--------
------%%%%%--------------------------------||||||||||----||||||||||||||-----%%%%%%%%%%%||||||||||||||||||||||||||||||||||----||||||||||||||||||||||||||||||||---||||||||||||||||||||||||||||||||--------
XXXXXX|||||XXXXXXXXXXXXXXXXXXXXXXXXXXXXXXXX||||||||||----||||||||||||||-----|||||||||||||||||||||||||||||||||||||||||||||----||||||||||||||||||||||||||||||||---||||||||||||||||||||||||||||||||XX    XX