--------------------------------------------------------------------------------------------------------------------------------------------------------------------------------------------------------
--------------------------------------------------------------------------------------------------------------------------------------------------------------------------------------------------------
--------------------------------------------------------------------------------------------------------------------------------------------------------------------------------------------------------
--------------------------------------------------------------------------------------------------------------------------------------------------------------------------------------------------------
--------------------------------------------------------------------------------------------------------------------------------------------------------------------------------------------------------
--------------------------------------------------------------------------------------------------------------------------------------------------------------------------------------------------------
--------------------------------------------------------------------------------------------------------------------------------------------------------------------------------------------------------
--------------------------------------------------------------------------------------------------------------------------------------------------------------------------------------------------------
--------------------------------------------------------------------------------------------------------------------------------------------------------------------------------------------------------
-------------------------------------------------------------------------------------------------------------------------------Tt-----------------------------------------------------------------------
-------------------------------------------------------------------------------------------------------------------------------tt-----------------------------------------------------------------------
-------------------G-----------------------------------------------------------------------------------------------------------tt-F--------------------------------2%%%%%%%%----------------------------
-------%%%%%-----%%%%-%%%%%-----%%%%%---------------%%%------K%%%%%%%-------------------------------------------------------G--tt-%------------%%%%%---%%%-K----22C-||%%%%||----------------------F-----
-------|||||-----||||-|||||-----|||||---------------|||----%%%%%%%%%%-%%%%%%%%%%-------------------------%%%%%%%%---------%%%%%%%%%%%----------|||||---|||%%%%KK%%%%%|||||||---------------------- -----
-------|||||-----||||-|||||-----|||||---------------|||----||||||||||-||||||||||-------------------------||||||||---------|||||||||||----------|||||---|||||%%%%%%||||||||||----------------%%%%%%%%%%--
XXXXXXX|||||-----||||X|||||-----|||||XXXXXXXXXXXXXXX|||XXXXXXXXXXXXXXX||||||||||XXXXXXXXXXXXXXXXXXXXXXXXX||||||||XXXXXXXXX|||||||||||XXXXXXXXXX|||||---|||XX||||||XXXXXXXXXXXXXXXXXXXXXXXXXX||||||||||XX