--------------------------------------------------------------------------------------------------------------------------------------------------------------------------------------------------------
--------------------------------------------------------------------------------------------------------------------------------------------------------------------------------------------------------
--------------------------------------------------------------------------------------------------------------------------------------------------------------------------------------------------------
--------------------------------------------------------------------------------------------------------------------------------------------------------------------------------------------------------
--------------------------------------------------------------------------------------------------------------------------------------------------------------------------------------------------------
--------------------------------------------------------------------------------------------------------------------------------------------------------------------------------------------------------
--------------------------------------------------------------------------------------------------------------------------------------------------------------------------------------------------------
------------------------------------------------------------------------Tt---------------------------Tt-------------------------------------------------------------------------------------------------
------------------------------------------------------------------------tt---------------------------tt-------------------------------------------------------------------------------------------------
-----------------------------------------------------------------------Ttt---------------------------ttTt-----------------------------Tt------------------------------------------------Tt--------------
-----------------------------------------------------------------------ttt-K-------------------------tttt-----------------------------tt------------------------------------------------tt--------------
--------------------------------------------------------------%%%--%%%%tt%%%%%------------------%%%%%%%tt%%%-----------------U22C- ---tt---------G--------------------------------------tt--------------
-------------------------%%%%%%-------------------------------|||--||||tt|||||------------------|||||||tt|K|CC--------------------%---tt--G---%%%%%----------G-------------------------Ktt--K-----------
-------------------------||||||--------------%%%%--%%%--------|||--|%%%%%%%%%|------------------|||%%%%%%%%%----------------------%%%%%%%%%%--|||||--%%%%%%%%%%%--------G-G---------%%%%%%%%%%%%%%    %%
-------------------------||||||--------------||||--|||--------|||--|||||||||||------------------||||||||||||----------------------||||||||||--|||||--|||||||||||%%%%---%%%%%--------||||||||||||||||||||
XXXXXXXXXXXXXXXXXXXXXXXXXXXXXXXXXXXXXXXXXXXXX||||--|||XXXXXXXXXXXXXXXXXXXXXXXXXXXXXXXXXXXXXXXXXXXXX|||||||||XXXXXXXXXXXXXXXXXXXXXX||||||||||XX|||||XXXXXXXXXXXXX||||---|||||XXXXXXXX||||||||||||||||||||