--------------------------------------------------------------------------------------------------------------------------------------------------------------------------------------------------------
--------------------------------------------------------------------------------------------------------------------------------------------------------------------------------------------------------
--------------------------------------------------------------------------------------------------------------------------------------------------------------------------------------------------------
--------------------------------------------------------------------------------------------------------------------------------------------------------------------------------------------------------
--------------------------------------------------------------------------------------------------------------------------------------------------------------------------------------------------------
--------------------------------------------------------------------------------------------------------------------------------------------------------------------------------------------------------
--------------------------------------------------------------------------------------------------------------------------------------------------------------------------------------------------------
--------------------------------------------------------------------------------------------------------------------------------------------------------------------------------------------------------
-------------------------------------------------------------------------Tt-----------------------------------------------------------------------------------------------------------------------------
-------------Tt----------------------------------------------------------tt-----------------------------------------------------------------------------------------------------------------------------
-------------tt----------------------------------------------------------tt-----------------------------------------------------------------------------------------------------------------------------
-------------tt----------------------------------------------------------tt------------------------GG----------------------------S CUU2S-----------------Tt---------------------------------------------
----------%%%%%%%%%----------------GG---------------------CU----------%%%%%%%%%------------------U22SCS2----------%%%%----%%%%%---%----------G-----------tt----------------%%%%%-%%%%%---------%%%    %%
----------|||||||||------%%%-----%%%%---------------------------------|||||||||-----------------------------------||||----|||||---|------%%%%%-----------tt---------------G|||K|-|||||---------|||||||||
----------|||||||||------|||-----||||----------%%%%%%%%%%%------------|||||||||-----------------------------------||||----|||||---|------|||||--------%%%%%%%%%----------%%%%%%%%%%%%%%--------|||||||||
XXXXXXXXXXXXXXXXXXXXXXXXX|||-----||||XXXXXXXXXX|||||||||||XXXXXXXXXXXXXXXXXXXXXXXXXXXXXXXXXXXXXXXXXXXXXXXXXXXXXXXX||||----|||||XXXXXXXXXX|||||XXXXXXXX|||||||||XXXXXXXXXX||||||||||||||XXXXXXXX|||||||||