--------------------------------------------------------------------------------------------------------------------------------------------------------------------------------------------------------
--------------------------------------------------------------------------------------------------------------------------------------------------------------------------------------------------------
--------------------------------------------------------------------------------------------------------------------------------------------------------------------------------------------------------
--------------------------------------------------------------------------------------------------------------------------------------------------------------------------------------------------------
--------------------------------------------------------------------------------------------------------------------------------------------------------------------------------------------------------
--------------------------------------------------------------------------------------------------------------------------------------------------------------------------------------------------------
--------------------------------------------------------------------------------------------------------------------------------------------------------------------------------------------------------
--------------------------------------------------------------------------------------------------------------------------------------------------------------------------------------------------------
-----------------------------------------------------------------------------------------------------------------------------------------------------------------------------------Tt-------------------
-----------------------------Tt----------------------------------------------------------------------------------------------------------------------------------------------------tt-------------------
-----------------------------tt-------------------------------------------------------------------------------------------------------------------------------------------K--------tt-------------------
-----------------------------tt-----------------------K---------------------------------------------------------K-----------------F---------------K---------------K---%%%%%-----%%%%G%%%%---------------
-----------------------------tt-----------------------%%%--%%%%----------------------------K---------G----%%%%--%%%%%-------------%--%%%%--%%%%---%%%----%%%-----%%%%%|||||2UC--||%%%%%||----%-%%%%%%%%%
----------%%%----%%%%%%---%%%%%%%%%-------------------|||--||||---------------------------%%%%---%%%-UU2C-||||--|||||-------------|--||||--||||---|||----|||-----||||||||||-----|||||||||----|-|||||||F|
----------|||----||||||---|||||||||-------------------|||--||||---------------------------||||---|||------||||--|||||-------------|--||||--||||---|||----|||-----||||||||||%%%%%%||||||||%%%%%%%%%%%|| |
XXXXXXXXXXXXXXXXXXXXXXXXXX|||||||||XXXXXXXXXXXXXXXXXXX|||--||||XXXXXXXXXXXXXXXXXXXXXXXXXXX||||---|||XXXXXX||||--|||||XXXXXXXXXXXXXXXX||||--||||XXX|||XXXX|||-----|||||XXXXX||||||XXXXXXXX|||||||||||XXXX