--------------------------------------------------------------------------------------------------------------------------------------------------------------------------------------------------------
--------------------------------------------------------------------------------------------------------------------------------------------------------------------------------------------------------
--------------------------------------------------------------------------------------------------------------------------------------------------------------------------------------------------------
--------------------------------------------------------------------------------------------------------------------------------------------------------------------------------------------------------
--------------------------------------------------------------------------------------------------------------------------------------------------------------------------------------------------------
--------------------------------------------------------------------------------------------------------------------------------------------------------------------------------------------------------
--------------------------------------------------------------------------------------------------------------------------------------------------------------------------------------------------------
--------------------------------------------------------------------------------------------------------------------------------------------------------------------------------------------------------
--------------------------------------------------------------------------------------------------------------------------------------------------------------------------------------------------------
------------------------------------------------------------------------------------------------------Tt------------------------------------------------------------------------------------------------
------------------------------------------------------------------------------------------------------tt--------------------------------------------------------Tt--------------------------------------
---------------------------K--------------------------------%%%%%--K----------------------------------tt-------------------------- ---------------------%%%%%%%%tt------%%%%%%%%%%%%--------------------
--------------------%%%%---%%%%-----------------------------|||||%%%----%%%%-%%%%%%%%------------%-%%%%%%%%%%-----------%%%-------%---------------------||||||||tt------||||||||||||2UCS2C--------------
--------------------||||---||||-------------%%%%----%%%----%%%||||||----||||-||||||||--------%%%%%%%%%%||||||-----------|||-------|---------------------%%%|||||tt------||||||||||||-----------GK-------
-------------------%||||%%-||||-------------||||----|||----|||||||||----||||-||||||||--------||||||||||||||||-----------|||-------|--%%%%---%%%---------|||%%%%%%%%%%%%-||||||||||||---------%%%%%--  %-
XXXXXXXXXXXXXXXXXXX|||||||-||||XXXXXXXXXXXXX||||----|||XXXX|||XXX|||----||||XXXXXXXXXXXXXXXXXXXXXXXXXXXXXXXXXXXXXXXXXXXXXXXXXXXXXXXXX||||---|||XXXXXXXXXXXX||||||||||||XXXXXXXXXXXXXXXXXXXXXX|||||--|||X