--------------------------------------------------------------------------------------------------------------------------------------------------------------------------------------------------------
--------------------------------------------------------------------------------------------------------------------------------------------------------------------------------------------------------
--------------------------------------------------------------------------------------------------------------------------------------------------------------------------------------------------------
--------------------------------------------------------------------------------------------------------------------------------------------------------------------------------------------------------
--------------------------------------------------------------------------------------------------------------------------------------------------------------------------------------------------------
--------------------------------------------------------------------------------------------------------------------------------------------------------------------------------------------------------
--------------------------------------------------------------------------------------------------------------------------------------------------------------------------------------------------------
--------------------------------------------------------------------------------------------------------------------------------------------------------------------------------------------------------
--------------------------------------------------------------------------------------------------------------------------------------------------------------------------------------------------------
-----------------------------------------------------------------------------Tt----------------------------------------------------Tt-------------------------------------Tt----------------------------
------------------------------------------------------------------G----------tt-------------------Tt-------------------------------tt-------------------------------------tt----------------------------
---------------------------------------------------------------%%%%----------t--------------------tt------------------------------Ftt---------------%%%------------------Ktt------------------------%%%%
-------------------------------G---G---------------------------||||----------tt-------------------tt--------------------------%%%%%%%%%%%%----------|||K-------------%%%%%%%%%%%C-------------------||||
-----------G-------------------%%%%%---%%%%--------------K-----||||------%%%%%%%%%%%---------%%%%%%%%%%%%---------------------||||||||||||-------%%%%%%S2C-----------|||||||||||--------------------||||
--------%%%%%----%%%%%---------|||||---||||--%%%%%-----%%%%----||||------|||||||||||---------||||||||||||---------------------||||||||||||-------||||||--------------|||||||||||--------------------||||
  X    X|||||----|||||XXXXXXX  |||||XXX||||X |||||-----||||X XX XXXXXXXX XXXXXXXX XXXXXXXXXXX||||||||||||XX  X X X  XXX XXXX X||||||||||||X  XX  XXXX XXXXXX XXX X  X|||||||||||XXXXXXX XXXXX XXX  XXX X