--------------------------------------------------------------------------------------------------------------------------------------------------------------------------------------------------------
--------------------------------------------------------------------------------------------------------------------------------------------------------------------------------------------------------
--------------------------------------------------------------------------------------------------------------------------------------------------------------------------------------------------------
--------------------------------------------------------------------------------------------------------------------------------------------------------------------------------------------------------
--------------------------------------------------------------------------------------------------------------------------------------------------------------------------------------------------------
--------------------------------------------------------------------------------------------------------------------------------------------------------------------------------------------------------
--------------------------------------------------------------------------------------------------------------------------------------------------------------------------------------------------------
--------------------------------------------------------------------------------------------------------------------------------------------------------------------------------------------------------
-------------Tt-----------------------------------------------------------------------------------------------------------------------------------------------------------------------------------------
-------------tt--------------------------------------------------------------------------------------------------Tt-------------------------Tt-------------------------------Tt-------------------------
-------------tt--------------------------------------------------------------------------------------------------tt--G----------------------tt-------------------------------tt-------------------------
-------------tt--------%%%%%%-%%%%%%%%%%-------------------------------------------K-----------------------------tt-%%%%%%%%%%%%--F---------tt-------------------------------tt-------------------------
--------%%%%%%%%%%-----||||||-||||||||||-----------K---------------------------%%%%%---%%%%-----------------%%%%%%%%%%%|||||||||--%---------tt-----------------------K--K--G-tt-%K%%%%%%----------------
--------||||||||||-----||||||-||||||||||---%%%%---%%%--------------------------|||||---||||-----------------||||||||||||||||||||G-K----%%%%%%%%%%-------------------%%%%%%%%%%%%%%%%||||------------F---
--------||||||||||-----||||||-||||||||||---||||---|||--------------------------|||||---||||-----------------||||||||||||||||||||%%%----||||||||||-------------------||||||||||||||||||||------------ ---
XXXXXXXX||||||||||XXXXXXXXXXXXXXXXXXXXXXXXX||||---|||XXXXXXXXXXXXXXXXXXXXXXXXXX|||||---||||XXXXXXXXXXXXXXXXX|||||||||||XXXXXXXXX|||XXXX||||||||||XXXXXXXXXXXXXXXXXXX||||||||||||||||XXXXXXXXXXXXXXXXXXXX