---------------------------------------------------------------------------------------------------------------------------------     ------------------------------------------------------------------
---------------------------------------------------------------------------------------------------------------------------------     ------------------------------------------------------------------
---------------------------------------------------------------------------------------------------------------------------------     ------------------------------------------------------------------
---------------------------------------------------------------------------------------------------------------------------------     ------------------------------------------------------------------
---------------------------------------------------------------------------------------------------------------------------------     ------------------------------------------------------------------
---------------------------------------------------------------------------------------------------------------------------------     ------------------------------------------------------------------
---------------------------------------------------------------------------------------------------------------------------------     ------------------------------------------------------------------
---------------------------------------------------------------------------------------------------------------------------------     ------------------------------------------------------------------
---------------------------------------------------------------------------------------------------------------------------------     --Tt--------------------------------------------------------------
---------------------------------------------------------------------------------------------------------------------------------     --tt--------------------------------------------------------------
-----------------------------------------------------Tt--------------------------------------------------------------------------     --tt--------------------------------------------------------------
-----------Tt-------------------------G--------------tt-------------G------------------------------------------------------------     --tt--------------------------------------------------------------
-----------tt-----------------------%%%%%----%%%-----tt-----------%%%%---------------------------------------------%%%%%%%%%%----     %%%%%%%%------------------------------------G---------------------
-----------tt%%%%%%%%%--------------|||||----|||-----tt-------%%%%||||------------------K%%%--------------%%%--%%%%||||||||||----     ||||||||-----------------------------------%%%%%%%%%%%---------%%%
-------%%%%%%%%%%|||||--------------|||||----|||-%%%%%%%%%----||||||||-------%%%%%%%%%%%%|||--------------|||--||||||||||||||----     ||||||||-----------------------------------|||||||||||---------|||
XXXXXXX||||||||||XXXXXXXXXXXXXXXXXXX|||||----|||X|||||||||XXXXXXXXXXXXXXXXXXX||||||||||||XXXXXXXXXXXXXXXXX|||--||||XXXXXXXXXXXXXX     XXXXXXXXXXXXXXXXXXXXXXXXXXXXXXXXXXXXXXXXXXXXXXXXXXXXXXXXXXXXXXX|||