--------------------------------------------------------------------------------------------------------------------------------------------------------------------------------------------------------
--------------------------------------------------------------------------------------------------------------------------------------------------------------------------------------------------------
--------------------------------------------------------------------------------------------------------------------------------------------------------------------------------------------------------
--------------------------------------------------------------------------------------------------------------------------------------------------------------------------------------------------------
--------------------------------------------------------------------------------------------------------------------------------------------------------------------------------------------------------
--------------------------------------------------------------------------------------------------------------------------------------------------------------------------------------------------------
--------------------------------------------------------------------------------------------------------------------------------------------------------------------------------------------------------
--------------------------------------------------------------------------------------------------------------------------------------------------------------------------------------------------------
-----------------------------------------------------------------------------------------------------------------------U---------------------------------------k--k---r---------------------------------
--------------------------------------------------------------------------------------------------------------------------------------------------------------------------------------------------------
-----------------------------------------------------------------------------------------------------------------------------%%%%%%--------------------------------- %%% %%---%% %%  %%%%%--------------
----------------------------------------------------g---------------g------------------------------------------------------kggggggrrk-------------------------------|||||||---||||||||||||%%%%%  %% %F%%
----------------------------------------------------------------------------------------------------------------%%  %%%%%%%--||||||---------------%%  %%%% %%%----%%%% %%%%%%%|||||||||||||||||||||||%||
---------------------------------------g----g----------------------%%%%%%%%%%%----g-----------------------g-----|||||||||||--||||||--%%% %%%%%%%%%||||||||||||----||||||||||||||||||||||||||||||||||||||
------%%%%%--------------------------------------------------------|||||||||||----------------------------------|||||||||||--||||||--|||||||||||||||||||||||||----||||||||||||||||||||||||||||||||||||||
 XX XX|||||XXXXXXXXXXXXXX---XXXXXXXXXX---XXX XXX ----XXXXXX XXX XXX|||||||||||---XXXXXX XX  XXX---X XXXXXXXXXXXX|||||||||||XXXXXXXXXX|||||||||||||||||||||||||----||||||||||||||||||||||||||||||||||||||