--------------------------------------------------------------------------------------------------------------------------------------------------------------------------------------------------------
--------------------------------------------------------------------------------------------------------------------------------------------------------------------------------------------------------
--------------------------------------------------------------------------------------------------------------------------------------------------------------------------------------------------------
--------------------------------------------------------------------------------------------------------------------------------------------------------------------------------------------------------
--------------------------------------------------------------------------------------------------------------------------------------------------------------------------------------------------------
--------------------------------------------------------------------------------------------------------------------------------------------------------------------------------------------------------
--------------------------------------------------------------------------------------------------------------------------------------------------------------------------------------------------------
-------------Tt-------------------------------------------------------------------------------------------------------------------------------------------------------------------------------------Tt--
-------------tt-------------------------------------------------------------------------------------------------------------------------------------------------------------------------------------tt--
-------------tt-------------------------------------------------------------------------------------------------------------------------------------------------------------------------------------tt--
-------------tt-------------------------------------------------------------------------------------------------------------------------Tt----------------------------------------------------------tt--
--------%%%%%%%%%%--------%%%%%%%%%------------------------------------------2S2UUU-----------------------------------------------F-----tt-------------------------------------------------------%%%%%%%
--------||||||||||%%%%%%%-%%%||||||-----------------------------%%%------%%%%--------%%%--------K-------S2S------%%%%%%%%----%%%%-%-----tt---------------------------------UU-------%%%%---%%%---|||||||
--------|||||||||||||||||-|||||||||-------------%%%%%%%%%%------|||------||||------K-|||-------%%%%%%%%%---------||||||||S---||||-|--%%%%%%%%----------%%%%------%%%----------------||||---|||---||F||||
--------||||||||||||%%%%%%%%%%%||||-------------||||||||||------|||------||||--%%%%%-|||-------|||||||||---------||||||||----||||-|--||||||||----------||||------|||----------------||||---|||---|| ||||
XXXXXXXXXXXXXXXXXXXX|||||||||||XXXXXXXXXXXXXXXXX||||||||||XXXXXX|||------||||XX|||||X|||XXXXXXX|||||||||XXXXXXXXX||||||||XXXX||||XXXX||||||||XXXXXXXXXX||||------|||XXXXXXXXXXXXXXXX||||---|||XXXXXXXXXX