--------------------------------------------------------------------------------------------------------------------------------------------------------------------------------------------------------
--------------------------------------------------------------------------------------------------------------------------------------------------------------------------------------------------------
--------------------------------------------------------------------------------------------------------------------------------------------------------------------------------------------------------
--------------------------------------------------------------------------------------------------------------------------------------------------------------------------------------------------------
--------------------------------------------------------------------------------------------------------------------------------------------------------------------------------------------------------
--------------------------------------------------------------------------------------------------------------------------------------------------------------------------------------------------------
--------------------------------------------------------------------------------------------------------------------------------------------------------------------------------------------------------
--------------------------------------------------------------------------------------------------------------------------------------------------------------------------------------------------------
--------------------------------------------------------------------------------------------------------------------------------------------------------------------------------------------------------
------------------------------------SCUC----------------------------------------------------------------------------------------------------------------------------------------------------------------
------------------------2CS2S-------------------------SSS-----------------------------------------------------------------------------------------------------------------------------------------------
-----------------USC2S----------------------#---#-------------------------------------------------------------------------------------------------------------------------------------------------------
----------------------------------g-------%%%---%%%-------------------------------------%%%%%%%%%%-------%%%%---%%%%%%---%%-----------------------------------------------------------------------------
--------------------------------%%%%%%%%%%|||---|||-y-----------------------------------||||||||||-------||||---||||||---||-------------%%%%%%%% %%%%%%%%%%%%%%%%%%%%%%%%%%%%%%%%%%%%%%%%%%%%%%%%%    %%
--------------------r--%%%%%%%%%|||||||||||||---|||%%%%%%%%%%%%%--%%%%%%--%%------------||||||||||-------||||---||||||---||%%%%%---%%%%%||||||||%|||||||||||||||||||||||||||||||||||||||||||||||||||||||
XXXXXXXXXXXXXXXXXXXXXXX||||||||||||||||||||||---||||||||||||||||--||||||--||XXXXX--XXXXX||||||||||XX---XX||||---||||||---|||||||---|||||||||||||||||||||||||||||||||||||||||||||||||||||||||||||||||||||