-----------------------------------------------------------------------------------------------------------------------------       --------------------------------------------------------------------
-----------------------------------------------------------------------------------------------------------------------------       --------------------------------------------------------------------
-----------------------------------------------------------------------------------------------------------------------------       --------------------------------------------------------------------
-----------------------------------------------------------------------------------------------------------------------------       --------------------------------------------------------------------
-----------------------------------------------------------------------------------------------------------------------------       --------------------------------------------------------------------
-----------------------------------------------------------------------------------------------------------------------------       --------------------------------------------------------------------
-----------------------------------------------------------------------------------------------------------------------------       --------------------------------------------------------------------
-----------------------------------------------------------------------------------------------------------------------------       --------------------------------------------------------------------
-----------------------------------------------------------------------------------------------------------------------------       --------------------------------------------------------------------
-----------------------------------------------------------------------------------------------------------------------------       ------Tt------------------------------------------------------------
-----------------------------------------------------------------------------------------------------------------------------       GG----tt----------------------K-------------------------------------
-----------------------------------------------------------------------------------------------------------------------------       2C----tt-----22C2U-----------C2%%%%%%-------Tt----------------------
-------------CCCSC2------G-----------------------------------------------G--G------------------------------------------------       ------tt----------------G--G---||||||-------tt------------------%%%%
----------------------%%%%%%%%%%%%%%%%---%%%%----------------------------%%%%%%----------------------------------------------       --%%%%%%%%%--------%%%--%%%%%--||||||-------tt-K----------------||||
----------------------||||||||||||||||---||||----------------------------||||||----------------------------------------------       --|||||||||--------|||--|||||--||||||--%%%%%%%%%%%%%%%%%%%%-----||||
XXXXXXXXXXXXXXXXXXXXXX||||||||||||||||---||||XXXXXXXXXXXXXXXXXXXXXXXXXXXXXXXXXXXXXXXXXXXXXXXXXXXXXXXXXXXXXXXXXXXXXXXXXXXXXXXX       XX|||||||||XXXXXXXX|||--|||||XXXXXXXXXX||||||||||||||||||||XXXXX||||