--------------------------------------------------------------------------------------------------------------------------------------------------------------------------------------------------------
--------------------------------------------------------------------------------------------------------------------------------------------------------------------------------------------------------
--------------------------------------------------------------------------------------------------------------------------------------------------------------------------------------------------------
--------------------------------------------------------------------------------------------------------------------------------------------------------------------------------------------------------
--------------------------------------------------------------------------------------------------------------------------------------------------------------------------------------------------------
--------------------------------------------------------------------------------------------------------------------------------------------------------------------------------------------------------
--------------------------------------------------------------------------------------------------------------------------------------------------------------------------------------------------------
--------------------------------------------------------------------------------------------------------------------------------------------------------------------------------------------------------
-----------------------------------------------------------------g-----------------------------------------------r----------------k-----------------------------------------------------%%%%%%%---------
--------------------------------------------------------------------------------------------U2SCCCSC-%%%%%%%%%%%%------------------------------k-----------------------------%%%%%%-----|||||||---------
--------------------------------U--------------------------------------------------------------------||||||||||||----%%%%%%%%%%%%--------------------------------------------||||||---%%%%%%%%%%%%    %%
------------------------------------kgggggkgkggkgg-----------------------------------UCC2C-----------||||||||||||----||||||||||||--------------------------------------------||||||---||||||||||||||| ||
-----------------------------------------------------------------------------------------------------||||||||||||----||||||||||||----%%%%%%%%%-------------------------------||||||---||||||||||||||||||
--------------------------------------------------%%%%%%%%%%%%%%-------------------------------------||||||||||||----||||||||||||----|||||||||----------------------%%%%%--%%%%%%%%%%%||||||||||||||||||
------%%%%%--------------%%%%%%%%%%%--------------||||||||||||||---%%%%%%%%%%%-----------------------||||||||||||----||||||||||||----|||||||||---%%%%%%%%%%%%%%-----|||||--|||||||||||||||||||||||||||||
XXXXXX|||||XXXXXXXXXXXXXX|||||||||||XXXXXXXXXXXXXX||||||||||||||---|||||||||||XXXXXXXXXXXXXXXXXXXXXXX||||||||||||----||||||||||||----|||||||||---||||||||||||||---XXXXXXXXX|||||||||||||||||||||||||||||