------------------------------------------------------------------------------ -------------------------------------------------------------------------------------------------------------------------
---------------- ------------------------------------------------ ------------------------------------------ -------------------------------------------------------------------------------------------
--------------------------------------------- --------------------------------------------------------------------------------------------------------------------------------------------- ------------
------------------------------------------------------------------ -------------------------------------------------------------------------------------------------------------------------------------
---------- ---------------------------------------------------------------------------------------------------------------------------------------------------------------------------------------------
------------------------------------------------------------------ -------------------------------------------------------------------------------------------------------------------------------------
-------------------------------------------------------------------------------------------------------------------------------------------------- -----------------------------------------------------
--------------------------------------------------------------------------------------------------------------------------------------------------------------------------------------------------------
-----------------------------------------------------------------------------------------------------------------------------------------------------------------------------------Tt-------------------
-------------------------------------------------- ------------------------------------------T -- ---------------------------------------------------------------------------------tt-------------------
-------------------------------------------------------Tt------------------ -----------------tt------------------------------------------------------------------------------------tt-------------------
-----------------K-------------G-----------------------t ------------------------------------tt---------------------------T ------F------------------------------------------------tt---------------S22U
---------------- %%------------2-------G-----CUSS ----Gtt----------------------------------K-t -------K----------------- -t ------%-------------------%%%%%%K- %---G-----------%%%% %  %% --------------
----------------|||-------------% % %%%%%---------% % %%%%%%%--------------------------- %%%%%%%%%%%--%% ---  %%----------tt------|-------------------K| %%%%%%%%%- S----------|||||||||||--------%%%%%%
-------------- -|||-------------|||||||||---------|||||||||||---------------------------||||||||||||--|||----|||-----%%%%%%%% %%%-|----%%% ----- %%--%%%||||||||||-------------|||||||||||--------||||||
   XXXXX XX   XX||| X  XXX  XX X|||||||||  XXXX   ||||||||||| XXX XX  X XXX XX  X  XX XX   X  XX  XX X|||---- ||    X||||||||||||X X X ||||-----|||XX|||X XX X   XX X  X X XX X|||||||||||X XXX  XXX    