--------------------------------------------------------------------------------------------------------------------------------------------------------------------------------------------------------
--------------------------------------------------------------------------------------------------------------------------------------------------------------------------------------------------------
--------------------------------------------------------------------------------------------------------------------------------------------------------------------------------------------------------
--------------------------------------------------------------------------------------------------------------------------------------------------------------------------------------------------------
--------------------------------------------------------------------------------------------------------------------------------------------------------------------------------------------------------
--------------------------------------------------------------------------------------------------------------------------------------------------------------------------------------------------------
--------------------------------------------------------------------------------------------------------------------------------2SSCCCC2----2SCS--------------------------------------------------------
--------------------------------------------------------------------------------------------------------------------------------------------------------------------------------------------------------
------------------------------------------------------------------------------------------------------------------------------------------g-------------------------------------------------------------
----------------------------------------------------------------------------------------------------------SSSSU--%%%%%%%%%%%%---------------------------------------------------------------------------
-------------------------------------------------------g----g----------------------------------------------------||||||||||||%%%%%%%%%%%%%%%%%%%%%------------------------------------------------------
----------------------------------ggggkkgggkgg----------------------------------------------------UCSS2C---------|||||||||||||||||||||||||||||||||----k----r------------------------------%%%%%%%%    %%
-----------------------------------------------------------------------------------------------------------------|||||||||||||||||||||||||||||||||---------------------%%%%%%%-----r------||||||||||| ||
--------------------------------r-------------%%%%%%%%-----------------------g--------g--------------------------|||||||||||||||||||||||||||||||||---%%%%%%%%%%%%------|||||||------------||||||||||||||
------%%%%%--------------%%%%%%%%-------------||||||||-----------------------------------------------------------|||||||||||||||||||||||||||||||||---||||||||||||------|||||||----%%%%%%%%||||||||||||||
XXXXXX|||||XXXXXXXXXXXXXX||||||||XXXXXXXXXXXXX||||||||----XXXXXXXXXXXXX-----XXXXXXXXXXXXXXXXXXXXXXXXXXXXXXXXXXXXX|||||||||||||||||||||||||||||||||---||||||||||||----XXXXXXXXXXXXX||||||||||||||||||||||