--------------------------------------------------------------------------------------------------------------------------------------------------------------------------------------------------------
--------------------------------------------------------------------------------------------------------------------------------------------------------------------------------------------------------
--------------------------------------------------------------------------------------------------------------------------------------------------------------------------------------------------------
--------------------------------------------------------------------------------------------------------------------------------------------------------------------------------------------------------
--------------------------------------------------------------------------------------------------------------------------------------------------------------------------------------------------------
--------------------------------------------------------------------------------------------------------------------------------------------------------------------------------------------------------
--------------------------------------------------------------------------------------------------------------------------------------------------------------------------------------------------------
--------------------------------------------------------------------------------------------------------------------------------------------------------------------------------------------------------
--------------------------------------------------------------------------------------------------------------------------------------------------------------------------------------------------------
-----------------------------------------------------------------Tt-------------------------------------------------------------------------------------------------------------------------------------
--------------------Tt------------------------------------------Ktt-------------------------------------------------------------------------------------------------------------------------------------
--------------------tt----------------------------------------%%%tt%%%%%----------K-----G-U--------------------G------------------ ----------------%%%%%------------------------------------------------
--------------------tt------------------------------------%%%%%||tt|K|||--------%%%%%%%%%%--------------------%%%-----------------%----------------|||||----------------%%%%----------------------------
-----------------%%%%%%%%------%%%%%---%%%----------------||%%%%%%%%%%||--------||||||||||--------------------|||--%%%%%--%%%%----|2CSCC-----------|||||----------------||||-------------------K--------
-----------------||||||||------|||||---|||----------------||||||||||||||--------||||||||||--------------------|||--|||||--||||----|----------------|||||----%%%--%%%%---||||----------------%%%%%%    %%
XXXXXXXXXXXXXXXXXXXXXXXXXXXXXXX|||||---|||XXXXXXXXXXXXXXXXXX||||||||||XXXXXXXXXX||||||||||XXXXXXXXXXXXXXXXXXXXXXXXX|||||--||||XXXXXXXXXXXXXXXXXXXXXXXXXXXXXX|||--||||XXX||||XXXXXXXXXXXXXXXX||||||||||||