--------------------------------------------------------------------------------------------------------------------------------------------------------------------------------------------------------
--------------------------------------------------------------------------------------------------------------------------------------------------------------------------------------------------------
--------------------------------------------------------------------------------------------------------------------------------------------------------------------------------------------------------
--------------------------------------------------------------------------------------------------------------------------------------------------------------------------------------------------------
--------------------------------------------------------------------------------------------------------------------------------------------------------------------------------------------------------
--------------------------------------------------------------------------------------------------------------------------------------------------------------------------------------------------------
--------------------------------------------------------------------------------------------------------------------------------------------------------------------------------------------------------
---------------------------------------------------------------------------------------------------------------------------------Tt---------------------------------------------------------------------
---------------------------------------------------------------------------------------------------------------------------------tt---------------------------------------------------------------------
---------------------------------------------------------------------------------------------------------------------------------tt---------------------------------------------------------------------
------------------------------------------------------------Tt-------------------------------------------------------------------tt---------------------------------------------------------------------
------------------------------------------------------------tt----------------------------------------------------------------%%%% %%%%-----------------------------------------------------------------
-----------------------------%%%%%%----UC2CS2---------------tt-----------------G----------------------2USC2S------------------G|||%||||-KK-G-----G--%%%%%%----------------------------------------    %%
-----------%%%%%%%%%%--------||||||-----------------------KGtt------2C2--------CCU-----------------------------------------%%%%%|||||||%%%%%----%%%%||||||------------G---------------------------||||||
-----------||||||||||--------||||||---------------------%%%%%%%%%%---------------------------------------------------------|||||||||||||||||----||||||||||---------%%%%%------%%%-----------------||||||
XXXXXXXXXXXXXXXXXXXXXXXXXXXXXXXXXXXXXXXXXXXXXXXXXXXXXXXX||||||||||XXXXXXXXXXXXXXXXXXXXXXXXXXXXXXXXXXXXXXXXXXXXXXXXXXXXXXXXX|||||XXXXXXX|||||----||||||||||XXXXXXXXX|||||------|||XXXXXXXXXXXXXXXXX    XX