-------------------------------------------------------- --------------------------------------------------------------------- -------------------------------------------------------------------------
-------------------------------------------- ----------------------------------------------- -----------------------------------------------------------------------------------------------------------
--------------------------------------------------------------------------------------------------------------------------------------------------------------------------------------------------------
------------------- ------------------------------------------------------------------------------------------------------------------------------------------------------------------------------------
--------------------------------------------------------------------------------------------------------------------------- ----------------------------------------------------------------------------
---------------------------------------- -------------------------------------------------------------------------------------------------------- ------------------------------------------------------
------------------------------------------- ------------------------------------------------------------------------------------------------------------------------------------- ----------------------
--------------------------------------------------------------------------------------------------------------------------------------------------------------------------------------------------------
--------------------------------------------------------------------------------------------------------------------------------------------------------------------------------------------------------
------------------------------------------------------------------------------------------------- --------------------- ----------U---------------------------------------------------------------------
-----------------------------------ggkgkggg----------------------------------------------------------------------------------------------SCSS2S--------------------------------g---g----r---------------
---------------------------------r--||||||--------------------g-----------g-----------------------------------------------------------ggggggggkgkk------------------------------------------------------
-------------------------%%% %% %%--||||||-%% %%% %%%% -------------------------------------- % -----g---------% %%----------------------------------------------------------- %    %%%%% --------------
------------- -----------|||||||||--||||||-||||||||||||-----S   %S%%---------%%% %%%---------|||---------------|%%% % %---  %%%%%% %% ------------ %%%%%%%% %%  --------------||||||||||||--------------
------% %% --------------||||||||| %%%%  %%||||||||||||-----||||||||---------|||||||---------|||----  %%%%%%%%-||||||||---||||||||||||------------||||||||||||||--------------||||||||||||----------- --
     X|||||XX XX XX X  XX||||||||||||||||||||||||||||||--- X  XX X X X  - -    X    X XX-----|||----|||||||||| XXX     XXX||||||||||||XXX XX  XXX ||||||||||||||---  XX  XXX X|||||||||||| XXXXXXX XX FX