--------------------------------------------------------------------------------------------------------------------------------------------------------------------------------------------------------
--------------------------------------------------------------------------------------------------------------------------------------------------------------------------------------------------------
--------------------------------------------------------------------------------------------------------------------------------------------------------------------------------------------------------
--------------------------------------------------------------------------------------------------------------------------------------------------------------------------------------------------------
--------------------------------------------------------------------------------------------------------------------------------------------------------------------------------------------------------
--------------------------------------------------------------------------------------------------------------------------------------------------------------------------------------------------------
--------------------------------------------------------------------------------------------------------------------------------------------------------------------------------------------------------
----------------------------------U---------------------------------------------------------------------------------------------------------------------------------------------------------------------
-----------------------------------------CSSCCCS------------------------------------------------------------------------------------------------------------------------------g-------------------------
------------------------------------------------------------g-------------------------------------------------------------------------------------------------------------------------------------------
--------------------------------------gkgkggkkggkgk------------------------------------------------------------g---------------%%%%----------------------------------%%%%%%%%-----%%%%%%----------------
-------------------------%%%%%%%%%%%%%-----------------------------%%%%%------------------gggggggg------------------%%%%%%----%%%%%%------------------------%%%%%%---||||||||-----||||||----------------
-------------------------|||||||||||||-------------%%%%%%%%--------|||||--------------------------------------------||||||----||||||------------------------||||||---||||||||-----|%%%%%----------------
-------------------------|||||||||||||-------------||||||||-------%%%%%%%---------------r---------%%%%%%%%%%%-------||||||----||||||---------------g------%%%%%%%%%%%||||||||-----||||||----------------
------%%%%%--------------|||||||||||||%%%%%%%%%%%%%||||||||-------|||||||----%%%%%%%%%%%%---------|||||||||||-------||||||--%%%%%%%%%%--------------------|||||||||||||||||||---%%%%%%%%%%%-------------
XXXXXX|||||XXXXXXXXXXXXXX||||||||||||||||||||||||||||||||||-----XXXXXXXXXXXXX||||||||||||XXXXXXXXX|||||||||||-----XXXXXXXXXX||||||||||-----XXX----XXXXXXXX|||||||||||||||||||---|||||||||||XXXXXXX    XX